year,STNAME,CTYNAME,POPESTIMATE,NPOPCHG,BIRTHS,DEATHS,NATURALINC,INTERNATIONALMIG,DOMESTICMIG,NETMIG,RESIDUAL,GQESTIMATES,RBIRTH,RDEATH,RNATURALINC,RINTERNATIONALMIG,RDOMESTICMIG,RNETMIG
2016,Alabama,Alabama,4863300,9425,58556,52405,6151,4738,-864,3874,-600,119659,12.052062456,10.786056647,1.2660058093,0.9751805437,-0.177829462,0.797351082
2016,Alabama,Autauga County,55416,381,631,494,137,7,228,235,9,455,11.42588116,8.9451430951,2.4807380648,0.1267530398,4.1285275824,4.2552806222
2016,Alabama,Baldwin County,208563,4873,2274,2113,161,243,4046,4289,423,2341,11.03206041,10.250986651,0.7810737581,1.1788877219,19.628723138,20.80761086
2016,Alabama,Barbour County,25965,-305,253,314,-61,-5,-248,-253,9,3186,9.6869914808,12.022590217,-2.335598736,-0.191442519,-9.495548961,-9.686991481
2016,Alabama,Bibb County,22643,82,266,237,29,18,34,52,1,2252,11.768870012,10.485797717,1.2830722945,0.7963897,1.5042916556,2.3006813556
2016,Alabama,Blount County,57704,28,663,622,41,38,-65,-27,14,489,11.492459698,10.781764604,0.7106950945,0.6586930144,-1.126711735,-0.468018721
2016,Alabama,Bullock County,10362,-93,114,111,3,9,-101,-92,-4,1653,10.952586828,10.664360859,0.2882259692,0.8646779075,-9.703607628,-8.838929721
2016,Alabama,Butler County,19998,-128,236,241,-5,8,-127,-119,-4,333,11.763533048,12.012760443,-0.249227395,0.3987638321,-6.330375835,-5.931612003
2016,Alabama,Calhoun County,114611,-674,1237,1441,-204,27,-462,-435,-35,2776,10.761387758,12.536103281,-1.774715524,0.2348888193,-4.019208686,-3.784319866
2016,Alabama,Chambers County,33843,-200,419,476,-57,18,-155,-137,-6,458,12.34422414,14.023510002,-1.679285862,0.5303007984,-4.566479097,-4.036178299
2016,Alabama,Cherokee County,25725,-1,208,331,-123,5,136,141,-19,290,8.0853627723,12.86661095,-4.781248178,0.194359682,5.2865833511,5.4809430332
2016,Alabama,Chilton County,43941,132,540,483,57,13,63,76,-1,393,12.307692308,11.008547009,1.2991452991,0.2962962963,1.4358974359,1.7321937322
2016,Alabama,Choctaw County,12993,-208,139,170,-31,-1,-174,-175,-2,129,10.613117508,12.980071772,-2.366954264,-0.076353363,-13.28548523,-13.36183859
2016,Alabama,Clarke County,24392,-334,297,313,-16,5,-326,-321,3,280,12.093326275,12.7448186,-0.651492325,0.2035913514,-13.27415611,-13.07056476
2016,Alabama,Clay County,13492,-3,136,202,-66,-1,43,42,21,255,10.078926891,14.970170823,-4.891243932,-0.074109757,3.1867195316,3.1126097751
2016,Alabama,Cleburne County,14924,-72,171,202,-31,-1,-51,-52,11,178,11.430481283,13.502673797,-2.072192513,-0.06684492,-3.409090909,-3.475935829
2016,Alabama,Coffee County,51226,163,602,537,65,84,33,117,-19,600,11.770571616,10.49966272,1.2709088954,1.6424053417,0.64523067,2.2876360117
2016,Alabama,Colbert County,54216,-79,582,661,-79,13,32,45,-45,474,10.727023067,12.183096645,-1.456073578,0.2396070444,0.5898019556,0.829409
2016,Alabama,Conecuh County,12395,-202,115,191,-76,2,-123,-121,-5,45,9.2029449424,15.284891165,-6.081946223,0.1600512164,-9.843149808,-9.683098592
2016,Alabama,Coosa County,10581,-106,91,101,-10,0,-89,-89,-7,257,8.5574572127,9.4978371262,-0.940379913,0.0,-8.36938123,-8.36938123
2016,Alabama,Covington County,37458,-203,440,520,-80,2,-110,-108,-15,575,11.714745936,13.844699743,-2.129953807,0.0532488452,-2.928686484,-2.875437639
2016,Alabama,Crenshaw County,13913,37,145,193,-48,10,65,75,10,132,10.435783943,13.890388283,-3.45460434,0.7197092375,4.6781100435,5.397819281
2016,Alabama,Cullman County,82471,613,997,1009,-12,28,560,588,37,990,12.134194208,12.280242684,-0.146048476,0.3407797772,6.8155955431,7.1563753202
2016,Alabama,Dale County,49226,-144,637,542,95,46,-274,-228,-11,917,12.92141669,10.994360826,1.9270558643,0.9331007343,-5.558034809,-4.624934074
2016,Alabama,Dallas County,40008,-885,465,545,-80,-3,-793,-796,-9,856,11.495531576,13.473257438,-1.977725862,-0.07416472,-19.60420761,-19.67837233
2016,Alabama,DeKalb County,70900,-96,796,771,25,56,-150,-94,-27,782,11.219484693,10.867113943,0.3523707504,0.7893104809,-2.114224502,-1.324914022
2016,Alabama,Elmore County,81799,561,978,794,184,52,283,335,42,5391,11.997276692,9.7401203408,2.257156351,0.6378920122,3.4716046051,4.1094966173
2016,Alabama,Escambia County,37728,-99,440,458,-18,2,-85,-83,2,3280,11.647144464,12.123618556,-0.476474092,0.0529415657,-2.250016544,-2.197074978
2016,Alabama,Etowah County,102564,-309,1148,1497,-349,27,44,71,-31,2085,11.176175665,14.573810949,-3.397635285,0.2628543057,0.4283551648,0.6912094705
2016,Alabama,Fayette County,16546,-177,170,234,-64,-1,-98,-99,-14,290,10.219724067,14.067149599,-3.847425531,-0.060116024,-5.891370345,-5.951486369
2016,Alabama,Franklin County,31628,86,363,378,-15,88,33,121,-20,272,11.492797214,11.96770619,-0.474908976,2.7861326579,1.0447997467,3.8309324046
2016,Alabama,Geneva County,26614,-141,284,358,-74,0,-50,-50,-17,229,10.642882572,13.416028031,-2.773145459,0.0,-1.873746932,-1.873746932
2016,Alabama,Greene County,8422,-28,99,91,8,-1,-32,-33,-3,45,11.73541963,10.787102892,0.9483167378,-0.118539592,-3.793266951,-3.911806543
2016,Alabama,Hale County,14952,-123,226,197,29,-1,-160,-161,9,221,15.05311886,13.121523962,1.9315948979,-0.066606721,-10.6570753,-10.72368202
2016,Alabama,Henry County,17164,-27,166,209,-43,5,22,27,-11,199,9.6638043953,12.167079028,-2.503274633,0.2910784456,1.2807451608,1.5718236065
2016,Alabama,Houston County,104056,-169,1282,1121,161,38,-297,-259,-71,1420,12.310292345,10.764303993,1.5459883523,0.3648916608,-2.851916401,-2.487024741
2016,Alabama,Jackson County,52138,-160,519,670,-151,31,4,35,-44,597,9.9391014593,12.83082462,-2.891723161,0.5936650197,0.076601938,0.6702669578
2016,Alabama,Jefferson County,659521,-486,8775,7269,1506,646,-2350,-1704,-288,16343,13.300210378,11.017575982,2.2826343965,0.9791379948,-3.561879702,-2.582741708
2016,Alabama,Lamar County,13918,16,135,197,-62,3,75,78,0,217,9.705248023,14.162473041,-4.457225018,0.2156721783,5.3918044572,5.6074766355
2016,Alabama,Lauderdale County,92318,-159,940,1099,-159,48,-1,47,-47,2060,10.173435428,11.894261208,-1.72082578,0.5194945751,-0.010822804,0.5086717714
2016,Alabama,Lawrence County,33244,111,380,408,-28,0,144,144,-5,229,11.44974916,12.293414888,-0.843665728,0.0,4.3388523133,4.3388523133
2016,Alabama,Lee County,158991,2224,1904,1056,848,573,769,1342,34,4955,12.059868634,6.6886666371,5.3712019965,3.6293617264,4.8708187916,8.500180518
2016,Alabama,Limestone County,92753,1131,1013,787,226,83,820,903,2,2728,10.988474576,8.5369491525,2.4515254237,0.9003389831,8.8949152542,9.7952542373
2016,Alabama,Lowndes County,10358,-64,123,148,-25,-1,-64,-65,26,96,11.838306064,14.244465833,-2.406159769,-0.096246391,-6.159769009,-6.256015399
2016,Alabama,Macon County,18963,-252,186,269,-83,2,-162,-160,-9,1690,9.743831526,14.091885379,-4.348053853,0.104772382,-8.486562942,-8.38179056
2016,Alabama,Madison County,356967,3665,4249,3069,1180,537,1923,2460,25,8107,11.964481063,8.6417962772,3.3226847856,1.5121031609,5.4148498667,6.9269530277
2016,Alabama,Marengo County,19673,-239,230,267,-37,14,-224,-210,8,254,11.620563345,13.489958318,-1.869394973,0.7073386384,-11.31741821,-10.61007958
2016,Alabama,Marion County,29998,-147,292,404,-112,16,-33,-17,-18,868,9.7101907121,13.434647424,-3.724456712,0.5320652445,-1.097384567,-0.565319322
2016,Alabama,Marshall County,95157,464,1280,1145,135,103,225,328,1,1061,13.484329734,12.062154332,1.4221754016,1.0850671583,2.3702923361,3.4553594943
2016,Alabama,Mobile County,414836,202,5596,4514,1082,484,-1138,-654,-226,7516,13.492953332,10.884058495,2.6088948365,1.1670102596,-2.743920817,-1.576910557
2016,Alabama,Monroe County,21530,-167,229,267,-38,0,-121,-121,-8,230,10.595229833,12.353390242,-1.758160409,0.0,-5.598352881,-5.598352881
2016,Alabama,Montgomery County,226349,-519,3170,2171,999,375,-1829,-1454,-64,8876,13.988883912,9.5803996761,4.408484236,1.6548364249,-8.071188857,-6.416352432
2016,Alabama,Morgan County,119012,-375,1331,1245,86,117,-509,-392,-69,2121,11.16615422,10.444674684,0.7214795364,0.9815477414,-4.27015214,-3.288604399
2016,Alabama,Perry County,9574,-109,106,139,-33,2,-73,-71,-5,805,11.008983746,14.436308875,-3.427325129,0.2077166745,-7.581658618,-7.373941943
2016,Alabama,Pickens County,20324,-503,216,262,-46,0,-450,-450,-7,1842,10.497922286,12.733590921,-2.235668635,0.0,-21.87067143,-21.87067143
2016,Alabama,Pike County,33286,-90,392,339,53,87,-230,-143,0,2258,11.760823258,10.17071195,1.5901113078,2.6101827128,-6.900483034,-4.290300321
2016,Alabama,Randolph County,22652,-51,294,282,12,-5,-42,-47,-16,407,12.964392019,12.435233161,0.5291588579,-0.220482857,-1.852056003,-2.07253886
2016,Alabama,Russell County,58172,-686,873,629,244,47,-989,-942,12,574,14.919251474,10.749380501,4.1698709733,0.8032128514,-16.90164915,-16.0984363
2016,Alabama,St. Clair County,88019,1033,988,922,66,41,896,937,30,1893,11.291105968,10.536841805,0.7542641639,0.4685580412,10.239707437,10.708265478
2016,Alabama,Shelby County,210622,2095,2384,1527,857,210,1021,1231,7,2703,11.37542974,7.2861917838,4.089237956,1.0020303043,4.8717759079,5.8738062121
2016,Alabama,Sumter County,13040,-204,162,153,9,37,-250,-213,0,906,12.326890884,11.642063613,0.6848272713,2.8154010044,-19.02297976,-16.20757876
2016,Alabama,Talladega County,80103,-646,846,1053,-207,35,-415,-380,-59,2805,10.518986397,13.092780941,-2.573794544,0.4351826524,-5.160022878,-4.724840226
2016,Alabama,Tallapoosa County,40727,-28,450,543,-93,8,72,80,-15,576,11.045384257,13.328097003,-2.282712746,0.1963623868,1.7672614811,1.9636238678
2016,Alabama,Tuscaloosa County,206102,1781,2520,1810,710,339,763,1102,-31,11007,12.280013547,8.8201684603,3.4598450867,1.6519542033,3.7181152128,5.3700694162
2016,Alabama,Walker County,64967,-324,797,950,-153,35,-180,-145,-26,851,12.237252223,14.58643615,-2.349183927,0.537395016,-2.763745797,-2.226350781
2016,Alabama,Washington County,16756,-145,187,207,-20,44,-167,-123,-2,147,11.112101494,12.300561547,-1.188460053,2.6146121164,-9.923641442,-7.309029325
2016,Alabama,Wilcox County,10986,-44,140,126,14,0,-54,-54,-4,108,12.718023256,11.44622093,1.2718023256,0.0,-4.905523256,-4.905523256
2016,Alabama,Winston County,23805,-49,239,321,-82,-3,53,50,-17,301,10.029585178,13.470698084,-3.441112906,-0.125894375,2.2241339516,2.098239577
2016,Alaska,Alaska,741894,4185,11255,4511,6744,2030,-4587,-2557,-2,27826,15.213540389,6.097581581,9.1159588079,2.7439792971,-6.20031184,-3.456332543
2016,Alaska,Aleutians East Borough,3296,-21,15,6,9,79,-122,-43,13,1726,4.5365189778,1.8146075911,2.7219113867,23.892333283,-36.89702102,-13.00468774
2016,Alaska,Aleutians West Census Area,5647,-92,30,8,22,96,-218,-122,8,2520,5.2696293694,1.4052344985,3.8643948709,16.862813982,-38.29264008,-21.4298261
2016,Alaska,Anchorage Municipality,298192,-120,4560,1774,2786,1048,-3869,-2821,-85,8126,15.289084398,5.9479902901,9.3410941083,3.5138071161,-12.97225165,-9.458444537
2016,Alaska,Bethel Census Area,17968,28,435,142,293,9,-275,-266,1,324,24.22858416,7.909101036,16.319483124,0.5012810516,-15.31692102,-14.81563997
2016,Alaska,Bristol Bay Borough,898,6,11,7,4,0,1,1,1,16,12.290502793,7.8212290503,4.469273743,0.0,1.1173184358,1.1173184358
2016,Alaska,Denali Borough,1953,40,20,0,20,17,-10,7,13,44,10.346611485,0.0,10.346611485,8.794619762,-5.173305742,3.6213140197
2016,Alaska,Dillingham Census Area,4954,-45,97,47,50,1,-95,-94,-1,52,19.49161057,9.4443886265,10.047221943,0.2009444389,-19.08972169,-18.88877725
2016,Alaska,Fairbanks North Star Borough,100605,966,1676,471,1205,325,-539,-214,-25,4868,16.739577715,4.7042608018,12.035316913,3.2460398314,-5.383432213,-2.137392381
2016,Alaska,Haines Borough,2496,12,16,6,10,2,-3,-1,3,0,6.4257028112,2.4096385542,4.016064257,0.8032128514,-1.204819277,-0.401606426
2016,Alaska,Hoonah-Angoon Census Area,2078,-40,18,15,3,3,-51,-48,5,0,8.5795996187,7.1496663489,1.4299332698,1.4299332698,-24.30886559,-22.87893232
2016,Alaska,Juneau City and Borough,32468,-135,392,176,216,57,-411,-354,3,1076,12.048377926,5.4094758034,6.6389021223,1.7519325045,-12.63235543,-10.88042292
2016,Alaska,Kenai Peninsula Borough,58506,462,724,483,241,32,212,244,-23,1721,12.423852424,8.2882882883,4.1355641356,0.5491205491,3.6379236379,4.187044187
2016,Alaska,Ketchikan Gateway Borough,13746,57,168,76,92,51,-79,-28,-7,275,12.247129579,5.5403681429,6.7067614361,3.7178786222,-5.759066885,-2.041188263
2016,Alaska,Kodiak Island Borough,13732,-57,223,50,173,65,-294,-229,-1,391,16.205806475,3.6335888958,12.572217579,4.7236655645,-21.36550271,-16.64183714
2016,Alaska,Kusilvak Census Area,8049,-60,214,97,117,3,-184,-181,4,16,26.488426785,12.00643644,14.481990345,0.3713330858,-22.77509593,-22.40376284
2016,Alaska,Lake and Peninsula Borough,1562,-5,29,17,12,2,-22,-20,3,37,18.53627357,10.866091403,7.6701821668,1.2783636945,-14.06200064,-12.78363694
2016,Alaska,Matanuska-Susitna Borough,104365,3245,1514,573,941,83,2187,2270,34,2425,14.735868798,5.5770494197,9.1588193785,0.8078448549,21.286225272,22.094070127
2016,Alaska,Nome Census Area,9917,42,215,96,119,3,-80,-77,0,172,21.725949879,9.7008892482,12.025060631,0.303152789,-8.084074373,-7.780921584
2016,Alaska,North Slope Borough,9606,-84,161,66,95,24,-207,-183,4,2652,16.687396352,6.8407960199,9.8466003317,2.4875621891,-21.45522388,-18.96766169
2016,Alaska,Northwest Arctic Borough,7673,-91,179,84,95,5,-196,-191,5,381,23.191034527,10.882943577,12.30809095,0.6477942605,-25.39353501,-24.74574075
2016,Alaska,Petersburg Borough,3149,0,36,24,12,11,-27,-16,4,43,11.432200699,7.6214671324,3.8107335662,3.4931724357,-8.574150524,-5.080978088
2016,Alaska,Prince of Wales-Hyder Census Area,6347,-13,75,46,29,1,-59,-58,16,50,11.804517195,7.2401038798,4.5644133155,0.1573935626,-9.286220194,-9.128826631
2016,Alaska,Sitka City and Borough,8830,-14,76,51,25,44,-81,-37,-2,253,8.600203689,5.7711893176,2.8290143714,4.9790652937,-9.166006563,-4.18694127
2016,Alaska,Skagway Municipality,1088,30,12,12,0,1,27,28,2,32,11.18359739,11.18359739,0.0,0.9319664492,25.163094129,26.095060578
2016,Alaska,Southeast Fairbanks Census Area,6876,50,107,34,73,25,-48,-23,0,369,15.618157933,4.9627791563,10.655378777,3.6491023208,-7.006276456,-3.357174135
2016,Alaska,Valdez-Cordova Census Area,9355,47,132,47,85,31,-76,-45,7,192,14.14563575,5.0367036382,9.1089321117,3.3220811231,-8.144456947,-4.822375824
2016,Alaska,Wrangell City and Borough,2411,11,24,29,-5,7,8,15,1,16,9.9771357306,12.055705674,-2.078569944,2.9099979214,3.3257119102,6.2357098316
2016,Alaska,Yakutat City and Borough,601,-19,10,0,10,3,-35,-32,3,18,16.38001638,0.0,16.38001638,4.914004914,-57.33005733,-52.41605242
2016,Alaska,Yukon-Koyukuk Census Area,5526,-15,86,74,12,2,-41,-39,12,31,15.541700551,13.373091172,2.1686093792,0.3614348965,-7.409415379,-7.047980483
2016,Arizona,Arizona,6931071,113506,87204,56564,30640,14861,61544,76405,6461,156879,12.685476581,8.2283071572,4.4571694239,2.161814452,8.9527426575,11.11455711
2016,Arizona,Apache County,73112,1518,1005,680,325,76,1118,1194,-1,993,13.89023261,9.3983663428,4.4918662668,1.0504056501,15.452019958,16.502425608
2016,Arizona,Cochise County,125770,-625,1582,1283,299,281,-1163,-882,-42,5204,12.547340035,10.175876906,2.3714631293,2.2286994627,-9.224119128,-6.995419666
2016,Arizona,Coconino County,140908,1832,1683,869,814,171,863,1034,-16,11485,12.022115549,6.2074975713,5.8146179782,1.2214983713,6.1646379793,7.3861363506
2016,Arizona,Gila County,53556,418,615,832,-217,30,583,613,22,962,11.528295874,15.596003524,-4.06770765,0.5623558963,10.928449585,11.490805481
2016,Arizona,Graham County,37599,-74,581,270,311,19,-400,-381,-4,3121,15.437347221,7.1739823573,8.2633648634,0.5048357955,-10.62812201,-10.12328622
2016,Arizona,Greenlee County,9613,88,152,51,101,20,-39,-19,6,35,15.884627443,5.3297105236,10.554916919,2.0900825583,-4.075660989,-1.98557843
2016,Arizona,La Paz County,20317,170,205,262,-57,46,141,187,40,356,10.132463424,12.949782523,-2.817319098,2.2736259391,6.9691577699,9.242783709
2016,Arizona,Maricopa County,4242997,81360,56073,30645,25428,10188,43189,53377,2555,64540,13.343353203,7.2924055943,6.0509476082,2.4243768378,10.277425525,12.701802363
2016,Arizona,Mohave County,205249,1084,1879,3101,-1222,-67,1999,1932,374,4622,9.1789728734,15.148480511,-5.969507638,-0.327297064,9.7651765694,9.4378795058
2016,Arizona,Navajo County,110026,1663,1566,986,580,61,990,1051,32,2317,14.341381663,9.0297588248,5.3116228381,0.558636195,9.0663907065,9.6250269015
2016,Arizona,Pima County,1016206,8001,11778,9795,1983,2252,2568,4820,1198,25162,11.635977082,9.6768887346,1.9590883472,2.2248446585,2.5370342287,4.7618788872
2016,Arizona,Pinal County,418540,12320,4543,3021,1522,1103,8245,9348,1450,24001,11.016538144,7.325767496,3.6907706484,2.6747174936,19.993695136,22.668412629
2016,Arizona,Santa Cruz County,45985,-152,601,321,280,32,-505,-473,41,387,13.047914722,6.9690193439,6.0788953779,0.6947309003,-10.96372202,-10.26899112
2016,Arizona,Yavapai County,225562,3978,1944,2886,-942,80,4337,4417,503,4154,8.6951465517,12.908535467,-4.213388915,0.357824961,19.398585697,19.756410658
2016,Arizona,Yuma County,205631,1925,2997,1562,1435,569,-382,187,303,9540,14.643191307,7.6318534606,7.0113378463,2.7801053899,-1.866432793,0.9136725974
2016,Arkansas,Arkansas,2988248,10395,37936,30581,7355,3335,195,3530,-490,85075,12.717183299,10.251586421,2.4655968781,1.1179830848,0.0653693258,1.1833524106
2016,Arkansas,Arkansas County,18214,-159,232,225,7,9,-166,-157,-9,247,12.6821002,12.299450625,0.382649575,0.491978025,-9.07426135,-8.582283325
2016,Arkansas,Ashley County,20492,-318,237,263,-26,-5,-273,-278,-14,191,11.476441819,12.735460753,-1.259018934,-0.242119026,-13.2196988,-13.46181783
2016,Arkansas,Baxter County,41062,-8,374,680,-306,-2,336,334,-36,595,9.1072907028,16.558710369,-7.451419666,-0.048702089,8.1819510057,8.1332489164
2016,Arkansas,Benton County,258291,7440,3629,1727,1902,746,4772,5518,20,2138,14.255355088,6.7839620381,7.4713930495,2.9304201971,18.745261636,21.675681833
2016,Arkansas,Boone County,37304,75,435,459,-24,3,129,132,-33,465,11.672681899,12.316691935,-0.644010036,0.0805012545,3.4615539425,3.542055197
2016,Arkansas,Bradley County,10996,-57,126,135,-9,-3,-42,-45,-3,224,11.429089755,12.245453309,-0.816363554,-0.272121185,-3.809696585,-4.08181777
2016,Arkansas,Calhoun County,5144,-65,47,48,-1,0,-67,-67,3,175,9.0794938665,9.2726745871,-0.193180721,0.0,-12.94310828,-12.94310828
2016,Arkansas,Carroll County,27646,-98,311,305,6,49,-156,-107,3,230,11.229463802,11.012818198,0.2166456039,1.7692724318,-5.632785701,-3.86351327
2016,Arkansas,Chicot County,10945,-40,125,154,-29,16,-23,-7,-4,771,11.399908801,14.044687642,-2.644778842,1.4591883265,-2.097583219,-0.638394893
2016,Arkansas,Clark County,22657,15,244,247,-3,14,-10,4,14,2826,10.772864743,10.905317998,-0.132453255,0.6181151902,-0.44151085,0.1766043401
2016,Arkansas,Clay County,14920,-147,165,217,-52,0,-94,-94,-1,125,11.004768733,14.472938273,-3.46816954,0.0,-6.269383399,-6.269383399
2016,Arkansas,Cleburne County,25264,-205,226,374,-148,7,-41,-34,-23,339,8.9093883665,14.743855084,-5.834466718,0.2759545069,-1.616304969,-1.340350462
2016,Arkansas,Cleveland County,8241,-58,72,87,-15,1,-72,-71,28,52,8.7061668682,10.519951632,-1.813784764,0.1209189843,-8.706166868,-8.585247884
2016,Arkansas,Columbia County,23901,-239,301,296,5,43,-284,-241,-3,1817,12.530963136,12.322807602,0.2081555338,1.7901375908,-11.82323432,-10.03309673
2016,Arkansas,Conway County,20937,-57,244,230,14,7,-61,-54,-17,285,11.638167466,10.970403759,0.667763707,0.3338818535,-2.909541866,-2.575660013
2016,Arkansas,Craighead County,105835,1473,1528,943,585,149,736,885,3,3819,14.538742228,8.9725352883,5.5662069392,1.4177176649,7.0029543714,8.4206720362
2016,Arkansas,Crawford County,62267,373,777,623,154,72,161,233,-14,540,12.516007442,10.035357318,2.4806501236,1.1597844734,2.5934069474,3.7531914208
2016,Arkansas,Crittenden County,49235,250,790,495,295,5,-30,-25,-20,953,16.086336795,10.079413561,6.0069232336,0.1018122582,-0.610873549,-0.509061291
2016,Arkansas,Cross County,17037,-245,216,207,9,0,-245,-245,-9,225,12.587779364,12.063288557,0.5244908068,0.0,-14.2778053,-14.2778053
2016,Arkansas,Dallas County,7469,-114,68,84,-16,5,-96,-91,-7,401,9.0353441403,11.161307467,-2.125963327,0.6643635397,-12.75577996,-12.09141642
2016,Arkansas,Desha County,11876,-131,150,174,-24,12,-119,-107,0,56,12.561236026,14.57103379,-2.009797764,1.004898882,-9.965247247,-8.960348365
2016,Arkansas,Drew County,18651,-24,253,198,55,10,-77,-67,-12,978,13.55623426,10.609226812,2.9470074479,0.535819536,-4.125810427,-3.589990891
2016,Arkansas,Faulkner County,122227,884,1509,889,620,104,188,292,-28,4400,12.390688508,7.2997495586,5.0909389498,0.8539639529,1.5437040686,2.3976680215
2016,Arkansas,Franklin County,17626,-83,207,200,7,9,-97,-88,-2,448,11.71642847,11.320220744,0.3962077261,0.5094099335,-5.490307061,-4.980897127
2016,Arkansas,Fulton County,12123,-65,111,190,-79,0,29,29,-15,165,9.1316687919,15.630784419,-6.499115627,0.0,2.385751306,2.385751306
2016,Arkansas,Garland County,97477,323,1068,1324,-256,10,659,669,-90,2176,10.974613499,13.605232466,-2.630618966,0.1027585534,6.7717886668,6.8745472201
2016,Arkansas,Grant County,18082,52,188,169,19,1,46,47,-14,143,10.412051396,9.3597696057,1.05228179,0.0553832521,2.5476295968,2.6030128489
2016,Arkansas,Greene County,44598,431,572,486,86,22,336,358,-13,602,12.887962598,10.950261928,1.9377006703,0.4956908691,7.5705514561,8.0662423252
2016,Arkansas,Hempstead County,21974,-64,318,222,96,-7,-139,-146,-14,301,14.450604381,10.088157775,4.3624466055,-0.318095065,-6.316459148,-6.634554212
2016,Arkansas,Hot Spring County,33374,-109,340,382,-42,8,-74,-66,-1,2279,10.170961904,11.427374845,-1.256412941,0.2393167507,-2.213679944,-1.974363193
2016,Arkansas,Howard County,13377,27,188,168,20,16,-7,9,-2,181,14.068170764,12.571556853,1.496613911,1.1972911288,-0.523814869,0.67347626
2016,Arkansas,Independence County,37168,95,457,419,38,34,48,82,-25,1025,12.311256583,11.287563476,1.0236931076,0.9159359384,1.2930860306,2.209021969
2016,Arkansas,Izard County,13433,-21,104,192,-88,10,58,68,-1,1008,7.7360806338,14.281995016,-6.545914382,0.7438539071,4.3143526611,5.0582065682
2016,Arkansas,Jackson County,17221,-129,183,209,-26,2,-125,-123,20,2271,10.586908102,12.09105898,-1.504150878,0.1157039137,-7.231494605,-7.115790692
2016,Arkansas,Jefferson County,70016,-1748,890,864,26,26,-1863,-1837,63,5168,12.554662153,12.187896741,0.3667654112,0.3667654112,-26.28015235,-25.91338694
2016,Arkansas,Johnson County,26176,30,335,252,83,32,-67,-35,-18,580,12.805320898,9.632659302,3.1726615955,1.223194832,-2.56106418,-1.337869348
2016,Arkansas,Lafayette County,6847,-134,73,76,-3,0,-137,-137,6,113,10.558287533,10.99218976,-0.433902227,0.0,-19.81486838,-19.81486838
2016,Arkansas,Lawrence County,16735,-6,180,245,-65,2,60,62,-3,653,10.753972996,14.637352133,-3.883379137,0.1194885888,3.5846576652,3.704146254
2016,Arkansas,Lee County,9310,-335,105,116,-11,1,-322,-321,-3,1757,11.07887101,12.23951464,-1.16064363,0.1055130572,-33.97520443,-33.86969137
2016,Arkansas,Lincoln County,13705,-136,127,129,-2,0,-127,-127,-7,3805,9.2209395193,9.3661511653,-0.145211646,0.0,-9.220939519,-9.220939519
2016,Arkansas,Little River County,12451,6,130,163,-33,-2,49,47,-8,123,10.44344473,13.094473008,-2.651028278,-0.16066838,3.9363753213,3.7757069409
2016,Arkansas,Logan County,21792,-4,271,299,-28,30,5,35,-11,573,12.434615032,13.719372304,-1.284757273,1.3765256493,0.2294209415,1.6059465908
2016,Arkansas,Lonoke County,72228,531,931,669,262,122,148,270,-1,572,12.937293729,9.2965085982,3.6407851311,1.6953274275,2.0566267153,3.7519541428
2016,Arkansas,Madison County,16072,355,190,154,36,2,325,327,-8,79,11.953820504,9.6888860927,2.2649344113,0.1258296895,20.447324546,20.573154236
2016,Arkansas,Marion County,16325,111,156,256,-100,3,208,211,0,141,9.5884938074,15.734964197,-6.146470389,0.1843941117,12.78465841,12.969052522
2016,Arkansas,Miller County,43787,-112,586,471,115,-1,-224,-225,-2,1472,13.365873686,10.742877996,2.6229956892,-0.022808658,-5.109139429,-5.131948087
2016,Arkansas,Mississippi County,42835,-864,649,518,131,17,-1051,-1034,39,807,14.999884438,11.972172788,3.0277116509,0.3929091455,-24.29103012,-23.89812097
2016,Arkansas,Monroe County,7169,-246,96,117,-21,0,-226,-226,1,84,13.165112452,16.044980801,-2.879868349,0.0,-30.9928689,-30.9928689
2016,Arkansas,Montgomery County,8879,-93,82,142,-60,6,-39,-33,0,121,9.1871603832,15.909472859,-6.722312475,0.6722312475,-4.369503109,-3.697271862
2016,Arkansas,Nevada County,8398,-155,88,105,-17,0,-143,-143,5,157,10.382868267,12.388649637,-2.00578137,0.0,-16.87216093,-16.87216093
2016,Arkansas,Newton County,7936,13,74,101,-27,0,37,37,3,51,9.3322403682,12.737246989,-3.405006621,0.0,4.6661201841,4.6661201841
2016,Arkansas,Ouachita County,24098,-272,271,342,-71,13,-200,-187,-14,352,11.182635966,14.11240406,-2.929768094,0.5364364117,-8.252867872,-7.71643146
2016,Arkansas,Perry County,10132,-50,110,120,-10,1,-51,-50,10,152,10.829969479,11.814512159,-0.98454268,0.098454268,-5.021167668,-4.9227134
2016,Arkansas,Phillips County,18975,-559,287,273,14,6,-616,-610,37,246,14.905606482,14.178503726,0.7271027552,0.3116154665,-31.99252123,-31.68090576
2016,Arkansas,Pike County,10832,-22,110,128,-18,10,-7,3,-7,196,10.144793876,11.804851056,-1.66005718,0.9222539887,-0.645577792,0.2766761966
2016,Arkansas,Poinsett County,24023,-5,316,341,-25,15,23,38,-18,341,13.152691931,14.193253002,-1.040561071,0.6243366423,0.9573161849,1.5816528272
2016,Arkansas,Polk County,20173,-52,247,284,-37,10,-7,3,-18,155,12.228328135,14.060101985,-1.83177385,0.4950740136,-0.346551809,0.1485222041
2016,Arkansas,Pope County,63779,287,807,565,242,57,9,66,-21,3825,12.681600679,8.8786919251,3.8029087538,0.895726442,0.1414304908,1.0371569328
2016,Arkansas,Prairie County,8251,-29,91,106,-15,0,-10,-10,-4,131,11.009618293,12.824390539,-1.814772246,0.0,-1.209848164,-1.209848164
2016,Arkansas,Pulaski County,393250,318,5444,3663,1781,783,-1994,-1211,-252,9043,13.849210488,9.3184529791,4.5307575091,1.9919051823,-5.072616773,-3.080711591
2016,Arkansas,Randolph County,17448,-7,194,252,-58,-6,71,65,-14,349,11.116522935,14.440019483,-3.323496548,-0.343809988,4.0684181875,3.7246081999
2016,Arkansas,St. Francis County,26196,-382,335,294,41,30,-455,-425,2,4089,12.695645583,11.141850153,1.5537954296,1.136923485,-17.24333952,-16.10641604
2016,Arkansas,Saline County,118703,1345,1350,1071,279,76,945,1021,45,1414,11.437721606,9.0739258073,2.3637957985,0.6439013645,8.0064051241,8.6503064886
2016,Arkansas,Scott County,10277,-233,124,116,8,2,-271,-269,28,79,11.930533507,11.160821667,0.7697118391,0.1924279598,-26.07398855,-25.88156059
2016,Arkansas,Searcy County,7967,117,72,109,-37,3,156,159,-5,71,9.1041284694,13.782638933,-4.678510463,0.3793386862,19.725611684,20.10495037
2016,Arkansas,Sebastian County,127793,203,1712,1236,476,173,-411,-238,-35,2383,13.407313721,9.6795792985,3.7277344224,1.3548278468,-3.218695058,-1.863867211
2016,Arkansas,Sevier County,16910,-316,242,148,94,7,-429,-422,12,173,14.178579798,8.6711975627,5.5073822358,0.410124209,-25.1347551,-24.72463089
2016,Arkansas,Sharp County,17157,226,205,250,-45,7,275,282,-11,189,12.02769303,14.667918329,-2.640225299,0.4107017132,16.134710162,16.545411875
2016,Arkansas,Stone County,12539,109,115,153,-38,-4,159,155,-8,151,9.2114221635,12.255196444,-3.04377428,-0.320397293,12.735792383,12.41539509
2016,Arkansas,Union County,39887,-271,547,533,14,-2,-287,-289,4,524,13.667312137,13.317508901,0.3498032357,-0.049971891,-7.170966331,-7.220938222
2016,Arkansas,Van Buren County,16628,-152,161,234,-73,1,-66,-65,-14,189,9.6384099617,14.00862069,-4.370210728,0.0598659004,-3.951149425,-3.891283525
2016,Arkansas,Washington County,228049,3816,3142,1508,1634,490,1637,2127,55,8312,13.893986495,6.6684059945,7.2255805007,2.1667897462,7.2388465603,9.4056363066
2016,Arkansas,White County,79263,250,982,815,167,68,13,81,2,3575,12.408703783,10.298465971,2.1102378124,0.8592585105,0.1642700094,1.0235285198
2016,Arkansas,Woodruff County,6641,-86,64,99,-35,0,-56,-56,5,106,9.5751047277,14.811490126,-5.236385398,0.0,-8.378216637,-8.378216637
2016,Arkansas,Yell County,21552,-55,250,243,7,10,-66,-56,-6,323,11.585069163,11.260687226,0.3243819366,0.4634027665,-3.058458259,-2.595055492
2016,California,California,39250017,256077,502848,273850,228998,142553,-109023,33530,-6451,813569,12.853337671,6.9999016026,5.8534360679,3.6438085564,-2.786745563,0.8570629934
2016,California,Alameda County,1647704,14957,20018,10695,9323,11548,-5216,6332,-698,36415,12.204419453,6.5204449022,5.6839745511,7.0404953465,-3.180050548,3.8604447986
2016,California,Alpine County,1071,-35,4,5,-1,1,-40,-39,5,24,3.6747818098,4.5934772623,-0.918695452,0.9186954525,-36.7478181,-35.82912265
2016,California,Amador County,37383,357,305,413,-108,17,472,489,-24,3235,8.1979330457,11.100807698,-2.902874652,0.456933973,12.686637369,13.143571342
2016,California,Butte County,226864,1613,2520,2444,76,228,1301,1529,8,5396,11.147606251,10.811408602,0.3361976488,1.0085929465,5.7551729095,6.763765856
2016,California,Calaveras County,45171,331,374,498,-124,22,427,449,6,493,8.3100954328,11.065314239,-2.755218807,0.4888291431,9.4877292775,9.9765584206
2016,California,Colusa County,21588,270,295,127,168,10,100,110,-8,268,13.750990537,5.9199179602,7.8310725773,0.4661352725,4.6613527246,5.127487997
2016,California,Contra Costa County,1135127,11896,12785,8347,4438,3820,4093,7913,-455,10542,11.322385556,7.3920963815,3.9302891747,3.3829888795,3.6247574565,7.0077463361
2016,California,Del Norte County,27540,239,302,246,56,39,148,187,-4,2916,11.013657665,8.9713900184,2.0422676465,1.4222935395,5.3974216371,6.8197151766
2016,California,El Dorado County,185625,1266,1639,1589,50,166,1128,1294,-78,1644,8.8598425878,8.5895606296,0.2702819581,0.897336101,6.0975609756,6.9948970766
2016,California,Fresno County,979915,7785,15767,7049,8718,1721,-2643,-922,-11,17435,16.154340704,7.2221695709,8.9321711333,1.7632790228,-2.707929377,-0.944650354
2016,California,Glenn County,28085,124,395,241,154,15,-26,-11,-19,316,14.095564358,8.6000785069,5.4954858509,0.5352745959,-0.9278093,-0.392534704
2016,California,Humboldt County,136646,1263,1476,1345,131,90,1100,1190,-58,5518,10.851784185,9.8886515776,0.9631326072,0.6616941576,8.0873730374,8.749067195
2016,California,Imperial County,180883,1077,3201,1019,2182,349,-1417,-1068,-37,8870,17.749363025,5.6502970703,12.099065954,1.9351851595,-7.857184444,-5.921999285
2016,California,Inyo County,18144,-107,213,168,45,16,-157,-141,-11,429,11.70490452,9.2320373678,2.4728671521,0.8792416541,-8.627558731,-7.748317077
2016,California,Kern County,884788,5291,14173,6094,8079,1720,-4228,-2508,-280,32350,16.066565209,6.9081809345,9.1583842746,1.9497983602,-4.792876434,-2.843078074
2016,California,Kings County,149785,-546,2324,849,1475,224,-2224,-2000,-21,16201,15.487344893,5.6578123126,9.8295325807,1.4927561343,-14.8209359,-13.32817977
2016,California,Lake County,64116,-330,737,881,-144,17,-187,-170,-16,1136,11.465285232,13.705449511,-2.240164279,0.2644638385,-2.909102223,-2.644638385
2016,California,Lassen County,30870,-463,316,181,135,28,-658,-630,32,7682,10.160281658,5.8196550006,4.3406266579,0.9002781216,-21.15653586,-20.25625774
2016,California,Los Angeles County,10137915,25660,128480,66489,61991,42607,-75168,-32561,-3770,176710,12.689276189,6.5667596865,6.1225165023,4.2080634385,-7.423937676,-3.215874237
2016,California,Madera County,154697,391,2276,1066,1210,189,-996,-807,-12,7504,14.731248564,6.8996093889,7.831639175,1.2232890943,-6.446539354,-5.22325026
2016,California,Marin County,260651,-403,2308,1979,329,852,-1616,-764,32,7958,8.8479121343,7.5866629609,1.2612491734,3.2662136648,-6.195071928,-2.928858263
2016,California,Mariposa County,17410,-143,153,179,-26,20,-159,-139,22,725,8.7521093728,10.239395933,-1.48728656,1.1440665847,-9.095329348,-7.951262763
2016,California,Mendocino County,87628,275,1026,876,150,62,141,203,-78,1991,11.726987502,10.012515645,1.7144718569,0.7086483675,1.6116035455,2.3202519131
2016,California,Merced County,268672,1571,4188,1730,2458,289,-1145,-856,-31,5747,15.63348657,6.4579588744,9.1755276955,1.0788150952,-4.274198215,-3.195383119
2016,California,Modoc County,8795,-138,67,105,-38,11,-133,-122,22,357,7.5586642599,11.84566787,-4.28700361,1.2409747292,-15.00451264,-13.76353791
2016,California,Mono County,13981,96,137,44,93,25,-42,-17,20,322,9.8327711189,3.1579702864,6.6748008326,1.7943012991,-3.014426182,-1.220124883
2016,California,Monterey County,435232,3225,6452,2630,3822,917,-1266,-349,-248,18190,14.879404639,6.0652253877,8.8141792516,2.114757293,-2.919610396,-0.804853103
2016,California,Napa County,142166,312,1483,1296,187,373,-298,75,50,4998,10.442926554,9.126117879,1.3168086754,2.6265755933,-2.098443772,0.5281318217
2016,California,Nevada County,99107,278,847,960,-113,56,432,488,-97,1204,8.5583218818,9.7001050845,-1.141783203,0.5658394633,4.365047288,4.9308867513
2016,California,Orange County,3172532,15959,38433,20520,17913,11747,-12409,-662,-1292,42892,12.144845124,6.4843291429,5.6605159813,3.712057234,-3.921249529,-0.209192295
2016,California,Placer County,380531,6148,3705,3253,452,394,5015,5409,287,3766,9.8156876147,8.6182002188,1.1974873959,1.0438275088,13.286281616,14.330109125
2016,California,Plumas County,18627,226,142,197,-55,13,273,286,-5,280,7.6698714486,10.640596305,-2.970724857,0.7021713298,14.745597926,15.447769256
2016,California,Riverside County,2387741,34849,30845,17092,13753,3099,16961,20060,1036,33834,13.013030116,7.2108513779,5.8021787386,1.3074203382,7.1555844968,8.463004835
2016,California,Sacramento County,1514460,17816,19978,12123,7855,4773,4850,9623,338,22572,13.269551633,8.052196138,5.2173554949,3.1702657896,3.2214098218,6.3916756113
2016,California,San Benito County,59414,941,715,322,393,14,560,574,-26,385,12.130260334,5.4628585001,6.667401834,0.237515587,9.5006234784,9.7381390654
2016,California,San Bernardino County,2140096,17551,31183,14506,16677,2790,-1657,1133,-259,37630,14.630835672,6.8061091703,7.8247265017,1.3090476069,-0.777452288,0.5315953185
2016,California,San Diego County,3317749,27504,44652,22552,22100,14447,-8300,6147,-743,105973,13.514540116,6.8256720572,6.6888680589,4.3725826628,-2.512108819,1.8604738443
2016,California,San Francisco County,870887,8883,9262,6235,3027,7656,-1813,5843,13,23535,10.689650994,7.1960671502,3.4935838434,8.8361010589,-2.092457056,6.743644003
2016,California,San Joaquin County,733709,10213,10239,5701,4538,1424,4156,5580,95,15110,14.052930096,7.824568266,6.2283618297,1.9544264534,5.7040704637,7.658496917
2016,California,San Luis Obispo County,282887,1927,2666,2414,252,220,1375,1595,80,15800,9.4564660271,8.5626065227,0.8938595044,0.7803535356,4.8772095976,5.6575631333
2016,California,San Mateo County,764797,1606,9196,5151,4045,4719,-7418,-2699,260,8668,12.036743744,6.7421995461,5.294544198,6.1767500792,-9.709500336,-3.532750257
2016,California,Santa Barbara County,446170,2355,5841,3216,2625,1493,-1605,-112,-158,18835,13.126063922,7.227088097,5.8989758254,3.3551127266,-3.606802362,-0.251689635
2016,California,Santa Clara County,1919402,9297,23834,10944,12890,17691,-21349,-3658,65,30498,12.44755526,5.7156182245,6.7319370352,9.2393093941,-11.14973807,-1.910428679
2016,California,Santa Cruz County,274673,1046,3006,1877,1129,327,-313,14,-97,13656,10.964800292,6.8466168156,4.1181834762,1.1927776765,-1.141710742,0.0510669342
2016,California,Shasta County,179631,330,2072,2227,-155,217,266,483,2,2828,11.545362353,12.409035695,-0.863673342,1.2091426788,1.4821748966,2.6913175755
2016,California,Sierra County,2947,-36,22,31,-9,2,-25,-23,-4,33,7.4198988196,10.455311973,-3.035413153,0.6745362563,-8.431703204,-7.757166948
2016,California,Siskiyou County,43603,120,422,543,-121,38,236,274,-33,578,9.6915692534,12.470431527,-2.778862274,0.8727005489,5.4199297246,6.2926302735
2016,California,Solano County,440207,5886,5302,3472,1830,1137,2784,3921,135,11318,12.125397929,7.9402832156,4.1851147133,2.6002597973,6.3668630393,8.9671228365
2016,California,Sonoma County,503070,1596,5084,4359,725,592,298,890,-19,10396,10.122005607,8.6785646024,1.4434410041,1.1786442406,0.5933040265,1.7719482671
2016,California,Stanislaus County,541560,6175,7708,4281,3427,868,2012,2880,-132,6413,14.314565739,7.9502667267,6.3642990125,1.611967185,3.7364953642,5.3484625492
2016,California,Sutter County,96651,673,1327,804,523,371,-213,158,-8,737,13.777780085,8.3476527418,5.4301273432,3.8519641383,-2.211505017,1.6404591209
2016,California,Tehama County,63276,203,824,657,167,15,40,55,-19,846,13.043237382,10.399765728,2.6434716539,0.2374375737,0.6331668632,0.8706044369
2016,California,Trinity County,12782,-286,105,169,-64,4,-263,-259,37,385,8.1237911025,13.075435203,-4.951644101,0.3094777563,-20.34816248,-20.03868472
2016,California,Tulare County,460437,2199,7575,3119,4456,262,-2331,-2069,-188,4808,16.491142134,6.7902141671,9.7009279669,0.5703866982,-5.074699976,-4.504313277
2016,California,Tuolumne County,53804,189,472,653,-181,65,335,400,-30,3598,8.7880170175,12.15799812,-3.369981102,1.2102142079,6.2372578408,7.4474720487
2016,California,Ventura County,849738,2019,10348,5996,4352,1468,-3710,-2242,-91,11204,12.192355977,7.0646855856,5.1276703917,1.7296461707,-4.37124475,-2.64159858
2016,California,Yolo County,215802,3600,2454,1336,1118,1128,1277,2405,77,9136,11.46718255,6.242932309,5.2242502407,5.2709787759,5.9672339511,11.238212727
2016,California,Yuba County,75275,976,1175,555,620,147,222,369,-13,1279,15.711286721,7.4210758554,8.2902108655,1.9655822536,2.9684303422,4.9340125958
2016,Colorado,Colorado,5540545,91726,67453,37121,30332,10557,50216,60773,621,118125,12.276051644,6.7558049765,5.5202466676,1.9213122798,9.1390184182,11.060330698
2016,Colorado,Adams County,498187,7513,7197,2998,4199,874,2580,3454,-140,4085,14.556140853,6.063541792,8.4925990609,1.7676903023,5.2181246909,6.9858149932
2016,Colorado,Alamosa County,16654,219,225,112,113,0,102,102,4,1275,13.599685696,6.7696213243,6.8300643718,0.0,6.1651908489,6.1651908489
2016,Colorado,Arapahoe County,637068,7827,7987,4011,3976,2371,1684,4055,-204,4337,12.6146146,6.3349466836,6.2796679168,3.7447416073,2.6596983833,6.4044399906
2016,Colorado,Archuleta County,12854,470,107,94,13,13,449,462,-5,129,8.4792772803,7.4490847135,1.0301925668,1.0301925668,35.581266344,36.611458911
2016,Colorado,Baca County,3568,-31,33,51,-18,0,-13,-13,0,82,9.2088740059,14.231896191,-5.023022185,0.0,-3.627738245,-3.627738245
2016,Colorado,Bent County,5861,-31,36,46,-10,13,-32,-19,-2,1932,6.126095465,7.8277886497,-1.701693185,2.2122011401,-5.445418191,-3.233217051
2016,Colorado,Boulder County,322226,3488,2911,1860,1051,876,1572,2448,-11,11247,9.0831934399,5.8037580894,3.2794353505,2.7333828421,4.9051116755,7.6384945176
2016,Colorado,Broomfield County,66529,1644,735,369,366,95,1142,1237,41,282,11.186022798,5.615840017,5.5701827811,1.4458124705,17.380187803,18.826000274
2016,Colorado,Chaffee County,19058,452,144,171,-27,12,476,488,-9,1447,7.6465590484,9.08028887,-1.433729822,0.637213254,25.276125743,25.913338997
2016,Colorado,Cheyenne County,1848,32,28,15,13,5,12,17,2,42,15.283842795,8.1877729258,7.096069869,2.7292576419,6.5502183406,9.2794759825
2016,Colorado,Clear Creek County,9436,72,55,58,-3,35,-1,34,41,84,5.8510638298,6.170212766,-0.319148936,3.7234042553,-0.106382979,3.6170212766
2016,Colorado,Conejos County,8129,4,119,74,45,8,-51,-43,2,36,14.642549526,9.1054509659,5.5370985604,0.9843730774,-6.275378368,-5.291005291
2016,Colorado,Costilla County,3721,158,26,23,3,6,145,151,4,0,7.1389346513,6.3152114223,0.823723229,1.647446458,39.813289401,41.460735859
2016,Colorado,Crowley County,5694,55,31,32,-1,24,22,46,10,2604,5.4707491397,5.6472249184,-0.176475779,4.2354186888,3.8824671314,8.1178858202
2016,Colorado,Custer County,4602,177,24,37,-13,0,194,194,-4,150,5.3173811898,8.1976293342,-2.880248144,0.0,42.982164617,42.982164617
2016,Colorado,Delta County,30442,492,280,370,-90,22,534,556,26,702,9.2727513578,12.25327858,-2.980527222,0.728573321,17.684461518,18.413034839
2016,Colorado,Denver County,693060,13028,10082,4825,5257,2016,5715,7731,40,16374,14.685104858,7.027934035,7.6571708232,2.936438345,8.3242783441,11.260716689
2016,Colorado,Dolores County,2056,75,20,6,14,0,61,61,0,0,9.908347783,2.9725043349,6.9358434481,0.0,30.220460738,30.220460738
2016,Colorado,Douglas County,328632,6251,3453,1311,2142,566,3397,3963,146,647,10.608083095,4.0275693419,6.5805137532,1.7388285641,10.43604352,12.174872084
2016,Colorado,Eagle County,53989,643,656,108,548,82,-15,67,28,79,12.22341268,2.0123911119,10.211021568,1.527926585,-0.279498766,1.2484278194
2016,Colorado,Elbert County,25231,533,207,131,76,7,445,452,5,73,8.2917743195,5.247451381,3.0443229386,0.2803981654,17.825311943,18.105710108
2016,Colorado,El Paso County,688284,13994,9619,4429,5190,1329,7410,8739,65,18336,14.118866205,6.5009313256,7.6179348791,1.9507197407,10.876473498,12.827193239
2016,Colorado,Fremont County,47446,733,388,547,-159,87,776,863,29,8175,8.2413789441,11.618645058,-3.377266114,1.8479380622,16.482757888,18.33069595
2016,Colorado,Garfield County,58887,1119,794,352,442,33,656,689,-12,883,13.61278985,6.0348892032,7.5779006472,0.5657708628,11.24683897,11.812609832
2016,Colorado,Gilpin County,5931,114,35,25,10,2,88,90,14,49,5.9584610146,4.2560435819,1.7024174328,0.3404834866,14.981273408,15.321756895
2016,Colorado,Grand County,15008,428,108,61,47,5,368,373,8,223,7.3002568609,4.123293227,3.1769636339,0.3379748547,24.874949304,25.212924158
2016,Colorado,Gunnison County,16408,271,147,68,79,-3,191,188,4,1058,9.0336457213,4.1788293133,4.8548164081,-0.184360117,11.7375941,11.553233984
2016,Colorado,Hinsdale County,788,19,8,5,3,0,11,11,5,56,10.276172126,6.4226075787,3.8535645472,0.0,14.129736673,14.129736673
2016,Colorado,Huerfano County,6677,218,46,91,-45,4,246,250,13,165,7.0036540804,13.855054811,-6.851400731,0.6090133983,37.454323995,38.063337393
2016,Colorado,Jackson County,1357,5,10,9,1,0,-2,-2,6,2,7.3827980805,6.6445182724,0.738279808,0.0,-1.476559616,-1.476559616
2016,Colorado,Jefferson County,571837,6694,5981,4460,1521,592,4767,5359,-186,8178,10.520853489,7.845344685,2.675508804,1.041355169,8.3853717743,9.4267269433
2016,Colorado,Kiowa County,1373,-41,15,14,1,0,-49,-49,7,14,10.764262648,10.046645138,0.7176175099,0.0,-35.16325798,-35.16325798
2016,Colorado,Kit Carson County,8195,-39,105,79,26,7,-81,-74,9,1030,12.782275245,9.6171404224,3.1651348226,0.852151683,-9.860612332,-9.008460649
2016,Colorado,Lake County,7618,157,84,24,60,1,81,82,15,146,11.141322369,3.1832349625,7.9580874063,0.1326347901,10.743417999,10.876052789
2016,Colorado,La Plata County,55623,853,582,355,227,36,616,652,-26,1914,10.544146821,6.4315672189,4.112579602,0.6522152673,11.160127907,11.812343174
2016,Colorado,Larimer County,339993,6124,3591,2182,1409,560,4028,4588,127,9367,10.657968545,6.4761034158,4.1818651297,1.6620613716,11.954970009,13.61703138
2016,Colorado,Las Animas County,14103,36,119,161,-42,12,68,80,-2,867,8.4487042953,11.430599929,-2.981895634,0.851970181,4.8278310259,5.679801207
2016,Colorado,Lincoln County,5643,92,63,50,13,5,68,73,6,1018,11.256030016,8.9333571556,2.3226728605,0.8933357156,12.149365732,13.042701447
2016,Colorado,Logan County,21919,-27,228,191,37,25,-75,-50,-14,3278,10.395531745,8.7085375584,1.6869941867,1.139860937,-3.419582811,-2.279721874
2016,Colorado,Mesa County,150083,1682,1787,1455,332,25,1203,1228,122,4437,11.973841144,9.7492662923,2.2245748516,0.1675131665,8.0607335737,8.2282467402
2016,Colorado,Mineral County,732,8,4,2,2,0,5,5,1,0,5.4945054945,2.7472527473,2.7472527473,0.0,6.8681318681,6.8681318681
2016,Colorado,Moffat County,13109,210,182,80,102,7,106,113,-5,102,13.995693633,6.1519532452,7.8437403876,0.538295909,8.1513380498,8.6896339588
2016,Colorado,Montezuma County,26999,846,338,263,75,17,720,737,34,243,12.718242023,9.8961468995,2.8220951234,0.6396748946,27.092113185,27.731788079
2016,Colorado,Montrose County,41471,671,459,447,12,26,606,632,27,542,11.158245311,10.86652648,0.2917188317,0.6320574686,14.731800999,15.363858468
2016,Colorado,Morgan County,28274,-49,447,248,199,84,-313,-229,-19,564,15.795890242,8.7637153913,7.0321748503,2.9683552132,-11.06065693,-8.092301712
2016,Colorado,Otero County,18295,11,196,219,-23,3,44,47,-13,457,10.716531343,11.974083491,-1.257552147,0.164028541,2.4057519342,2.5697804751
2016,Colorado,Ouray County,4857,197,23,29,-6,4,191,195,8,0,4.833455921,6.0943574656,-1.260901545,0.8406010297,40.13869917,40.9793002
2016,Colorado,Park County,17166,585,102,103,-1,8,540,548,38,92,6.0449817762,6.1042463034,-0.059264527,0.4741162177,32.002844697,32.476960915
2016,Colorado,Phillips County,4288,-38,61,56,5,12,-58,-46,3,59,14.162990481,13.002089622,1.1609008591,2.7861620618,-13.46644997,-10.6802879
2016,Colorado,Pitkin County,17752,-30,127,41,86,71,-225,-154,38,72,7.1480835256,2.3076490122,4.8404345134,3.9961726797,-12.66392751,-8.667754826
2016,Colorado,Prowers County,11922,-27,163,112,51,13,-113,-100,22,342,13.656738302,9.383771103,4.2729671987,1.0891877173,-9.467554774,-8.378367056
2016,Colorado,Pueblo County,165123,2006,1926,1765,161,69,1704,1773,72,4149,11.735315623,10.754326103,0.9809895199,0.4204240799,10.382646844,10.803070924
2016,Colorado,Rio Blanco County,6545,-3,77,39,38,14,-62,-48,7,296,11.762010234,5.9573818071,5.8046284274,2.1385473154,-9.470709539,-7.332162224
2016,Colorado,Rio Grande County,11479,12,139,124,15,-6,6,0,-3,198,12.115401377,10.807983962,1.3074174148,-0.522966966,0.5229669659,0.0
2016,Colorado,Routt County,24648,323,220,115,105,69,148,217,1,349,8.984542503,4.6964653993,4.2880771037,2.8178792396,6.0441467748,8.8620260143
2016,Colorado,Saguache County,6389,180,66,55,11,5,151,156,13,18,10.477853628,8.7315446896,1.7463089379,0.79377679,23.972059057,24.765835847
2016,Colorado,San Juan County,694,0,4,4,0,0,0,0,0,0,5.7636887608,5.7636887608,0.0,0.0,0.0,0.0
2016,Colorado,San Miguel County,8017,168,65,19,46,24,92,116,6,9,8.1936215807,2.3950586159,5.7985629648,3.025337199,11.59712593,14.622463129
2016,Colorado,Sedgwick County,2407,22,18,39,-21,1,37,38,5,35,7.5125208681,16.277128548,-8.764607679,0.4173622705,15.442404007,15.859766277
2016,Colorado,Summit County,30374,482,295,60,235,67,141,208,39,273,9.7899313045,1.9911724687,7.7987588358,2.2234759234,4.6792553015,6.9027312249
2016,Colorado,Teller County,24043,714,194,172,22,-7,710,703,-11,132,8.1904922739,7.2616735624,0.9288187115,-0.295533226,29.975512961,29.679979735
2016,Colorado,Washington County,4908,48,47,49,-2,1,49,50,0,184,9.6232596233,10.032760033,-0.40950041,0.2047502048,10.032760033,10.237510238
2016,Colorado,Weld County,294932,9879,4106,1725,2381,309,6991,7300,198,4944,14.15898687,5.9484297008,8.2105571696,1.0655447986,24.107520022,25.173064821
2016,Colorado,Yuma County,10103,8,128,95,33,21,-42,-21,-4,262,12.67452223,9.4068719675,3.2676502624,2.0794138033,-4.158827607,-2.079413803
2016,Connecticut,Connecticut,3576452,-8278,35848,30638,5210,17058,-29880,-12822,-666,114956,10.011755043,8.5566879881,1.4550670546,4.7640180071,-8.344991092,-3.580973085
2016,Connecticut,Fairfield County,944177,-497,10050,6800,3250,5785,-9787,-4002,255,19530,10.641389924,7.2001444264,3.4412454979,6.1254169863,-10.36291375,-4.237496764
2016,Connecticut,Hartford County,892389,-2303,9349,8201,1148,4743,-8084,-3341,-110,27001,10.462872136,9.1780954529,1.2847766833,5.3080973946,-9.047155669,-3.739058274
2016,Connecticut,Litchfield County,182571,-1205,1423,1780,-357,274,-970,-696,-152,2604,7.7685909807,9.7175628571,-1.948971876,1.4958495634,-5.295525827,-3.799676263
2016,Connecticut,Middlesex County,163329,-248,1356,1483,-127,337,-360,-23,-98,4643,8.2959627538,9.0729445162,-0.776981762,2.0617547552,-2.202467988,-0.140713233
2016,Connecticut,New Haven County,856875,-2198,8781,7924,857,4100,-6809,-2709,-346,29511,10.234575873,9.2357111055,0.9988647675,4.7786995876,-7.936137925,-3.157438337
2016,Connecticut,New London County,269801,-838,2676,2465,211,992,-1844,-852,-197,11503,9.9030419658,9.1221967286,0.7808452372,3.6710828214,-6.824069277,-3.152986455
2016,Connecticut,Tolland County,151118,-566,1158,990,168,469,-1195,-726,-8,15383,7.6485624269,6.5389264272,1.1096359998,3.0977338327,-7.892946546,-4.795212713
2016,Connecticut,Windham County,116192,-423,1055,995,60,358,-831,-473,-10,4781,9.0633013612,8.5478529426,0.5154484186,3.0755088979,-7.138960598,-4.0634517
2016,Delaware,Delaware,952065,7989,10922,8945,1977,2556,3027,5583,429,25059,11.52024032,9.4349523585,2.0852879612,2.6960020378,3.1928005354,5.8888025732
2016,Delaware,Kent County,174827,1294,2147,1651,496,284,402,686,112,4719,12.326329085,9.4787001952,2.8476288897,1.6304971868,2.3079572856,3.9384544724
2016,Delaware,New Castle County,556987,1820,6492,4732,1760,1915,-1545,370,-310,17411,11.674642181,8.5096128774,3.1650293035,3.4437676797,-2.778392201,0.6653754786
2016,Delaware,Sussex County,220251,4875,2283,2562,-279,357,4170,4527,627,2929,10.481443988,11.762356328,-1.28091234,1.6390168653,19.144818847,20.783835713
2016,District of Columbia,District of Columbia,681170,10793,9779,5455,4324,4116,2276,6392,77,39769,14.470824914,8.0722313024,6.3985936116,6.0907981742,3.3679923821,9.4587905563
2016,District of Columbia,District of Columbia,681170,10793,9779,5455,4324,4116,2276,6392,77,39769,14.470824914,8.0722313024,6.3985936116,6.0907981742,3.3679923821,9.4587905563
2016,Florida,Florida,20612439,367525,222793,201485,21308,118831,207155,325986,20231,433717,10.905894956,9.8628513697,1.0430435863,5.8168721797,10.14040239,15.957274569
2016,Florida,Alachua County,263496,4094,2937,1964,973,1215,1766,2981,140,13900,11.233548417,7.5119813042,3.7215671125,4.6471778435,6.7546634334,11.401841277
2016,Florida,Baker County,27937,513,344,243,101,17,400,417,-5,2632,12.427521179,8.7787431585,3.6487780206,0.6141507559,14.450606022,15.064756778
2016,Florida,Bay County,183974,2027,2346,1913,433,356,1184,1540,54,3985,12.822439816,10.455808767,2.3666310488,1.945775181,6.471342175,8.4171173559
2016,Florida,Bradford County,26926,-9,288,331,-43,20,8,28,6,3262,10.694194315,12.290896938,-1.596702623,0.742652383,0.2970609532,1.0397133362
2016,Florida,Brevard County,579130,11196,5317,7040,-1723,1305,10823,12128,791,6570,9.27062483,12.274816401,-3.004191571,2.275374347,18.870786634,21.146160981
2016,Florida,Broward County,1909632,22351,22170,15864,6306,14844,1357,16201,-156,16914,11.677907816,8.3562620476,3.3216457685,7.8189834742,0.7147912001,8.5337746743
2016,Florida,Calhoun County,14423,-45,139,145,-6,6,-43,-37,-2,1841,9.6223737496,10.037728012,-0.415354263,0.4153542626,-2.976705548,-2.561351286
2016,Florida,Charlotte County,178465,5271,1044,2658,-1614,354,5800,6154,731,3227,5.937570203,15.116917241,-9.179347038,2.0133140343,32.986501128,34.999815162
2016,Florida,Citrus County,143621,2647,1017,2577,-1560,105,3697,3802,405,2250,7.1469983661,18.109945712,-10.96294735,0.7378906868,25.980779704,26.718670391
2016,Florida,Clay County,208311,4928,2163,1755,408,391,3911,4302,218,1250,10.50780434,8.5257497073,1.9820546328,1.8994690231,18.999548208,20.899017231
2016,Florida,Collier County,365136,8566,3270,3490,-220,2142,5292,7434,1352,4545,9.0618617553,9.6715282955,-0.60966654,5.9359351315,14.665251501,20.601186633
2016,Florida,Columbia County,69299,1013,815,799,16,36,934,970,27,5032,11.847221717,11.614638224,0.2325834938,0.5233128611,13.577061453,14.100374314
2016,Florida,DeSoto County,35800,445,372,312,60,169,191,360,25,3744,10.456046659,8.7695875202,1.6864591385,4.7501932401,5.3685615909,10.118754831
2016,Florida,Dixie County,16300,113,151,207,-56,4,176,180,-11,1721,9.2960261027,12.743558962,-3.447532859,0.2462523471,10.835103272,11.081355619
2016,Florida,Duval County,926255,14174,12763,8379,4384,3304,6165,9469,321,20988,13.885383303,9.1158525971,4.769530706,3.5945550759,6.7071525554,10.301707631
2016,Florida,Escambia County,315187,3951,3847,3478,369,719,2736,3455,127,19670,12.282435351,11.104317689,1.1781176617,2.2955734384,8.7353114429,11.030884881
2016,Florida,Flagler County,108310,3122,828,1231,-403,235,2991,3226,299,684,7.7565129416,11.531723951,-3.775211009,2.2014257745,28.018997836,30.220423611
2016,Florida,Franklin County,11901,152,98,108,-10,13,141,154,8,1793,8.2875264271,9.133192389,-0.845665962,1.0993657505,11.923890063,13.023255814
2016,Florida,Gadsden County,46006,-26,532,496,36,60,-108,-48,-14,3498,11.560442426,10.778156848,0.7822855777,1.3038092962,-2.346856733,-1.043047437
2016,Florida,Gilchrist County,17212,31,183,185,-2,12,25,37,-4,792,10.641700346,10.758003082,-0.116302736,0.6978164161,1.4537842003,2.1516006164
2016,Florida,Glades County,13970,363,69,132,-63,58,315,373,53,1481,5.0041701418,9.5731950538,-4.569024912,4.2064038873,22.84512456,27.051528448
2016,Florida,Gulf County,15990,116,116,168,-52,9,169,178,-10,3334,7.2809440121,10.544815466,-3.263871454,0.5649008285,10.607582224,11.172483053
2016,Florida,Hamilton County,14361,58,152,117,35,23,9,32,-9,2705,10.605637734,8.1635500977,2.4420876361,1.6048004466,0.6279653921,2.2327658387
2016,Florida,Hardee County,27360,108,397,181,216,77,-171,-94,-14,1931,14.538929173,6.6285797993,7.9103493738,2.8198930638,-6.262359921,-3.442466857
2016,Florida,Hendry County,39290,400,600,300,300,162,-68,94,6,694,15.349194167,7.6745970837,7.6745970837,4.1442824252,-1.739575339,2.4047070862
2016,Florida,Hernando County,182835,4509,1547,2713,-1166,184,5099,5283,392,1790,8.5668164614,15.023770562,-6.456954101,1.0189361531,28.236714374,29.255650527
2016,Florida,Highlands County,100917,1470,931,1485,-554,284,1539,1823,201,1734,9.2930865824,14.8230221,-5.529935517,2.8348405901,15.362041085,18.196881675
2016,Florida,Hillsborough County,1376238,29161,17345,11179,6166,7774,14806,22580,415,23019,12.738151848,8.2098471899,4.5283046581,5.7092183607,10.873512612,16.582730973
2016,Florida,Holmes County,19487,158,204,242,-38,7,197,204,-8,1805,10.511129431,12.469084913,-1.957955482,0.3606760099,10.150453421,10.511129431
2016,Florida,Indian River County,151563,3771,1284,2050,-766,298,3530,3828,709,1324,8.5784436539,13.69611331,-5.117669656,1.9909472032,23.584039017,25.57498622
2016,Florida,Jackson County,48229,-361,494,623,-129,19,-213,-194,-38,8098,10.2046086,12.869374813,-2.664766213,0.3924849461,-4.399962817,-4.007477871
2016,Florida,Jefferson County,13906,-165,123,149,-26,0,-131,-131,-8,1175,8.7929370554,10.651606677,-1.858669621,0.0,-9.364835401,-9.364835401
2016,Florida,Lafayette County,8617,-11,65,69,-4,5,-11,-6,-1,1708,7.5384169324,8.0023195129,-0.46390258,0.5798782256,-1.275732096,-0.695853871
2016,Florida,Lake County,335396,9878,3279,4130,-851,763,8963,9726,1003,3634,9.9226223079,12.497843895,-2.575221587,2.3089237026,27.123044753,29.431968456
2016,Florida,Lee County,722336,22051,6666,7324,-658,3011,17769,20780,1929,8473,9.3714348375,10.296487961,-0.925053124,4.2330318476,24.980651909,29.213683757
2016,Florida,Leon County,287822,1635,3070,1838,1232,770,-474,296,107,14838,10.696696393,6.4040807723,4.292615621,2.6828847631,-1.651542049,1.0313427141
2016,Florida,Levy County,39961,273,399,545,-146,35,391,426,-7,334,10.018958179,13.685043127,-3.666084948,0.8788559806,9.818076812,10.696932793
2016,Florida,Liberty County,8202,-121,84,61,23,-1,-150,-151,7,2014,10.166414523,7.3827534039,2.7836611195,-0.121028744,-18.15431165,-18.27534039
2016,Florida,Madison County,18224,-174,192,226,-34,10,-137,-127,-13,1927,10.485500519,12.342307902,-1.856807384,0.5461198187,-7.481841516,-6.935721697
2016,Florida,Manatee County,375888,12778,3590,4001,-411,1378,10852,12230,959,4813,9.7158585003,10.828175448,-1.112316948,3.7293740984,29.369497617,33.098871715
2016,Florida,Marion County,349020,5506,3509,4824,-1315,628,5668,6296,525,8967,10.133798485,13.931445965,-3.79764748,1.8136293669,16.36887142,18.182500787
2016,Florida,Martin County,158701,2897,1279,1966,-687,166,2982,3148,436,4206,8.1334160029,12.502185975,-4.368769972,1.0556270965,18.963132542,20.018759638
2016,Florida,Miami-Dade County,2712945,20352,31772,21405,10367,41830,-30560,11270,-1285,41977,11.755351641,7.9196557308,3.8356959104,15.476720356,-11.30692264,4.1697977149
2016,Florida,Monroe County,79077,349,748,778,-30,441,10,451,-72,3236,9.4800544976,9.8602705871,-0.380216089,5.5891765153,0.1267386965,5.7159152118
2016,Florida,Nassau County,80622,2152,779,862,-83,71,1930,2001,234,543,9.7930757046,10.836497121,-1.043421417,0.8925653081,24.26269077,25.155256078
2016,Florida,Okaloosa County,201170,2489,2843,1870,973,368,1035,1403,113,4618,14.220297061,9.3534841729,4.8668128878,1.8406856554,5.1769284058,7.0176140612
2016,Florida,Okeechobee County,40314,905,538,403,135,80,697,777,-7,2905,13.496732436,10.110005895,3.3867265406,2.0069490611,17.485543695,19.492492756
2016,Florida,Orange County,1314367,29503,16721,8198,8523,11078,10083,21161,-181,34839,12.866113093,6.3080195642,6.5580935284,8.5240596161,7.7584485565,16.282508173
2016,Florida,Osceola County,336015,12987,4296,2191,2105,4310,6172,10482,400,3265,13.037085592,6.6490350402,6.3880505521,13.079571439,18.730189077,31.809760516
2016,Florida,Palm Beach County,1443810,21967,14696,15207,-511,8443,12473,20916,1562,21197,10.256650055,10.613287792,-0.356637737,5.8925487489,8.7051712123,14.597719961
2016,Florida,Pasco County,512368,15076,5026,6099,-1073,953,14173,15126,1023,5904,9.9558267139,12.081294693,-2.125467979,1.8877641978,28.074797457,29.962561654
2016,Florida,Pinellas County,960730,12339,8674,12517,-3843,2620,12615,15235,947,19766,9.0869043921,13.112840936,-4.025936544,2.7447186428,13.215505984,15.960224627
2016,Florida,Polk County,666149,16724,7678,6786,892,2909,12152,15061,771,13208,11.672471484,10.316409415,1.3560620687,4.4224042129,18.474065313,22.896469526
2016,Florida,Putnam County,72277,367,804,951,-147,27,555,582,-68,1396,11.152184316,13.19120309,-2.039018774,0.3745136524,7.6983361884,8.0728498408
2016,Florida,St. Johns County,235087,8429,2199,1898,301,213,7284,7497,631,2815,9.5247376799,8.2209877746,1.3037499053,0.9225871423,31.549881428,32.47246857
2016,Florida,St. Lucie County,306507,8200,3078,3281,-203,799,6777,7576,827,3049,10.178335819,10.849616576,-0.671280757,2.6421346067,22.410195531,25.052330138
2016,Florida,Santa Rosa County,170497,3647,1883,1445,438,133,2987,3120,89,6556,11.163579341,8.5668466001,2.5967327411,0.788505604,17.708768716,18.49727432
2016,Florida,Sarasota County,412569,7666,2955,5771,-2816,847,8061,8908,1574,5789,7.2296054177,14.119138026,-6.889532608,2.0722422297,19.721776403,21.794018633
2016,Florida,Seminole County,455479,6757,4553,3532,1021,1330,4223,5553,183,3516,10.070769663,7.812422238,2.258347425,2.9418237759,9.3408434629,12.282667239
2016,Florida,Sumter County,123996,5114,501,1742,-1241,55,4873,4928,1427,8203,4.1255280429,14.344650401,-10.21912236,0.4529022802,40.127142022,40.580044302
2016,Florida,Suwannee County,43794,143,425,566,-141,35,235,270,14,3227,9.7203956773,12.94527989,-3.224884213,0.8005031734,5.3748070216,6.175310195
2016,Florida,Taylor County,22175,-296,227,244,-17,20,-283,-263,-16,2983,10.168884111,10.930430498,-0.761546387,0.895936926,-12.6775075,-11.78157058
2016,Florida,Union County,15142,-38,144,218,-74,15,22,37,-1,4925,9.4980542181,14.378998747,-4.880944529,0.9893806477,1.4510916166,2.4404722644
2016,Florida,Volusia County,529364,11174,4886,6920,-2034,1203,10990,12193,1015,13659,9.3283973905,13.211729419,-3.883332029,2.2967789727,20.982211896,23.278990868
2016,Florida,Wakulla County,31893,377,333,233,100,16,251,267,10,3296,10.503240865,7.349114479,3.1541263858,0.5046602217,7.9168572285,8.4215174502
2016,Florida,Walton County,65889,2430,775,585,190,59,2070,2129,111,1985,11.983177165,9.0453659894,2.9378111761,0.912267681,32.006679655,32.918947336
2016,Florida,Washington County,24569,-102,240,285,-45,9,-50,-41,-16,2558,9.7481722177,11.575954509,-1.827782291,0.3655564582,-2.030869212,-1.665312754
2016,Georgia,Georgia,10310371,110973,130862,81525,49337,23831,36781,60612,1024,256905,12.760943334,7.9498701326,4.8110732013,2.3238682015,3.5866810592,5.9105492607
2016,Georgia,Appling County,18428,-9,250,214,36,2,-35,-33,-12,407,13.563000136,11.609928116,1.9530720195,0.1085040011,-1.898820019,-1.790316018
2016,Georgia,Atkinson County,8273,-77,149,61,88,12,-192,-180,15,21,17.926968658,7.3392287794,10.587739878,1.4437827107,-23.10052337,-21.65674066
2016,Georgia,Bacon County,11372,91,144,109,35,10,47,57,-1,325,12.713547874,9.6234494327,3.0900984417,0.8828852691,4.1495607646,5.0324460336
2016,Georgia,Baker County,3150,-10,32,27,5,4,-20,-16,1,0,10.142630745,8.557844691,1.5847860539,1.2678288431,-6.339144216,-5.071315372
2016,Georgia,Baldwin County,45144,-287,442,452,-10,38,-301,-263,-14,5715,9.7598675131,9.9806789953,-0.220811482,0.8390836323,-6.646425614,-5.807341982
2016,Georgia,Banks County,18397,-71,216,154,62,9,-134,-125,-8,0,11.718432117,8.3548080835,3.3636240336,0.4882680049,-7.269768073,-6.781500068
2016,Georgia,Barrow County,77126,2019,1074,588,486,44,1411,1455,78,288,14.109949879,7.7250004927,6.3849493868,0.5780612614,18.537373631,19.115434893
2016,Georgia,Bartow County,103807,1274,1298,882,416,58,837,895,-37,968,12.581176699,8.5489968014,4.0321798973,0.562178928,8.1128234952,8.6750024232
2016,Georgia,Ben Hill County,17243,-111,236,224,12,-3,-115,-118,-5,296,13.642801399,12.949099633,0.693701766,-0.173425442,-6.647975258,-6.821400699
2016,Georgia,Berrien County,18993,27,263,216,47,17,-24,-7,-13,188,13.857056298,11.380700229,2.4763560684,0.8957032588,-1.264522248,-0.368818989
2016,Georgia,Bibb County,152760,-780,2248,1742,506,227,-1449,-1222,-64,6108,14.67841985,11.374469474,3.3039503754,1.4822069866,-9.461312439,-7.979105452
2016,Georgia,Bleckley County,12970,188,129,132,-3,11,177,188,3,1376,10.018639329,10.251630941,-0.232991612,0.8543025784,13.746505126,14.600807704
2016,Georgia,Brantley County,18355,-94,208,197,11,-5,-101,-106,1,58,11.303119226,10.705358113,0.5977611129,-0.271709597,-5.488533855,-5.760243452
2016,Georgia,Brooks County,15687,-5,177,201,-24,10,3,13,6,176,11.281430256,12.811115714,-1.529685458,0.637368941,0.1912106823,0.8285796233
2016,Georgia,Bryan County,36230,1178,545,240,305,58,762,820,53,98,15.291377907,6.7338177941,8.5575601134,1.6273393002,21.379871496,23.007210797
2016,Georgia,Bulloch County,74722,1509,894,531,363,171,993,1164,-18,5352,12.086389293,7.1788285396,4.907560753,2.3118261399,13.424814953,15.736641092
2016,Georgia,Burke County,22688,-54,298,247,51,-1,-96,-97,-8,246,13.119084306,10.873871891,2.2452124147,-0.044023773,-4.226282192,-4.270305965
2016,Georgia,Butts County,23817,269,259,249,10,6,236,242,17,2662,10.936345403,10.514092684,0.4222527183,0.253351631,9.9651641507,10.218515782
2016,Georgia,Calhoun County,6324,-141,55,45,10,7,-165,-158,7,1642,8.6011416061,7.0372976777,1.5638439284,1.0946907499,-25.80342482,-24.70873407
2016,Georgia,Camden County,53008,465,767,323,444,68,-83,-15,36,2420,14.533258804,6.1202641377,8.4129946661,1.2884766606,-1.572699453,-0.284222793
2016,Georgia,Candler County,10910,-25,131,137,-6,12,-30,-18,-1,264,11.993591211,12.542915999,-0.549324788,1.0986495766,-2.746623941,-1.647974365
2016,Georgia,Carroll County,116261,1572,1512,1046,466,146,979,1125,-19,3933,13.093743234,9.0582377138,4.0355055207,1.2643429314,8.4780255467,9.742368478
2016,Georgia,Catoosa County,66398,501,707,656,51,38,378,416,34,502,10.688234627,9.917230432,0.7710041952,0.574473714,5.7145016818,6.2889753959
2016,Georgia,Charlton County,12497,-512,118,81,37,12,-573,-561,12,2492,9.2527248491,6.3514467184,2.9012781306,0.9409550694,-44.93060456,-43.98964949
2016,Georgia,Chatham County,289082,2460,4059,2479,1580,792,127,919,-39,13823,14.100996345,8.6120645332,5.4889318122,2.751413921,0.4411989495,3.1926128705
2016,Georgia,Chattahoochee County,10922,-540,199,25,174,161,-889,-728,14,3277,17.780557541,2.2337383846,15.546819157,14.385275197,-79.43173695,-65.04646176
2016,Georgia,Chattooga County,24824,-58,305,286,19,6,-75,-69,-8,1332,12.272160303,11.507665071,0.764495232,0.2414195469,-3.017744337,-2.77632479
2016,Georgia,Cherokee County,241689,6080,2763,1465,1298,170,4346,4516,266,1657,11.577672649,6.1387225591,5.4389500899,0.7123432321,18.210845216,18.923188448
2016,Georgia,Clarke County,124707,1078,1387,771,616,431,28,459,3,10212,11.170349849,6.2093292958,4.9610205528,3.471103666,0.2255009342,3.6966046002
2016,Georgia,Clay County,3020,-60,31,35,-4,0,-57,-57,1,55,10.163934426,11.475409836,-1.31147541,0.0,-18.68852459,-18.68852459
2016,Georgia,Clayton County,279462,5895,3976,1676,2300,802,2881,3683,-88,4301,14.378992783,6.061164966,8.3178278173,2.9003903954,10.418983453,13.319373848
2016,Georgia,Clinch County,6829,-56,101,58,43,16,-117,-101,2,139,14.729473531,8.4585095523,6.2709639784,2.3333819455,-17.06285548,-14.72947353
2016,Georgia,Cobb County,748150,8006,9713,4469,5244,2419,540,2959,-197,9361,13.0525286,6.0055338529,7.046994747,3.2507018103,0.7256630746,3.9763648849
2016,Georgia,Coffee County,43012,-59,576,396,180,65,-305,-240,1,3112,13.382433233,9.2004228477,4.1820103853,1.5101704169,-7.086184264,-5.576013847
2016,Georgia,Colquitt County,45708,-47,623,453,170,81,-304,-223,6,926,13.622995091,9.9056449056,3.7173501853,1.7712080295,-6.647496802,-4.876288773
2016,Georgia,Columbia County,147450,3370,1710,907,803,296,2202,2498,69,688,11.731211196,6.2223441841,5.508867012,2.0306657977,15.106507049,17.137172847
2016,Georgia,Cook County,17167,82,220,210,10,11,73,84,-12,142,12.845965199,12.26205769,0.5839075091,0.64229826,4.2625248161,4.904823076
2016,Georgia,Coweta County,140526,2248,1680,992,688,163,1381,1544,16,499,12.051477023,7.1161102423,4.935366781,1.1692802112,9.9066010531,11.075881264
2016,Georgia,Crawford County,12322,-89,101,116,-15,9,-83,-74,0,135,8.1672259734,9.3801803259,-1.212954352,0.7277726115,-6.71168075,-5.983908139
2016,Georgia,Crisp County,22721,-129,292,267,25,14,-155,-141,-13,412,12.815167541,11.717978539,1.0971890018,0.614425841,-6.802571811,-6.18814597
2016,Georgia,Dade County,16257,55,159,182,-23,1,87,88,-10,974,9.7969746449,11.214147078,-1.417172433,0.0616161927,5.360608768,5.4222249607
2016,Georgia,Dawson County,23604,348,255,196,59,-5,256,251,38,139,10.883482714,8.3653435766,2.5181391379,-0.213401622,10.926163039,10.712761417
2016,Georgia,Decatur County,26822,-361,351,332,19,-4,-388,-392,12,961,12.998796408,12.295157856,0.703638552,-0.148134432,-14.3690399,-14.51717434
2016,Georgia,DeKalb County,740321,7563,11028,4645,6383,4903,-3680,1223,-43,11804,14.972720404,6.3065185234,8.6662018806,6.6568052358,-4.996337603,1.6604676328
2016,Georgia,Dodge County,20563,-300,214,236,-22,2,-267,-265,-13,1755,10.331675759,11.39381065,-1.062134891,0.0965577174,-12.89045527,-12.79389755
2016,Georgia,Dooly County,13763,-160,94,110,-16,19,-157,-138,-6,1869,6.7904355992,7.9462544246,-1.155818825,1.3725348552,-11.34147222,-9.968937369
2016,Georgia,Dougherty County,90017,-1242,1234,949,285,63,-1608,-1545,18,4062,13.614598733,10.470222203,3.1443765308,0.6950727068,-17.74090337,-17.04583067
2016,Georgia,Douglas County,142224,1553,1771,1019,752,207,625,832,-31,1327,12.520546493,7.2040863218,5.3164601707,1.4634404991,4.4186005408,5.88204104
2016,Georgia,Early County,10339,-148,133,135,-2,1,-152,-151,5,107,12.772495919,12.964563526,-0.192067608,0.0960338039,-14.59713819,-14.50110439
2016,Georgia,Echols County,3962,-83,39,17,22,10,-118,-108,3,0,9.7414762083,4.2462845011,5.4951917073,2.4978144124,-29.47421007,-26.97639565
2016,Georgia,Effingham County,58712,1557,757,416,341,39,1144,1183,33,590,13.066705792,7.180646776,5.8860590159,0.6731856353,19.746778634,20.419964269
2016,Georgia,Elbert County,19143,-159,213,260,-47,0,-110,-110,-2,269,11.080764729,13.525816101,-2.445051372,0.0,-5.722460658,-5.722460658
2016,Georgia,Emanuel County,22635,-24,306,269,37,-1,-55,-56,-5,1035,13.511723407,11.87795293,1.6337704773,-0.044155959,-2.428577737,-2.472733695
2016,Georgia,Evans County,10670,-54,137,128,9,-3,-55,-58,-5,389,12.807329158,11.965971768,0.8413573899,-0.280452463,-5.141628494,-5.422080957
2016,Georgia,Fannin County,24900,615,216,310,-94,-5,671,666,43,160,8.7831655993,12.605469147,-3.822303548,-0.203314019,27.284741283,27.081427264
2016,Georgia,Fayette County,111627,1081,915,876,39,193,832,1025,17,502,8.2368244566,7.8857466929,0.3510777637,1.7373848307,7.4896589595,9.2270437902
2016,Georgia,Floyd County,96560,257,1170,1097,73,113,97,210,-26,3830,12.132964851,11.375950804,0.7570140462,1.1718162634,1.0058953765,2.1777116399
2016,Georgia,Forsyth County,221009,8884,2288,1201,1087,341,6991,7332,465,696,10.564859836,5.5456279119,5.0192319236,1.5745704563,32.281003108,33.855573564
2016,Georgia,Franklin County,22320,1,263,275,-12,11,16,27,-14,773,11.783418087,12.32106454,-0.537646453,0.4928425816,0.7168619369,1.2097045185
2016,Georgia,Fulton County,1023336,15533,13237,7157,6080,4095,5447,9542,-89,32634,13.034066108,7.0472774143,5.9867886934,4.0322203453,5.3634930943,9.3957134396
2016,Georgia,Gilmer County,29733,357,312,330,-18,56,296,352,23,187,10.556768005,11.165812313,-0.609044308,1.8948045137,10.015395287,11.9101998
2016,Georgia,Glascock County,3006,-28,27,27,0,1,-34,-33,5,84,8.940397351,8.940397351,0.0,0.3311258278,-11.25827815,-10.92715232
2016,Georgia,Glynn County,84502,868,986,871,115,178,533,711,42,1303,11.728600657,10.360660418,1.3679402389,2.1173335871,6.3401056288,8.4574392159
2016,Georgia,Gordon County,56904,581,709,526,183,51,340,391,7,641,12.523514709,9.2910701511,3.2324445583,0.9008452048,6.0056346984,6.9064799032
2016,Georgia,Grady County,24808,-316,313,245,68,-3,-367,-370,-14,167,12.537050389,9.8133461508,2.7237042378,-0.120163422,-14.69999199,-14.82015541
2016,Georgia,Greene County,17003,269,164,209,-45,31,255,286,28,157,9.7222633903,12.389957613,-2.667694223,1.8377449092,15.11693393,16.954678839
2016,Georgia,Gwinnett County,907135,14209,11630,4382,7248,3545,3680,7225,-264,4847,12.921784317,4.8687238932,8.0530604241,3.9387554088,4.0887503257,8.0275057345
2016,Georgia,Habersham County,44246,320,494,441,53,5,280,285,-18,2507,11.20537132,10.003175611,1.2021957084,0.1134146895,6.3512226104,6.4646372998
2016,Georgia,Hall County,196637,3380,2622,1533,1089,219,1988,2207,84,2879,13.449809435,7.8636757683,5.5861336671,1.1233822526,10.197643462,11.321025715
2016,Georgia,Hancock County,8640,62,67,122,-55,8,106,114,3,1302,7.7825531421,14.171216169,-6.388663027,0.9292600767,12.312696016,13.241956092
2016,Georgia,Haralson County,29042,186,360,354,6,4,181,185,-5,318,12.435662717,12.228401672,0.2072610453,0.1381740302,6.2523748661,6.3905488963
2016,Georgia,Harris County,33652,440,287,318,-31,2,474,476,-5,457,8.5845896147,9.511844939,-0.927255324,0.0598229241,14.178033022,14.237855946
2016,Georgia,Hart County,25553,47,263,304,-41,16,89,105,-17,669,10.301807713,11.907792945,-1.605985233,0.6267259445,3.4861630663,4.1128890108
2016,Georgia,Heard County,11487,-35,102,118,-16,0,-41,-41,22,124,8.8660958755,10.256856013,-1.390760137,0.0,-3.563822852,-3.563822852
2016,Georgia,Henry County,221768,4764,2597,1535,1062,205,3424,3629,73,864,11.837583073,6.9968001604,4.8407829123,0.9344260801,15.607194625,16.541620705
2016,Georgia,Houston County,152122,2160,1939,1210,729,322,1099,1421,10,1515,12.83748891,8.0110168033,4.8264721071,2.1318573642,7.2761218734,9.4079792376
2016,Georgia,Irwin County,9422,195,93,95,-2,1,189,190,7,981,9.9737251327,10.188213845,-0.214488713,0.1072443563,20.269183334,20.37642769
2016,Georgia,Jackson County,64615,1577,830,582,248,3,1323,1326,3,685,13.004003039,9.1184696012,3.8855334383,0.0470024206,20.728067495,20.775069916
2016,Georgia,Jasper County,13654,30,148,120,28,8,-17,-9,11,91,10.851235428,8.7982989955,2.0529364323,0.5865532664,-1.246425691,-0.659872425
2016,Georgia,Jeff Davis County,14877,-45,213,159,54,2,-96,-94,-5,111,14.295781738,10.671499044,3.6242826941,0.1342326924,-6.443169234,-6.308936541
2016,Georgia,Jefferson County,15916,-151,202,241,-39,7,-136,-129,17,597,12.631710596,15.070506206,-2.43879561,0.4377325454,-8.504518025,-8.06678548
2016,Georgia,Jenkins County,8849,-94,93,102,-9,-2,-92,-94,9,1189,10.454136691,11.465827338,-1.011690647,-0.224820144,-10.34172662,-10.56654676
2016,Georgia,Johnson County,9505,-90,76,93,-17,0,-82,-82,9,1732,7.9581151832,9.7382198953,-1.780104712,0.0,-8.586387435,-8.586387435
2016,Georgia,Jones County,28623,69,247,272,-25,11,78,89,5,302,8.639837697,9.5143151967,-0.8744775,0.3847700999,2.728369799,3.1131398989
2016,Georgia,Lamar County,18469,197,200,213,-13,24,187,211,-1,1237,10.88701995,11.594676247,-0.707656297,1.3064423941,10.179363654,11.485806048
2016,Georgia,Lanier County,10399,129,134,100,34,3,95,98,-3,180,12.966278001,9.6763268663,3.2899511345,0.290289806,9.192510523,9.482800329
2016,Georgia,Laurens County,47516,-227,605,538,67,17,-294,-277,-17,996,12.702211864,11.295520633,1.4066912313,0.3569216557,-6.172645104,-5.815723449
2016,Georgia,Lee County,29337,55,328,215,113,30,-122,-92,34,867,11.190910797,7.3355055528,3.855405244,1.0235589143,-4.162472918,-3.138914004
2016,Georgia,Liberty County,62570,41,1350,338,1012,286,-1260,-974,3,2442,21.582906338,5.4037202536,16.179186085,4.5723786761,-20.14404592,-15.57166724
2016,Georgia,Lincoln County,7828,143,83,88,-5,7,141,148,0,59,10.700702636,11.345323277,-0.644620641,0.9024688971,18.178302069,19.080770966
2016,Georgia,Long County,18437,638,262,111,151,46,440,486,1,321,14.460757258,6.1265040291,8.3342532288,2.5389115796,24.285241197,26.824152776
2016,Georgia,Lowndes County,114628,889,1616,896,720,261,-97,164,5,6383,14.152657783,7.8470181769,6.3056396064,2.2857943573,-0.84950978,1.436284577
2016,Georgia,Lumpkin County,31445,151,271,281,-10,0,152,152,9,2366,8.6389645994,8.9577455809,-0.318780982,0.0,4.8454709192,4.8454709192
2016,Georgia,McDuffie County,21490,-35,281,256,25,-4,-64,-68,8,267,13.065209811,11.902824596,1.1623852145,-0.185981634,-2.975706149,-3.161687783
2016,Georgia,McIntosh County,13927,-12,113,124,-11,0,4,4,-5,70,8.1102418718,8.8997344434,-0.789492572,0.0,0.2870882079,0.2870882079
2016,Georgia,Macon County,13450,-213,127,154,-27,23,-201,-178,-8,1914,9.3681997566,11.359864272,-1.991664515,1.6966031055,-14.82683584,-13.13023273
2016,Georgia,Madison County,28824,428,346,251,95,26,314,340,-7,248,12.093673541,8.7731562391,3.3205173016,0.9087731562,10.975183502,11.883956659
2016,Georgia,Marion County,8524,-113,84,80,4,5,-130,-125,8,74,9.7896392984,9.3234659985,0.4661732999,0.5827166249,-15.15063225,-14.56791562
2016,Georgia,Meriwether County,21074,-117,244,261,-17,1,-92,-91,-9,245,11.546196617,12.350644742,-0.804448125,0.0473204779,-4.35348397,-4.306163492
2016,Georgia,Miller County,5926,80,64,85,-21,4,81,85,16,127,10.87325858,14.441046551,-3.567787971,0.6795786612,13.76146789,14.441046551
2016,Georgia,Mitchell County,22459,-34,252,245,7,4,-69,-65,24,2222,11.211959423,10.900516106,0.3114433173,0.1779676099,-3.069941271,-2.891973661
2016,Georgia,Monroe County,27306,199,249,299,-50,-1,216,215,34,1071,9.1522246522,10.990020767,-1.837796115,-0.036755922,7.9392792164,7.9025232941
2016,Georgia,Montgomery County,9060,66,87,84,3,7,40,47,16,692,9.6377534064,9.3054170821,0.3323363244,0.7754514235,4.4311509915,5.206602415
2016,Georgia,Morgan County,18170,159,196,154,42,0,123,123,-6,140,10.834415854,8.5127553136,2.3216605401,0.0,6.7991487245,6.7991487245
2016,Georgia,Murray County,39315,-161,465,383,82,11,-235,-224,-19,176,11.803378558,9.7219225546,2.0814560039,0.2792197078,-5.965148304,-5.685928596
2016,Georgia,Muscogee County,197485,-2166,3003,1887,1116,572,-3816,-3244,-38,7020,15.123282704,9.5030417791,5.620240925,2.880625277,-19.217598,-16.33697272
2016,Georgia,Newton County,106999,1675,1341,855,486,87,1030,1117,72,1492,12.631697932,8.0537671378,4.5779307941,0.8195061298,9.7021990081,10.521705138
2016,Georgia,Oconee County,36838,966,333,213,120,13,827,840,6,126,9.1596754229,5.8588914867,3.3007839362,0.3575849264,22.747902627,23.105487553
2016,Georgia,Oglethorpe County,14921,-4,160,155,5,23,-22,1,-10,170,10.721704751,10.386651478,0.3350532735,1.541245058,-1.474234403,0.0670106547
2016,Georgia,Paulding County,155825,3572,1770,949,821,126,2452,2578,173,460,11.490596537,6.1607774654,5.3298190718,0.8179746688,15.918046728,16.736021397
2016,Georgia,Peach County,26655,-10,341,252,89,31,-118,-87,-12,1052,12.790697674,9.4523630908,3.3383345836,1.1627906977,-4.426106527,-3.263315829
2016,Georgia,Pickens County,30832,531,309,332,-23,23,532,555,-1,349,10.109106375,10.861564131,-0.752457756,0.752457756,17.404675053,18.157132809
2016,Georgia,Pierce County,19171,41,238,196,42,12,-15,-3,2,180,12.427873946,10.23471972,2.1931542257,0.6266154931,-0.783269366,-0.156653873
2016,Georgia,Pike County,17941,-2,159,170,-11,3,11,14,-5,213,8.8618883068,9.4749749192,-0.613086612,0.1672054398,0.6130866124,0.7802920522
2016,Georgia,Polk County,41776,371,555,490,65,60,266,326,-20,612,13.344393551,11.781536649,1.5628569024,1.4426371407,6.3956913237,7.8383284644
2016,Georgia,Pulaski County,11251,-112,88,129,-41,-3,-63,-66,-5,1197,7.7827894225,11.408861767,-3.626072345,-0.265322367,-5.5717697,-5.837092067
2016,Georgia,Putnam County,21477,203,218,266,-48,6,247,253,-2,171,10.198591846,12.444153353,-2.245561507,0.2806951884,11.555285256,11.835980445
2016,Georgia,Quitman County,2335,32,23,17,6,0,30,30,-4,0,9.9180681328,7.3307460112,2.5873221216,0.0,12.936610608,12.936610608
2016,Georgia,Rabun County,16559,292,159,221,-62,11,310,321,33,406,9.6874428806,13.464936331,-3.77749345,0.6702004509,18.887467252,19.557667702
2016,Georgia,Randolph County,7177,21,75,72,3,0,17,17,1,415,10.46535966,10.046745273,0.4186143864,0.0,2.3721481895,2.3721481895
2016,Georgia,Richmond County,201647,246,2993,2046,947,343,-993,-650,-51,10967,14.851829063,10.152636907,4.6991921558,1.7020305274,-4.92745281,-3.225422282
2016,Georgia,Rockdale County,89355,677,1021,661,360,111,228,339,-22,819,11.469783692,7.4255896379,4.0441940539,1.2469598333,2.5613229008,3.8082827341
2016,Georgia,Schley County,5098,-64,47,37,10,0,-75,-75,1,0,9.1617933723,7.2124756335,1.9493177388,0.0,-14.61988304,-14.61988304
2016,Georgia,Screven County,14044,-79,167,174,-7,3,-76,-73,1,442,11.857847836,12.354883374,-0.497035538,0.2130152306,-5.396385842,-5.183370611
2016,Georgia,Seminole County,8468,-138,96,105,-9,0,-142,-142,13,99,11.245168092,12.2994026,-1.054234509,0.0,-16.6334778,-16.6334778
2016,Georgia,Spalding County,64806,790,790,754,36,49,629,678,76,1217,12.264985794,11.706075049,0.5589107451,0.7607396252,9.7654127401,10.526152365
2016,Georgia,Stephens County,25751,251,342,334,8,4,241,245,-2,598,13.346081052,13.033892022,0.3121890305,0.1560945152,9.4046945425,9.5607890578
2016,Georgia,Stewart County,5705,-60,43,65,-22,63,-108,-45,7,1523,7.497820401,11.33391456,-3.836094159,10.985178727,-18.83173496,-7.846556234
2016,Georgia,Sumter County,30389,-355,350,342,8,13,-364,-351,-12,1649,11.450444114,11.188719677,0.2617244369,0.4253022099,-11.90846188,-11.48315967
2016,Georgia,Talbot County,6171,-150,47,85,-38,0,-119,-119,7,0,7.5248158822,13.608709574,-6.083893692,0.0,-19.0521934,-19.0521934
2016,Georgia,Taliaferro County,1593,-45,10,32,-22,0,-28,-28,5,7,6.1900340452,19.808108945,-13.6180749,0.0,-17.33209533,-17.33209533
2016,Georgia,Tattnall County,25092,-113,279,253,26,21,-155,-134,-5,4549,11.09410104,10.060242162,1.0338588783,0.8350398632,-6.163389467,-5.328349603
2016,Georgia,Taylor County,8232,-82,79,83,-4,0,-93,-93,15,160,9.5491357428,10.032636287,-0.483500544,0.0,-11.24138765,-11.24138765
2016,Georgia,Telfair County,15965,-515,133,162,-29,62,-547,-485,-1,3229,8.1984897519,9.9861303745,-1.787640623,3.8218523655,-33.71860071,-29.89674834
2016,Georgia,Terrell County,8967,-132,110,104,6,1,-138,-137,-1,269,12.177571128,11.513339976,0.6642311524,0.1107051921,-15.27731651,-15.16661131
2016,Georgia,Thomas County,45248,210,592,507,85,27,81,108,17,847,13.113882551,11.230977117,1.8829054338,0.5980993731,1.7942981193,2.3923974924
2016,Georgia,Tift County,40828,106,623,388,235,28,-149,-121,-8,1518,15.278969957,9.51563458,5.7633353771,0.686695279,-3.654199877,-2.967504598
2016,Georgia,Toombs County,27196,30,416,325,91,11,-95,-84,23,405,15.304808506,11.956881645,3.3479268607,0.4046944557,-3.495088481,-3.090394025
2016,Georgia,Towns County,11391,228,84,165,-81,2,250,252,57,1035,7.4487895717,14.631550944,-7.182761373,0.1773521327,22.169016582,22.346368715
2016,Georgia,Treutlen County,6637,-118,74,67,7,2,-138,-136,11,363,11.051373955,10.005973716,1.0454002389,0.2986857826,-20.609319,-20.31063321
2016,Georgia,Troup County,70005,258,948,736,212,59,24,83,-37,2328,13.566889919,10.532944072,3.0339458469,0.8443528536,0.3434655676,1.1878184212
2016,Georgia,Turner County,8030,-6,126,95,31,-6,-27,-33,-4,383,15.685298145,11.826216855,3.8590812897,-0.746918959,-3.361135317,-4.108054276
2016,Georgia,Twiggs County,8171,-126,86,144,-58,3,-77,-74,6,89,10.444498421,17.488462473,-7.043964051,0.3643429682,-9.351469517,-8.987126548
2016,Georgia,Union County,22928,677,168,289,-121,10,728,738,60,250,7.4370836008,12.793554528,-5.356470927,0.4426835477,32.22736227,32.670045818
2016,Georgia,Upson County,26335,43,333,390,-57,-3,94,91,9,364,12.655100994,14.821289452,-2.166188458,-0.114009919,3.572310791,3.4583008722
2016,Georgia,Walker County,67896,-157,753,783,-30,6,-84,-78,-49,1262,11.077683543,11.519025517,-0.441341974,0.0882683948,-1.235757527,-1.147489132
2016,Georgia,Walton County,90184,1689,1136,842,294,68,1236,1304,91,653,12.715540159,9.4247225471,3.2908176115,0.7611414884,13.834865877,14.596007365
2016,Georgia,Ware County,35738,316,467,427,40,38,244,282,-6,2349,13.125351321,12.001124227,1.1242270939,1.0680157392,6.8577852726,7.9258010118
2016,Georgia,Warren County,5442,-16,49,66,-17,1,4,5,-4,89,8.9908256881,12.110091743,-3.119266055,0.1834862385,0.7339449541,0.9174311927
2016,Georgia,Washington County,20457,-347,239,228,11,2,-366,-364,6,1603,11.584789511,11.051598362,0.533191149,0.0969438453,-17.74072369,-17.64377984
2016,Georgia,Wayne County,30104,565,406,320,86,18,460,478,1,2057,13.614338648,10.73051322,2.883825428,0.6035913686,15.425112754,16.028704123
2016,Georgia,Webster County,2599,-36,22,12,10,-1,-54,-55,9,0,8.4065724112,4.5854031334,3.8211692778,-0.382116928,-20.6343141,-21.01643103
2016,Georgia,Wheeler County,7978,81,56,68,-12,0,95,95,-2,2567,7.0551181102,8.5669291339,-1.511811024,0.0,11.968503937,11.968503937
2016,Georgia,White County,28884,482,270,294,-24,35,441,476,30,617,9.4263869008,10.264287959,-0.837901058,1.2219390427,15.396431938,16.618370981
2016,Georgia,Whitfield County,104589,613,1409,822,587,94,-17,77,-51,1089,13.511375351,7.8824347326,5.628940618,0.9013976458,-0.163018723,0.7383789226
2016,Georgia,Wilcox County,8761,-103,81,105,-24,1,-96,-95,16,1925,9.1914893617,11.914893617,-2.723404255,0.1134751773,-10.89361702,-10.78014184
2016,Georgia,Wilkes County,9805,-85,110,140,-30,13,-82,-69,14,133,11.170347804,14.216806296,-3.046458492,1.3201320132,-8.326986545,-7.006854532
2016,Georgia,Wilkinson County,9104,-44,103,137,-34,0,-13,-13,3,119,11.286434363,15.012053474,-3.72561911,0.0,-1.424501425,-1.424501425
2016,Georgia,Worth County,20748,40,233,220,13,2,1,3,24,179,11.240833655,10.613662679,0.6271709765,0.0964878425,0.0482439213,0.1447317638
2016,Hawaii,Hawaii,1428557,3400,18507,12237,6270,7438,-10021,-2583,-287,44287,12.970465856,8.5761922884,4.3942735677,5.2128559484,-7.023128456,-1.810272508
2016,Hawaii,Hawaii County,198449,2293,2440,1892,548,679,1060,1739,6,3803,12.366797177,9.5893361716,2.7774610053,3.4414160996,5.3724610687,8.8138771683
2016,Hawaii,Honolulu County,992605,-561,13231,8352,4879,5571,-10727,-5156,-284,36429,13.32580645,8.4118460789,4.9139603711,5.6109188824,-10.80386409,-5.192945209
2016,Hawaii,Kalawao County,88,0,0,0,0,0,0,0,0,3,0.0,0.0,0.0,0.0,0.0,0.0
2016,Hawaii,Kauai County,72029,551,903,664,239,390,-92,298,14,1225,12.584751963,9.2539039907,3.3308479726,5.4352749343,-1.28216742,4.1531075139
2016,Hawaii,Maui County,165386,1117,1933,1329,604,798,-262,536,-23,2827,11.727411991,8.0629749283,3.664437063,4.8414251263,-1.58954058,3.251884546
2016,Idaho,Idaho,1683140,30312,22792,12496,10296,1726,17143,18869,1147,30052,13.664399659,7.4916785773,6.1727210813,1.0347821082,10.277676524,11.312458633
2016,Idaho,Ada County,444028,10561,5127,2831,2296,737,6948,7685,580,10683,11.68553667,6.4524584186,5.2330782512,1.6797816512,15.835987669,17.515769321
2016,Idaho,Adams County,3900,61,29,18,11,0,50,50,0,21,7.4945083344,4.6517637938,2.8427445406,0.0,12.921566094,12.921566094
2016,Idaho,Bannock County,84377,466,1263,653,610,150,-280,-130,-14,2129,15.009982886,7.7605057996,7.2494770869,1.7826583001,-3.327628827,-1.544970527
2016,Idaho,Bear Lake County,5945,44,78,53,25,0,22,22,-3,31,13.169002195,8.948168158,4.2208340368,0.0,3.7143339524,3.7143339524
2016,Idaho,Benewah County,9092,57,108,116,-8,1,60,61,4,70,11.915926518,12.798587742,-0.882661224,0.1103326529,6.6199591769,6.7302918299
2016,Idaho,Bingham County,45201,225,695,345,350,3,-109,-106,-19,324,15.414129989,7.6516184836,7.7625115052,0.0665358129,-2.417467869,-2.350932056
2016,Idaho,Blaine County,21791,243,212,104,108,42,93,135,0,258,9.7833360253,4.7993723898,4.9839636355,1.9382080805,4.2917464639,6.2299545444
2016,Idaho,Boise County,7124,112,43,54,-11,7,112,119,4,34,6.0837577816,7.6400679117,-1.55631013,0.9903791737,15.84606678,16.836445954
2016,Idaho,Bonner County,42536,740,401,421,-20,6,737,743,17,353,9.5100317792,9.9843475786,-0.474315799,0.1422947398,17.47853721,17.62083195
2016,Idaho,Bonneville County,112232,2235,1918,802,1116,33,1014,1047,72,1241,17.261473525,7.2177798577,10.043693667,0.2969909418,9.1257216655,9.4227126073
2016,Idaho,Boundary County,11681,347,145,120,25,5,322,327,-5,73,12.600477949,10.427981751,2.1724961981,0.4344992396,27.981751032,28.416250272
2016,Idaho,Butte County,2501,0,27,13,14,-2,-13,-15,1,18,10.795681727,5.1979208317,5.5977608956,-0.799680128,-5.197920832,-5.99760096
2016,Idaho,Camas County,1072,7,6,3,3,-1,2,1,3,0,5.6153486196,2.8076743098,2.8076743098,-0.935891437,1.8717828732,0.9358914366
2016,Idaho,Canyon County,211698,4612,3237,1433,1804,34,2605,2639,169,3374,15.459043325,6.8436234431,8.6154198823,0.1623748758,12.440780928,12.603155803
2016,Idaho,Caribou County,6887,122,81,60,21,3,99,102,-1,79,11.866393202,8.7899208907,3.0764723117,0.4394960445,14.50336947,14.942865514
2016,Idaho,Cassia County,23504,7,358,189,169,23,-181,-158,-4,286,15.233718432,8.042382077,7.1913363545,0.9787025808,-7.701963788,-6.723261207
2016,Idaho,Clark County,860,-12,11,2,9,5,-28,-23,2,2,12.702078522,2.3094688222,10.3926097,5.7736720554,-32.33256351,-26.55889145
2016,Idaho,Clearwater County,8497,18,57,102,-45,2,52,54,9,626,6.7153628652,12.016965127,-5.301602262,0.2356267672,6.1262959472,6.3619227144
2016,Idaho,Custer County,4096,9,35,33,2,3,5,8,-1,21,8.5543199316,8.0655016498,0.4888182818,0.7332274227,1.2220457045,1.9552731272
2016,Idaho,Elmore County,26018,228,449,179,270,99,-140,-41,-1,606,17.333230389,6.9101297097,10.423100679,3.8218035825,-5.404570723,-1.58276714
2016,Idaho,Franklin County,13406,373,183,81,102,-6,270,264,7,102,13.843186202,6.1273119256,7.7158742766,-0.453874957,20.424373085,19.970498128
2016,Idaho,Fremont County,12943,130,187,105,82,6,30,36,12,460,14.520888337,8.1534399752,6.3674483615,0.4659108557,2.3295542786,2.7954651343
2016,Idaho,Gem County,17184,277,201,189,12,21,261,282,-17,151,11.791968555,11.087970432,0.7039981227,1.2319967147,15.311959168,16.543955883
2016,Idaho,Gooding County,15185,-8,204,110,94,20,-113,-93,-9,52,13.430772269,7.2420830864,6.188689183,1.3167423794,-7.439594443,-6.122852064
2016,Idaho,Idaho County,16156,-104,163,168,-5,4,-103,-99,0,498,10.056762093,10.365251728,-0.308489635,0.2467917078,-6.354886476,-6.108094768
2016,Idaho,Jefferson County,27839,686,454,152,302,5,389,394,-10,111,16.511492581,5.5280768112,10.98341577,0.1818446319,14.147512365,14.329356997
2016,Idaho,Jerome County,22994,278,389,148,241,15,5,20,17,106,17.020345657,6.4756070882,10.544738569,0.6563115292,0.2187705097,0.8750820389
2016,Idaho,Kootenai County,154311,3947,1834,1354,480,46,3123,3169,298,1489,12.039058013,8.8881595142,3.1508984984,0.3019611061,20.500533355,20.802494461
2016,Idaho,Latah County,39196,473,453,213,240,119,108,227,6,3206,11.627459285,5.467215955,6.1602433296,3.0544539843,2.7721094983,5.8265634826
2016,Idaho,Lemhi County,7723,-29,77,102,-25,1,3,4,-8,80,9.9515347334,13.182552504,-3.231017771,0.1292407108,0.3877221325,0.5169628433
2016,Idaho,Lewis County,3853,62,39,28,11,-1,55,54,-3,74,10.204081633,7.326007326,2.8780743066,-0.261643119,14.390371533,14.128728414
2016,Idaho,Lincoln County,5271,-38,72,37,35,8,-80,-72,-1,37,13.610586011,6.9943289225,6.6162570888,1.5122873346,-15.12287335,-13.61058601
2016,Idaho,Madison County,39048,956,1107,122,985,58,-82,-24,-5,633,28.701063002,3.1630801141,25.537982888,1.5037593985,-2.126004667,-0.622245268
2016,Idaho,Minidoka County,20616,229,327,163,164,28,42,70,-5,82,15.950052435,7.9506377582,7.999414677,1.3657537253,2.048630588,3.4143843133
2016,Idaho,Nez Perce County,40369,223,477,470,7,37,209,246,-30,1055,11.84872384,11.674843197,0.1738806434,0.9190834006,5.1915792088,6.1106626095
2016,Idaho,Oneida County,4343,54,49,36,13,8,36,44,-3,50,11.353104727,8.3410565338,3.0120481928,1.8535681186,8.3410565338,10.194624652
2016,Idaho,Owyhee County,11389,84,145,89,56,8,24,32,-4,160,12.778708029,7.8434828589,4.9352251696,0.7050321671,2.1150965013,2.8201286684
2016,Idaho,Payette County,23026,189,306,208,98,-14,96,82,9,94,13.344090007,9.0704925539,4.2735974533,-0.610513922,4.1863811787,3.5758672568
2016,Idaho,Power County,7654,34,140,57,83,17,-65,-48,-1,47,18.331805683,7.4636637423,10.868141941,2.2260049758,-8.511195496,-6.28519052
2016,Idaho,Shoshone County,12452,-3,157,162,-5,2,12,14,-12,160,12.606897659,13.008391215,-0.401493556,0.1605974224,0.9635845345,1.1241819569
2016,Idaho,Teton County,10960,392,154,37,117,15,251,266,9,7,14.30694909,3.4373838722,10.869565217,1.3935340022,23.318468971,24.712002973
2016,Idaho,Twin Falls County,83514,1407,1201,757,444,180,756,936,27,984,14.50299177,9.1413528478,5.3616389226,2.1736374011,9.1292770844,11.302914485
2016,Idaho,Valley County,10496,413,90,81,9,-3,392,389,15,66,8.7467806988,7.8721026289,0.8746780699,-0.291559357,38.097089266,37.805529909
2016,Idaho,Washington County,10172,205,103,96,7,2,154,156,42,119,10.228909082,9.5337405035,0.6951685784,0.1986195938,15.293708724,15.492328318
2016,Illinois,Illinois,12801539,-37508,155238,108040,47198,30934,-114144,-83210,-1496,300819,12.108771617,8.4272644939,3.6815071231,2.4128933715,-8.903384657,-6.490491286
2016,Illinois,Adams County,66578,-396,814,819,-5,25,-405,-380,-11,2230,12.190008386,12.264885588,-0.074877201,0.3743860069,-6.065053313,-5.690667306
2016,Illinois,Alexander County,6478,-298,90,95,-5,4,-312,-308,15,132,13.580805794,14.335295005,-0.754489211,0.6035913686,-47.08012675,-46.47653539
2016,Illinois,Bond County,16824,-100,157,169,-12,13,-106,-93,5,1891,9.304255067,10.01540832,-0.711153254,0.7704160247,-6.281853739,-5.511437715
2016,Illinois,Boone County,53503,13,603,354,249,-29,-179,-208,-28,310,11.271765443,6.6172553345,4.6545101081,-0.542091539,-3.346013291,-3.888104829
2016,Illinois,Brown County,6762,-59,54,61,-7,3,-54,-51,-1,2107,7.9511153648,8.9818155047,-1.03070014,0.4417286314,-7.951115365,-7.509386733
2016,Illinois,Bureau County,33359,-112,314,377,-63,20,-38,-18,-31,457,9.3969774054,11.282358222,-1.885380817,0.5985335927,-1.137213826,-0.538680233
2016,Illinois,Calhoun County,4894,-4,49,66,-17,3,15,18,-5,90,10.008169935,13.480392157,-3.472222222,0.612745098,3.0637254902,3.6764705882
2016,Illinois,Carroll County,14539,-89,132,189,-57,12,-60,-48,16,223,9.0513251277,12.959851887,-3.90852676,0.8228477389,-4.114238694,-3.291390956
2016,Illinois,Cass County,12676,-193,170,140,30,47,-282,-235,12,184,13.309845371,10.961049129,2.3487962419,3.679780779,-22.07868467,-18.3989039
2016,Illinois,Champaign County,208419,685,2413,1345,1068,1798,-2102,-304,-79,16226,11.596696407,6.4639687807,5.1327276266,8.6410526898,-10.10205381,-1.461001122
2016,Illinois,Christian County,33309,-237,300,389,-89,10,-128,-118,-30,1608,8.9746466233,11.637125122,-2.662478498,0.2991548874,-3.829182559,-3.530027672
2016,Illinois,Clark County,15938,-5,181,210,-29,0,37,37,-13,221,11.354725385,13.173990778,-1.819265393,0.0,2.3211317085,2.3211317085
2016,Illinois,Clay County,13300,-78,160,179,-19,1,-54,-53,-6,305,11.994902167,13.419296799,-1.424394632,0.0749681385,-4.048279481,-3.973311343
2016,Illinois,Clinton County,37729,-80,420,383,37,6,-114,-108,-9,2072,11.120230877,10.14059149,0.9796393868,0.1588604411,-3.018348381,-2.85948794
2016,Illinois,Coles County,52343,-220,507,484,23,50,-261,-211,-32,3952,9.665796046,9.2273082569,0.4384877891,0.9532343241,-4.975883172,-4.022648848
2016,Illinois,Cook County,5203499,-21324,68049,42297,25752,18434,-66244,-47810,734,90942,13.050805297,8.1119474447,4.9388578527,3.5353722296,-12.70463263,-9.169260405
2016,Illinois,Crawford County,19308,-105,218,248,-30,9,-78,-69,-6,1495,11.260039772,12.809586529,-1.549546758,0.4648640273,-4.02882157,-3.563957542
2016,Illinois,Cumberland County,10858,1,112,103,9,9,-10,-1,-7,117,10.31545015,9.4865300484,0.8289201013,0.8289201013,-0.921022335,-0.092102233
2016,Illinois,DeKalb County,104528,-13,1182,716,466,245,-681,-436,-43,6068,11.307271762,6.8494133516,4.4578584104,2.3437238424,-6.51459566,-4.170871817
2016,Illinois,De Witt County,16226,-34,178,217,-39,0,6,6,-1,249,10.958566767,13.359601059,-2.401034292,0.0,0.369389891,0.369389891
2016,Illinois,Douglas County,19630,-123,239,168,71,19,-214,-195,1,168,12.137216566,8.5315999289,3.6056166366,0.9648833253,-10.86763324,-9.902749917
2016,Illinois,DuPage County,929368,-2451,10582,6452,4130,2946,-9171,-6225,-356,12877,11.371237818,6.9332098279,4.4380279897,3.1657216604,-9.855001136,-6.689279476
2016,Illinois,Edgar County,17566,-78,174,229,-55,5,-19,-14,-9,249,9.883555808,13.007668276,-3.124112468,0.2840102244,-1.079238853,-0.795228628
2016,Illinois,Edwards County,6523,3,74,67,7,2,-12,-10,6,52,11.347082726,10.273710036,1.0733726903,0.3066779115,-1.840067469,-1.533389558
2016,Illinois,Effingham County,34386,-10,432,342,90,8,-106,-98,-2,440,12.561425954,9.944462214,2.6169637405,0.2326189992,-3.082201739,-2.84958274
2016,Illinois,Fayette County,21789,-270,250,208,42,18,-363,-345,33,1914,11.403028644,9.4873198321,1.9157088123,0.8210180624,-16.55719759,-15.73617953
2016,Illinois,Ford County,13575,-151,151,196,-45,1,-106,-105,-1,410,11.061865866,14.358448408,-3.296582543,0.0732573898,-7.765283323,-7.692025933
2016,Illinois,Franklin County,39156,-271,475,518,-43,11,-225,-214,-14,517,12.089128692,13.183512974,-1.094384282,0.2799587697,-5.72642938,-5.446470611
2016,Illinois,Fulton County,35536,-214,353,463,-110,-1,-76,-77,-27,2698,9.9037679208,12.989927896,-3.086159975,-0.028056,-2.132255983,-2.160311983
2016,Illinois,Gallatin County,5212,-66,65,83,-18,0,-48,-48,0,25,12.392755005,15.824594852,-3.431839847,0.0,-9.151572927,-9.151572927
2016,Illinois,Greene County,13093,-220,123,165,-42,2,-186,-184,6,280,9.3160645308,12.497159736,-3.181095206,0.1514807241,-14.08770734,-13.93622662
2016,Illinois,Grundy County,50437,-62,605,401,204,4,-255,-251,-15,254,11.987794246,7.9456289134,4.0421653325,0.0792581438,-5.052706666,-4.973448522
2016,Illinois,Hamilton County,8061,-137,74,115,-41,1,-119,-118,22,117,9.1026508395,14.14601144,-5.0433606,0.1230087951,-14.63804662,-14.51503783
2016,Illinois,Hancock County,18508,-31,189,217,-28,4,5,9,-12,223,10.203255324,11.714848706,-1.511593381,0.2159419116,0.2699273895,0.4858693012
2016,Illinois,Hardin County,4024,-89,20,61,-41,0,-45,-45,-3,110,4.91581664,14.993240752,-10.07742411,0.0,-11.06058744,-11.06058744
2016,Illinois,Henderson County,6869,-102,72,89,-17,1,-82,-81,-4,51,10.404624277,12.861271676,-2.456647399,0.1445086705,-11.84971098,-11.70520231
2016,Illinois,Henry County,49280,-179,510,547,-37,13,-130,-117,-25,724,10.330264637,11.079715209,-0.749450572,0.2633204711,-2.633204711,-2.36988424
2016,Illinois,Iroquois County,28334,-317,293,346,-53,12,-264,-252,-12,468,10.283407914,12.143546547,-1.860138633,0.4211634641,-9.26559621,-8.844432745
2016,Illinois,Jackson County,58870,-350,718,457,261,237,-821,-584,-27,3851,12.160216784,7.7398594292,4.4203573546,4.0138877128,-13.904649,-9.890761284
2016,Illinois,Jasper County,9536,-55,103,89,14,11,-84,-73,4,54,10.770115543,9.3062163434,1.4638992001,1.1502065144,-8.783395201,-7.633188686
2016,Illinois,Jefferson County,38460,70,517,441,76,35,-43,-8,2,2207,13.454782043,11.476903058,1.977878985,0.9108653221,-1.11906311,-0.208197788
2016,Illinois,Jersey County,22025,-281,191,203,-12,18,-282,-264,-5,817,8.6169948794,9.1583767567,-0.541381877,0.8120728159,-12.72247412,-11.9104013
2016,Illinois,Jo Daviess County,21770,-264,176,248,-72,8,-186,-178,-14,167,8.0357958177,11.323166834,-3.287371016,0.3652634463,-8.492375126,-8.127111679
2016,Illinois,Johnson County,12902,65,106,133,-27,1,87,88,4,1798,8.2365282256,10.33451183,-2.097983605,0.0777030965,6.7601693928,6.8378724892
2016,Illinois,Kane County,531715,2013,6776,3365,3411,650,-1824,-1174,-224,6805,12.767837711,6.3405805635,6.4272571478,1.2247778206,-3.436914992,-2.212137171
2016,Illinois,Kankakee County,110008,-787,1278,1140,138,122,-993,-871,-54,5160,11.575929675,10.325946658,1.2499830165,1.1050574494,-8.99444301,-7.889385561
2016,Illinois,Kendall County,124695,1749,1605,533,1072,136,553,689,-12,208,12.96231238,4.304618379,8.6576940006,1.0983641643,4.4661425208,5.5645066851
2016,Illinois,Knox County,50938,-478,546,596,-50,55,-483,-428,0,3964,10.66885515,11.645856537,-0.977001387,1.0747015261,-9.437833402,-8.363131876
2016,Illinois,Lake County,703047,-366,7773,4589,3184,1674,-5179,-3505,-45,18544,11.05328271,6.5256032877,4.5276794221,2.3804445203,-7.36458911,-4.98414459
2016,Illinois,LaSalle County,110642,-662,1200,1235,-35,64,-629,-565,-62,3553,10.813441107,11.12883314,-0.315392032,0.5767168591,-5.66804538,-5.091328521
2016,Illinois,Lawrence County,16377,-136,184,227,-43,4,-97,-93,0,2584,11.188811189,13.803587717,-2.614776528,0.2432350258,-5.898449377,-5.655214351
2016,Illinois,Lee County,34251,-176,325,394,-69,1,-87,-86,-21,2962,9.4644573226,11.473834416,-2.009377093,0.0291214071,-2.533562422,-2.504441015
2016,Illinois,Livingston County,36526,-223,357,365,-8,26,-216,-190,-25,2716,9.7441146366,9.9624701467,-0.21835551,0.7096554077,-5.895598772,-5.185943364
2016,Illinois,Logan County,29527,-13,321,314,7,24,-37,-13,-7,4327,10.869013155,10.631994176,0.2370189784,0.8126364975,-1.2528146,-0.440178103
2016,Illinois,McDonough County,30996,-346,281,284,-3,46,-400,-354,11,3837,9.0153678334,9.1116173121,-0.096249479,1.4758253393,-12.83326382,-11.35743848
2016,Illinois,McHenry County,307004,-184,3280,1995,1285,289,-1589,-1300,-169,1648,10.680699195,6.4963399067,4.1843592883,0.941073801,-5.17427775,-4.233203949
2016,Illinois,McLean County,172418,-255,1957,1198,759,620,-1572,-952,-62,10602,11.341935895,6.9430961688,4.3988397263,3.5932551124,-9.110640382,-5.517385269
2016,Illinois,Macon County,106550,-827,1317,1171,146,92,-1026,-934,-39,4215,12.312611311,10.947659716,1.3649515956,0.8601064849,-9.592057104,-8.731950619
2016,Illinois,Macoupin County,45908,-181,451,586,-135,9,-22,-13,-33,836,9.8046675435,12.739545855,-2.934878311,0.1956585541,-0.478276466,-0.282617911
2016,Illinois,Madison County,265759,-312,3032,2814,218,148,-572,-424,-106,3828,11.402139782,10.58232894,0.8198108418,0.5565688284,-2.15106331,-1.594494481
2016,Illinois,Marion County,38140,-238,503,414,89,16,-330,-314,-13,758,13.147233331,10.820983298,2.3262500327,0.4182022531,-8.625421469,-8.207219216
2016,Illinois,Marshall County,11939,-41,127,139,-12,0,-32,-32,3,255,10.619173042,11.622559472,-1.003386429,0.0,-2.675697145,-2.675697145
2016,Illinois,Mason County,13507,-182,121,173,-52,6,-139,-133,3,206,8.898367407,12.722459185,-3.824091778,0.441241359,-10.22209148,-9.780850125
2016,Illinois,Massac County,14658,-94,156,178,-22,6,-81,-75,3,292,10.608636518,12.104726284,-1.496089765,0.4080244815,-5.5083305,-5.100306018
2016,Illinois,Menard County,12516,62,119,145,-26,0,79,79,9,154,9.5314377253,11.613936724,-2.082498999,0.0,6.3275931117,6.3275931117
2016,Illinois,Mercer County,15730,-109,153,179,-26,5,-75,-70,-13,185,9.6930533118,11.340238842,-1.64718553,0.3167664481,-4.751496721,-4.434730273
2016,Illinois,Monroe County,34068,175,349,313,36,2,111,113,26,343,10.270596371,9.2111652271,1.0594311443,0.0588572858,3.2665793617,3.3254366475
2016,Illinois,Montgomery County,28952,-244,248,386,-138,1,-97,-96,-10,2469,8.5299580381,13.276466946,-4.746508908,0.0343949921,-3.336314233,-3.301919241
2016,Illinois,Morgan County,34277,-328,366,368,-2,23,-324,-301,-25,2920,10.626869139,10.684939462,-0.058070323,0.6678087164,-9.407392352,-8.739583636
2016,Illinois,Moultrie County,14827,-94,187,160,27,0,-120,-120,-1,395,12.572273766,10.757025682,1.8152480839,0.0,-8.067769262,-8.067769262
2016,Illinois,Ogle County,51273,-384,529,481,48,25,-431,-406,-26,525,10.278830273,9.3461575828,0.9326726902,0.4857670261,-8.374623531,-7.888856504
2016,Illinois,Peoria County,185006,-1309,2679,1782,897,435,-2604,-2169,-37,4884,14.429563639,9.5981643915,4.8313992476,2.3429862572,-14.02560049,-11.68261423
2016,Illinois,Perry County,21357,-101,191,225,-34,15,-70,-55,-12,2418,8.9221067383,10.510335163,-1.588228425,0.7006890109,-3.269882051,-2.56919304
2016,Illinois,Piatt County,16560,180,187,172,15,3,170,173,-8,72,11.353976928,10.443230115,0.9107468124,0.1821493625,10.321797207,10.50394657
2016,Illinois,Pike County,15950,-31,182,186,-4,-1,-22,-23,-4,627,11.399580345,11.650120572,-0.250540227,-0.062635057,-1.377971251,-1.440606307
2016,Illinois,Pope County,4157,-47,37,25,12,3,-76,-73,14,371,8.850615955,5.9801459156,2.8704700395,0.7176175099,-18.17964358,-17.46202607
2016,Illinois,Pulaski County,5619,-53,59,71,-12,1,-44,-43,2,21,10.450801523,12.576388274,-2.125586751,0.1771322292,-7.793818085,-7.616685856
2016,Illinois,Putnam County,5611,-25,44,61,-17,1,-9,-8,0,2,7.8243087045,10.847337068,-3.023028363,0.1778251978,-1.60042678,-1.422601583
2016,Illinois,Randolph County,32621,-225,331,390,-59,8,-152,-144,-22,4523,10.111964807,11.914399621,-1.802434814,0.2443979409,-4.643560878,-4.399162937
2016,Illinois,Richland County,15930,-113,194,190,4,5,-126,-121,4,364,12.135239108,11.885027992,0.2502111156,0.3127638945,-7.881650142,-7.568886248
2016,Illinois,Rock Island County,144784,-1174,1798,1464,334,396,-1870,-1474,-34,4643,12.368354073,10.070784407,2.2975696666,2.7240646346,-12.86363855,-10.13957392
2016,Illinois,St. Clair County,262759,-1320,3282,2678,604,127,-1910,-1783,-141,4686,12.459237944,10.166312984,2.2929249599,0.4821216389,-7.250805751,-6.768684112
2016,Illinois,Saline County,24307,-267,329,329,0,4,-266,-262,-5,886,13.461263067,13.461263067,0.0,0.1636627729,-10.88357439,-10.71991162
2016,Illinois,Sangamon County,197499,-997,2192,2111,81,258,-1299,-1041,-37,3914,11.070846854,10.66175078,0.4090960744,1.3030467556,-6.560688898,-5.257642142
2016,Illinois,Schuyler County,6923,-120,57,70,-13,0,-103,-103,-4,463,8.1626807962,10.024344837,-1.861664041,0.0,-14.7501074,-14.7501074
2016,Illinois,Scott County,5053,-61,47,47,0,0,-60,-60,-1,43,9.245598505,9.245598505,0.0,0.0,-11.80289171,-11.80289171
2016,Illinois,Shelby County,21717,-84,257,249,8,4,-83,-79,-13,205,11.811204559,11.443540604,0.3676639551,0.1838319776,-3.814513535,-3.630681557
2016,Illinois,Stark County,5776,12,51,87,-36,0,48,48,0,92,8.8388214905,15.077989601,-6.239168111,0.0,8.3188908146,8.3188908146
2016,Illinois,Stephenson County,45624,-167,497,550,-53,14,-95,-81,-33,836,10.873489034,12.033036154,-1.15954712,0.3062954657,-2.078433517,-1.772138052
2016,Illinois,Tazewell County,134385,-350,1536,1443,93,37,-442,-405,-38,2736,11.414982164,10.723840666,0.6911414982,0.2749702735,-3.284780024,-3.00980975
2016,Illinois,Union County,17212,-187,174,230,-56,11,-133,-122,-9,580,10.054606917,13.290572361,-3.235965445,0.6356360695,-7.685417931,-7.049781861
2016,Illinois,Vermilion County,78111,-879,918,940,-22,26,-886,-860,3,2925,11.686749289,11.96682389,-0.280074602,0.3309972565,-11.27936805,-10.94837079
2016,Illinois,Wabash County,11492,-62,137,126,11,25,-106,-81,8,88,11.889264948,10.934652434,0.9546125141,2.1695738957,-9.198993318,-7.029419422
2016,Illinois,Warren County,17378,-129,187,186,1,44,-172,-128,-2,1013,10.720940232,10.663609001,0.0573312312,2.5225741723,-9.860971764,-7.338397592
2016,Illinois,Washington County,14154,-92,145,140,5,1,-91,-90,-7,246,10.211267606,9.8591549296,0.3521126761,0.0704225352,-6.408450704,-6.338028169
2016,Illinois,Wayne County,16396,-31,205,205,0,4,-25,-21,-10,76,12.491240898,12.491240898,0.0,0.2437315297,-1.523322061,-1.279590531
2016,Illinois,White County,14292,-57,174,217,-43,4,-37,-33,19,391,12.150413743,15.153102196,-3.002688454,0.2793198562,-2.583708669,-2.304388813
2016,Illinois,Whiteside County,56536,-427,602,624,-22,10,-367,-357,-48,1011,10.608022978,10.995691592,-0.387668614,0.1762130063,-6.467017331,-6.290804324
2016,Illinois,Will County,689529,2842,7829,4483,3346,882,-1253,-371,-133,9190,11.377574451,6.514965674,4.8626087765,1.2817755352,-1.820935086,-0.539159551
2016,Illinois,Williamson County,67560,-29,792,783,9,70,-78,-8,-30,2132,11.720397487,11.587211152,0.1331863351,1.0358937173,-1.154281571,-0.118387853
2016,Illinois,Winnebago County,285873,-1295,3576,2747,829,462,-2506,-2044,-80,4718,12.480782352,9.5874466225,2.8933357299,1.612450069,-8.746320071,-7.133870002
2016,Illinois,Woodford County,39140,-18,413,408,5,25,-70,-45,22,1022,10.549439322,10.421722138,0.1277171831,0.6385859153,-1.788040563,-1.149454648
2016,Indiana,Indiana,6633053,20285,83267,60909,22358,11052,-12135,-1083,-990,187052,12.572569114,9.196711929,3.3758571854,1.6687527334,-1.832276006,-0.163523273
2016,Indiana,Adams County,35232,265,683,254,429,10,-161,-151,-13,421,19.458966652,7.2365703215,12.22239633,0.2849043434,-4.586959928,-4.302055585
2016,Indiana,Allen County,370404,2364,5259,3089,2170,818,-424,394,-200,6112,14.243463282,8.3662403649,5.8772229174,2.2154692841,-1.148360607,1.0671086772
2016,Indiana,Bartholomew County,81402,391,1064,711,353,298,-213,85,-47,1147,13.102399438,8.7554567676,4.3469426708,3.6696569856,-2.622942745,1.0467142409
2016,Indiana,Benton County,8650,-24,116,82,34,4,-56,-52,-6,92,13.391826368,9.4666358809,3.9251904872,0.4617871161,-6.465019626,-6.00323251
2016,Indiana,Blackford County,12149,-138,131,169,-38,10,-104,-94,-6,163,10.721885742,13.832051072,-3.11016533,0.8184645605,-8.512031429,-7.693566869
2016,Indiana,Boone County,64653,1253,827,480,347,69,821,890,16,574,12.916526751,7.4968958166,5.4196309341,1.0776787736,12.822815553,13.900494327
2016,Indiana,Brown County,14912,-7,102,142,-40,-1,16,15,18,163,6.8385236834,9.5202976769,-2.681773993,-0.06704435,1.0727095974,1.0056652476
2016,Indiana,Carroll County,19970,80,221,188,33,9,45,54,-7,106,11.088810838,9.4330155544,1.6557952835,0.4515805319,2.2579026593,2.7094831912
2016,Indiana,Cass County,37946,-132,502,413,89,115,-319,-204,-17,1043,13.206355888,10.864990003,2.3413658845,3.0253604125,-8.392086709,-5.366726297
2016,Indiana,Clark County,116031,941,1472,1142,330,104,519,623,-12,1327,12.737916503,9.8822694606,2.855647042,0.899961492,4.4911539843,5.3911154763
2016,Indiana,Clay County,26309,-176,304,290,14,0,-196,-196,6,341,11.516460204,10.986096905,0.5303632989,0.0,-7.425086184,-7.425086184
2016,Indiana,Clinton County,32457,-110,453,325,128,20,-236,-216,-22,831,13.933316929,9.9963090551,3.937007874,0.6151574803,-7.258858268,-6.643700787
2016,Indiana,Crawford County,10539,29,128,112,16,0,1,1,12,62,12.162097962,10.641835717,1.5202622452,0.0,0.0950163903,0.0950163903
2016,Indiana,Daviess County,32969,133,524,332,192,12,-63,-51,-8,581,15.925841501,10.090418661,5.8354228402,0.3647139275,-1.914748119,-1.550034192
2016,Indiana,Dearborn County,49331,-144,507,444,63,2,-251,-249,42,530,10.262534664,8.987308463,1.2752262008,0.0404833715,-5.080663118,-5.040179746
2016,Indiana,Decatur County,26598,205,334,271,63,20,130,150,-8,377,12.605914212,10.22815195,2.3777622615,0.7548451624,4.9064935555,5.6613387179
2016,Indiana,DeKalb County,42746,189,548,399,149,7,36,43,-3,615,12.848317175,9.3548878703,3.4934293049,0.1641208398,0.8440500334,1.0081708732
2016,Indiana,Delaware County,115603,-416,1215,1198,17,175,-540,-365,-68,8414,10.491231403,10.344440511,0.1467908921,1.5110827124,-4.662769512,-3.1516868
2016,Indiana,Dubois County,42552,131,574,406,168,40,-80,-40,3,894,13.51017382,9.5559766043,3.9541972156,0.9414755275,-1.882951055,-0.941475528
2016,Indiana,Elkhart County,203781,497,3128,1622,1506,100,-987,-887,-122,3797,15.368552934,7.9692432413,7.3993096926,0.4913220247,-4.849348384,-4.358026359
2016,Indiana,Fayette County,23331,-95,246,287,-41,4,-47,-43,-11,392,10.522488611,12.276236713,-1.753748102,0.1710973758,-2.010394166,-1.83929679
2016,Indiana,Floyd County,76990,229,923,750,173,31,8,39,17,1330,12.006425974,9.7560341071,2.2503918674,0.4032494098,0.1040643638,0.5073137736
2016,Indiana,Fountain County,16486,-50,179,188,-9,0,-49,-49,8,172,10.841257344,11.386348495,-0.545091151,0.0,-2.967718491,-2.967718491
2016,Indiana,Franklin County,22715,-175,248,200,48,12,-221,-209,-14,187,10.876000439,8.7709680956,2.1050323429,0.5262580857,-9.691919746,-9.16566166
2016,Indiana,Fulton County,20139,-189,275,206,69,1,-254,-253,-5,224,13.591321324,10.181135246,3.4101860775,0.0494229866,-12.5534386,-12.50401562
2016,Indiana,Gibson County,33703,-59,427,389,38,3,-74,-71,-26,738,12.658415475,11.531905432,1.1265100422,0.0889350033,-2.193730082,-2.104795079
2016,Indiana,Grant County,66937,-755,735,814,-79,35,-717,-682,6,4930,10.918895632,12.092491217,-1.173595585,0.519947411,-10.65149411,-10.13154669
2016,Indiana,Greene County,32211,-239,342,413,-71,10,-164,-154,-14,281,10.578246547,12.774315275,-2.196068728,0.3093054546,-5.072609455,-4.763304001
2016,Indiana,Hamilton County,316373,7201,3839,1667,2172,733,3913,4646,383,1634,12.274096987,5.3297524559,6.9443445316,2.3435564188,12.510690678,14.854247097
2016,Indiana,Hancock County,73717,1325,738,602,136,0,1201,1201,-12,649,10.102047102,8.2404232457,1.8616238562,0.0,16.439781259,16.439781259
2016,Indiana,Harrison County,39826,187,451,348,103,29,68,97,-13,461,11.350909205,8.7585729566,2.5923362487,0.7298810797,1.7114452904,2.4413263701
2016,Indiana,Hendricks County,160610,2551,1785,1046,739,227,1559,1786,26,3886,11.202846841,6.5648054878,4.6380413533,1.4246757607,9.784447185,11.209122946
2016,Indiana,Henry County,48521,-373,479,565,-86,1,-283,-282,-5,3610,9.8342144434,11.599856285,-1.765641842,0.0205307191,-5.810193502,-5.789662783
2016,Indiana,Howard County,82568,-13,987,942,45,49,-53,-4,-54,1280,11.952842585,11.407880157,0.5449624279,0.5934035326,-0.641844637,-0.048441105
2016,Indiana,Huntington County,36400,-207,419,394,25,10,-229,-219,-13,1336,11.478351391,10.793485556,0.6848658348,0.2739463339,-6.273371047,-5.999424713
2016,Indiana,Jackson County,44013,72,613,444,169,87,-166,-79,-18,595,13.939104532,10.096186643,3.8429178889,1.9783068422,-3.774700412,-1.796393569
2016,Indiana,Jasper County,33433,-68,375,326,49,22,-116,-94,-23,929,11.205067679,9.7409388353,1.4641288433,0.6573639705,-3.466100935,-2.808736965
2016,Indiana,Jay County,21046,-109,336,227,109,4,-228,-224,6,243,15.923793275,10.758038909,5.165754366,0.1895689676,-10.80543115,-10.61586218
2016,Indiana,Jefferson County,32418,-47,390,349,41,12,-87,-75,-13,1952,12.02163895,10.757825625,1.2638133255,0.3698965831,-2.681750227,-2.311853644
2016,Indiana,Jennings County,27758,-155,354,303,51,3,-195,-192,-14,298,12.717572884,10.88538018,1.8321927036,0.1077760414,-7.00544269,-6.897666649
2016,Indiana,Johnson County,151982,2644,1821,1285,536,191,1854,2045,63,2558,12.086818001,8.5291384575,3.5576795433,1.2677552104,12.305854241,13.573609452
2016,Indiana,Knox County,37744,-147,486,406,80,15,-227,-212,-15,2564,12.851193231,10.735770477,2.115422754,0.3966417664,-6.002512065,-5.605870298
2016,Indiana,Kosciusko County,79092,277,1078,694,384,63,-147,-84,-23,1803,13.653606237,8.7899839779,4.8636222587,0.7979380268,-1.861855396,-1.063917369
2016,Indiana,LaGrange County,39110,439,699,257,442,25,-16,9,-12,325,17.973541096,6.6082976562,11.36524344,0.6428305113,-0.411411527,0.2314189841
2016,Indiana,Lake County,485846,-1803,5918,4908,1010,324,-2891,-2567,-246,6488,12.158254536,10.083256719,2.0749978171,0.6656428641,-5.939424445,-5.273781581
2016,Indiana,LaPorte County,110015,-747,1293,1195,98,24,-830,-806,-39,6280,11.713176644,10.825403008,0.8877736358,0.2174139516,-7.518899161,-7.301485209
2016,Indiana,Lawrence County,45518,33,474,535,-61,28,78,106,-12,653,10.417238992,11.757854137,-1.340615145,0.6153643286,1.7142292012,2.3295935299
2016,Indiana,Madison County,129296,-199,1405,1438,-33,89,-206,-117,-49,5927,10.858182858,11.113214911,-0.255032053,0.6878137184,-1.59201827,-0.904204551
2016,Indiana,Marion County,941229,3171,14433,8015,6418,3033,-6176,-3143,-104,17294,15.360080711,8.5298307284,6.8302499831,3.2278199126,-6.572705499,-3.344885587
2016,Indiana,Marshall County,46556,-200,565,471,94,25,-289,-264,-30,671,12.109910837,10.095164609,2.0147462277,0.5358367627,-6.194272977,-5.658436214
2016,Indiana,Martin County,10171,-20,129,97,32,4,-56,-52,0,134,12.670661035,9.5275513211,3.1431097142,0.3928887143,-5.500442,-5.107553286
2016,Indiana,Miami County,35883,-19,375,359,16,3,-29,-26,-9,3288,10.447865153,10.002089573,0.4457755799,0.0835829212,-0.807968238,-0.724385317
2016,Indiana,Monroe County,145496,1239,1305,894,411,1019,-132,887,-59,15076,9.0076720517,6.1707730377,2.836899014,7.0335768741,-0.911120851,6.1224560229
2016,Indiana,Montgomery County,38074,-93,446,385,61,7,-149,-142,-12,1174,11.699741609,10.099552734,1.6001888748,0.1836282315,-3.908658071,-3.72502984
2016,Indiana,Morgan County,69698,52,754,656,98,22,-45,-23,-23,592,10.822138018,9.4155471351,1.406590883,0.3157653003,-0.645883569,-0.330118268
2016,Indiana,Newton County,13924,-78,126,144,-18,8,-93,-85,25,169,9.0238487431,10.312969992,-1.289121249,0.5729427773,-6.660459787,-6.087517009
2016,Indiana,Noble County,47638,-121,633,452,181,5,-284,-279,-23,820,13.270857574,9.4761889787,3.7946685954,0.1048250993,-5.954065641,-5.849240542
2016,Indiana,Ohio County,5932,-4,47,78,-31,0,24,24,3,52,7.9204583755,13.144590495,-5.22413212,0.0,4.0444893832,4.0444893832
2016,Indiana,Orange County,19335,-181,211,211,0,5,-178,-173,-8,258,10.862011274,10.862011274,0.0,0.2573936321,-9.163213302,-8.90581967
2016,Indiana,Owen County,20840,31,208,238,-30,2,44,46,15,197,9.9882350116,11.428845831,-1.440610819,0.0960407213,2.1128958678,2.2089365891
2016,Indiana,Parke County,16800,-78,183,173,10,1,-96,-95,7,1467,10.867628719,10.273769226,0.5938594928,0.0593859493,-5.701051131,-5.641665182
2016,Indiana,Perry County,18966,-356,180,176,4,-2,-354,-356,-4,1359,9.4024237359,9.1934809862,0.2089427497,-0.104471375,-18.49143335,-18.59590472
2016,Indiana,Pike County,12431,-45,118,143,-25,2,-15,-13,-7,213,9.4752479223,11.482715702,-2.00746778,0.1605974224,-1.204480668,-1.043883246
2016,Indiana,Porter County,167791,160,1763,1575,188,149,-145,4,-32,3416,10.512130987,9.3911550226,1.1209759646,0.8884330783,-0.864582526,0.0238505524
2016,Indiana,Posey County,25476,-14,259,245,14,5,-14,-9,-19,242,10.163638504,9.614252639,0.5493858651,0.1962092375,-0.549385865,-0.353176628
2016,Indiana,Pulaski County,12660,-211,137,138,-1,1,-212,-211,1,193,10.732051232,10.810387372,-0.07833614,0.0783361404,-16.60726176,-16.52892562
2016,Indiana,Putnam County,37436,-185,348,340,8,59,-243,-184,-9,4964,9.2729525561,9.0597812329,0.2131713231,1.5721385081,-6.47507894,-4.902940432
2016,Indiana,Randolph County,25082,-51,288,268,20,-1,-59,-60,-11,329,11.470676093,10.674101364,0.7965747287,-0.039828736,-2.34989545,-2.389724186
2016,Indiana,Ripley County,28846,147,329,306,23,31,27,58,66,449,11.434529499,10.635155096,0.7993744026,1.0774176731,0.9383960379,2.015813711
2016,Indiana,Rush County,16649,-76,201,187,14,-1,-79,-80,-10,178,12.045304728,11.206328279,0.8389764487,-0.059926889,-4.734224246,-4.794151136
2016,Indiana,St. Joseph County,269141,1007,3458,2471,987,537,-349,188,-168,11386,12.872365176,9.1982690429,3.6740961333,1.9989763157,-1.299148481,0.6998278349
2016,Indiana,Scott County,23730,23,267,306,-39,3,55,58,4,312,11.257035647,12.901321753,-1.644286106,0.1264835466,2.318865021,2.4453485676
2016,Indiana,Shelby County,44324,-118,516,436,80,19,-185,-166,-32,683,11.626073046,9.8235811009,1.8024919451,0.428091837,-4.168262623,-3.740170786
2016,Indiana,Spencer County,20648,-79,245,236,9,-1,-93,-94,6,368,11.842900302,11.407854985,0.4350453172,-0.048338369,-4.495468278,-4.543806647
2016,Indiana,Starke County,23009,69,249,283,-34,2,105,107,-4,16,10.838103114,12.318004744,-1.47990163,0.0870530371,4.5702844458,4.6573374829
2016,Indiana,Steuben County,34116,-227,366,322,44,28,-305,-277,6,1304,10.692531296,9.4070903753,1.2854409208,0.8180078587,-8.910442747,-8.092434888
2016,Indiana,Sullivan County,20802,-125,243,204,39,2,-181,-179,15,2176,11.646576721,9.7773730499,1.8692036713,0.0958565985,-8.675022167,-8.579165568
2016,Indiana,Switzerland County,10527,18,125,111,14,5,-1,4,0,107,11.884388667,10.553337136,1.3310515307,0.4753755467,-0.095075109,0.3803004373
2016,Indiana,Tippecanoe County,188059,2318,2356,1138,1218,1716,-530,1186,-86,14476,12.605671482,6.0888175495,6.5168539326,9.1813804173,-2.835741038,6.3456393793
2016,Indiana,Tipton County,15182,-110,156,165,-9,-2,-96,-98,-3,205,10.238235873,10.828903327,-0.590667454,-0.131259434,-6.300452845,-6.431712279
2016,Indiana,Union County,7212,17,79,67,12,0,-10,-10,15,67,10.966891095,9.3010342195,1.6658568751,0.0,-1.388214063,-1.388214063
2016,Indiana,Vanderburgh County,181721,-220,2188,1887,301,186,-601,-415,-106,7549,12.033151663,10.377768367,1.6553832955,1.0229278836,-3.305266979,-2.282339095
2016,Indiana,Vermillion County,15645,11,146,200,-54,2,59,61,4,209,9.3353368074,12.788132613,-3.452795805,0.1278813261,3.7724991208,3.9003804469
2016,Indiana,Vigo County,107931,223,1291,1160,131,182,-250,-68,160,9510,11.97371533,10.758721753,1.2149935772,1.6880063439,-2.318690033,-0.630683689
2016,Indiana,Wabash County,31762,-313,318,411,-93,16,-259,-243,23,1841,9.9628741952,12.87654495,-2.913670755,0.5012766891,-8.114416404,-7.613139715
2016,Indiana,Warren County,8166,-114,86,85,1,2,-126,-124,9,84,10.458470145,10.336860027,0.121610118,0.2432202359,-15.32287486,-15.07965463
2016,Indiana,Warrick County,62498,604,671,609,62,86,400,486,56,727,10.788475143,9.7916264712,0.9968486719,1.3827255772,6.4312817545,7.8140073317
2016,Indiana,Washington County,27670,-51,308,293,15,0,-59,-59,-7,261,11.120940225,10.579335993,0.5416042317,0.0,-2.130309978,-2.130309978
2016,Indiana,Wayne County,66568,-416,734,889,-155,8,-228,-220,-41,2706,10.991973164,13.313166407,-2.321193243,0.1198035222,-3.414400383,-3.294596861
2016,Indiana,Wells County,27949,12,331,247,84,20,-74,-54,-18,472,11.845542712,8.8394231113,3.0061196006,0.7157427621,-2.64824822,-1.932505458
2016,Indiana,White County,23999,-225,278,293,-15,6,-206,-200,-10,307,11.529767953,12.151877735,-0.622109782,0.2488439127,-8.543641001,-8.294797089
2016,Indiana,Whitley County,33449,54,411,298,113,14,-67,-53,-6,436,12.297289211,8.916282688,3.3810065226,0.4188857639,-2.004667584,-1.58578182
2016,Iowa,Iowa,3134693,12696,39349,28739,10610,6336,-3392,2944,-858,100516,12.578216277,9.1866466135,3.3915696638,2.0253520632,-1.084279387,0.9410726758
2016,Iowa,Adair County,7092,-119,68,99,-31,0,-84,-84,-4,154,9.5084947214,13.843249668,-4.334754947,0.0,-11.7457876,-11.7457876
2016,Iowa,Adams County,3693,-65,41,44,-3,0,-72,-72,10,84,11.005234197,11.810495236,-0.805261039,0.0,-19.32626493,-19.32626493
2016,Iowa,Allamakee County,13884,2,176,180,-4,17,-9,8,-2,300,12.677375207,12.965497371,-0.288122164,1.2245191961,-0.648274869,0.5762443276
2016,Iowa,Appanoose County,12462,-89,137,187,-50,5,-39,-34,-5,126,10.954303762,14.952224843,-3.997921081,0.3997921081,-3.118378443,-2.718586335
2016,Iowa,Audubon County,5678,-60,66,64,2,1,-58,-57,-5,117,11.562718991,11.212333567,0.350385424,0.175192712,-10.1611773,-9.985984583
2016,Iowa,Benton County,25699,36,300,239,61,9,-38,-29,4,297,11.681788092,9.3064911802,2.3752969121,0.3504536428,-1.479693158,-1.129239516
2016,Iowa,Black Hawk County,132904,-595,1768,1189,579,304,-1401,-1097,-77,5506,13.273123801,8.9263259047,4.3467978964,2.2822565812,-10.51789957,-8.235642992
2016,Iowa,Boone County,26532,-39,279,304,-25,0,1,1,-15,721,10.507880911,11.449447301,-0.94156639,0.0,0.0376626556,0.0376626556
2016,Iowa,Bremer County,24798,19,274,226,48,33,-62,-29,0,1610,11.053512718,9.1171309276,1.9363817899,1.3312624806,-2.501159812,-1.169897331
2016,Iowa,Buchanan County,20992,-92,288,186,102,5,-190,-185,-9,326,13.689514212,8.8411445955,4.8483696169,0.2376651773,-9.031276737,-8.79361156
2016,Iowa,Buena Vista County,20332,43,319,167,152,87,-184,-97,-12,970,15.706161837,8.2223480466,7.4838137909,4.2834986829,-9.059353536,-4.775854853
2016,Iowa,Butler County,14791,-105,145,171,-26,11,-104,-93,14,190,9.7685855762,11.520194024,-1.751608448,0.7410651127,-7.006433793,-6.26536868
2016,Iowa,Calhoun County,9846,18,116,142,-26,1,53,54,-10,730,11.792213073,14.435295314,-2.643082241,0.1016570093,5.3878214903,5.4894784995
2016,Iowa,Carroll County,20437,-70,258,258,0,3,-60,-57,-13,461,12.602579132,12.602579132,0.0,0.1465416178,-2.930832356,-2.784290739
2016,Iowa,Cass County,13157,-197,137,178,-41,1,-158,-157,1,249,10.335332503,13.428388216,-3.093055713,0.0754403832,-11.91958055,-11.84414017
2016,Iowa,Cedar County,18454,92,191,183,8,7,82,89,-5,316,10.375923512,9.9413298566,0.4345936549,0.3802694481,4.4545849631,4.8348544111
2016,Iowa,Cerro Gordo County,43070,82,469,497,-28,42,101,143,-33,1047,10.899625834,11.550349764,-0.65072393,0.9760858956,2.3472541774,3.323340073
2016,Iowa,Cherokee County,11508,-59,127,169,-42,0,-20,-20,3,372,11.007583965,14.647887324,-3.640303359,0.0,-1.73347779,-1.73347779
2016,Iowa,Chickasaw County,12023,-62,131,114,17,0,-72,-72,-7,99,10.867761739,9.4574415132,1.4103202257,0.0,-5.973120956,-5.973120956
2016,Iowa,Clarke County,9309,64,123,96,27,1,36,37,0,155,13.258596529,10.348172901,2.9104236283,0.1077934677,3.8805648378,3.9883583055
2016,Iowa,Clay County,16333,-158,199,185,14,3,-164,-161,-11,254,12.12527419,11.272239825,0.8530343651,0.1827930782,-9.992688277,-9.809895199
2016,Iowa,Clayton County,17590,-84,192,185,7,8,-89,-81,-10,276,10.889292196,10.492286751,0.3970054446,0.4537205082,-5.047640653,-4.593920145
2016,Iowa,Clinton County,47309,-308,574,527,47,33,-352,-319,-36,634,12.093630828,11.103385795,0.990245033,0.6952784274,-7.416303226,-6.721024798
2016,Iowa,Crawford County,16940,-58,224,155,69,27,-155,-128,1,530,13.200542165,9.1343037303,4.0662384348,1.5911367788,-9.13430373,-7.543166951
2016,Iowa,Dallas County,84516,3739,1268,433,835,296,2500,2796,108,700,15.342452493,5.2391813325,10.103271161,3.5815188786,30.249314853,33.830833732
2016,Iowa,Davis County,8860,83,145,85,60,0,9,9,14,91,16.442705676,9.638827465,6.8038782106,0.0,1.0205817316,1.0205817316
2016,Iowa,Decatur County,8141,-44,97,80,17,8,-65,-57,-4,758,11.882886194,9.8003185104,2.0825676834,0.980031851,-7.96275879,-6.982726939
2016,Iowa,Delaware County,17327,-79,222,176,46,3,-135,-132,7,219,12.783232085,10.134454265,2.6487778194,0.1727463795,-7.773587079,-7.600840699
2016,Iowa,Des Moines County,39739,-246,469,431,38,30,-286,-256,-28,598,11.76559129,10.812302443,0.9532888465,0.7525964578,-7.174752897,-6.42215644
2016,Iowa,Dickinson County,17243,121,174,177,-3,7,134,141,-17,203,10.126582278,10.301178525,-0.174596246,0.4073912411,7.7986323294,8.2060235705
2016,Iowa,Dubuque County,97003,-31,1237,900,337,111,-453,-342,-26,4343,12.750145591,9.2765812706,3.4735643202,1.14411169,-4.669212573,-3.525100883
2016,Iowa,Emmet County,9658,-74,107,109,-2,4,-87,-83,11,452,11.036616813,11.242908716,-0.206291903,0.4125838061,-8.973697782,-8.561113976
2016,Iowa,Fayette County,20054,-169,213,238,-25,19,-159,-140,-4,914,10.576755965,11.818159247,-1.241403282,0.9434664945,-7.895324875,-6.951858381
2016,Iowa,Floyd County,15873,-81,192,197,-5,-1,-78,-79,3,306,12.065227637,12.379426273,-0.314198636,-0.062839727,-4.901498727,-4.964338455
2016,Iowa,Franklin County,10170,-138,126,99,27,2,-177,-175,10,193,12.305889247,9.6689129798,2.6369762672,0.1953315753,-17.28684442,-17.09151284
2016,Iowa,Fremont County,6950,48,78,84,-6,1,58,59,-5,134,11.261911637,12.128212532,-0.866300895,0.1443834825,8.3742419867,8.5186254692
2016,Iowa,Greene County,9011,51,98,121,-23,2,80,82,-8,80,10.906460408,13.466139892,-2.559679484,0.2225808247,8.9032329865,9.1258138111
2016,Iowa,Grundy County,12313,-100,122,122,0,1,-99,-98,-2,151,9.8681549786,9.8681549786,0.0,0.0808865162,-8.007765106,-7.926878589
2016,Iowa,Guthrie County,10625,-38,116,130,-14,5,-28,-23,-1,145,10.898158587,12.213453589,-1.315295002,0.469748215,-2.630590004,-2.160841789
2016,Iowa,Hamilton County,15076,-137,209,169,40,11,-184,-173,-4,201,13.80038958,11.159166694,2.6412228862,0.7263362937,-12.14962528,-11.42328898
2016,Iowa,Hancock County,10835,-150,120,129,-9,3,-136,-133,-8,134,10.99908341,11.824014665,-0.824931256,0.2749770852,-12.46562786,-12.19065078
2016,Iowa,Hardin County,17226,-50,201,235,-34,12,-18,-6,-10,755,11.651498464,13.622398702,-1.970900238,0.6956118486,-1.043417773,-0.347805924
2016,Iowa,Harrison County,14149,-99,156,182,-26,0,-63,-63,-10,279,10.9870761,12.81825545,-1.83117935,0.0,-4.437088425,-4.437088425
2016,Iowa,Henry County,19773,-119,227,198,29,7,-160,-153,5,1374,11.44585907,9.9836127568,1.4622463129,0.3529560066,-8.067565864,-7.714609858
2016,Iowa,Howard County,9332,-35,118,113,5,2,-46,-44,4,201,12.620995775,12.086207819,0.5347879566,0.2139151826,-4.9200492,-4.706134018
2016,Iowa,Humboldt County,9487,-59,98,112,-14,1,-52,-51,6,119,10.297903641,11.769032733,-1.471129092,0.1050806494,-5.464193769,-5.359113119
2016,Iowa,Ida County,6985,-19,74,99,-25,1,9,10,-4,105,10.579741225,14.153978126,-3.5742369,0.142969476,1.2867252842,1.4296947602
2016,Iowa,Iowa County,16311,-70,187,197,-10,-1,-63,-64,4,284,11.440107672,12.051878135,-0.611770464,-0.061177046,-3.854153921,-3.915330968
2016,Iowa,Jackson County,19472,18,211,228,-17,2,26,28,7,195,10.841083081,11.714535272,-0.873452191,0.1027590813,1.3358680573,1.4386271387
2016,Iowa,Jasper County,36708,-21,407,384,23,6,-31,-25,-19,1754,11.084330787,10.457943543,0.6263872435,0.1634053679,-0.844261067,-0.680855699
2016,Iowa,Jefferson County,18090,237,155,170,-15,308,-58,250,2,1731,8.6247669922,9.4594218624,-0.83465487,17.138246668,-3.227332165,13.910914504
2016,Iowa,Johnson County,146547,1980,1800,727,1073,1004,-71,933,-26,8529,12.366289495,4.9946069237,7.3716825711,6.8976414738,-0.487781419,6.4098600548
2016,Iowa,Jones County,20439,44,211,208,3,10,42,52,-11,1199,10.334525151,10.187588774,0.1469363765,0.4897879218,2.0571092717,2.5468971935
2016,Iowa,Keokuk County,10119,-10,115,100,15,1,-27,-26,1,130,11.359146582,9.8775187673,1.4816278151,0.0987751877,-2.666930067,-2.568154879
2016,Iowa,Kossuth County,15114,-41,166,170,-4,6,-27,-21,-16,240,10.96831742,11.232614226,-0.264296805,0.396445208,-1.784003436,-1.387558228
2016,Iowa,Lee County,34615,-456,395,423,-28,18,-421,-403,-25,1328,11.336566886,12.140171627,-0.803604741,0.516603048,-12.08277129,-11.56616824
2016,Iowa,Linn County,221661,1869,2815,1753,1062,365,553,918,-111,5056,12.75333954,7.9419553157,4.8113842244,1.6536301713,2.5053629718,4.1589931431
2016,Iowa,Louisa County,11142,-89,150,115,35,39,-166,-127,3,118,13.409019801,10.280248514,3.1287712868,3.4863451482,-14.83931525,-11.3529701
2016,Iowa,Lucas County,8647,-45,97,101,-4,7,-53,-46,5,76,11.188649864,11.650037488,-0.461387623,0.8074283407,-6.113386008,-5.305957668
2016,Iowa,Lyon County,11754,5,170,100,70,4,-69,-65,0,165,14.466238353,8.5095519721,5.9566863805,0.3403820789,-5.871590861,-5.531208782
2016,Iowa,Madison County,15848,102,162,160,2,6,98,104,-4,189,10.25511173,10.128505412,0.1266063177,0.379818953,6.2037095651,6.5835285181
2016,Iowa,Mahaska County,22181,-110,295,221,74,12,-192,-180,-4,663,13.2667746,9.9388379205,3.3279366793,0.5396654074,-8.634646519,-8.094981112
2016,Iowa,Marion County,33189,48,359,332,27,17,7,24,-3,1342,10.824664556,10.010553294,0.8141112619,0.5125885723,0.2110658827,0.723654455
2016,Iowa,Marshall County,40312,-200,515,484,31,149,-353,-204,-27,1305,12.743739483,11.976640602,0.7670988815,3.6870236563,-8.735029199,-5.048005543
2016,Iowa,Mills County,14972,157,162,120,42,0,122,122,-7,566,10.877228321,8.0572061638,2.8200221573,0.0,8.1914929332,8.1914929332
2016,Iowa,Mitchell County,10763,-24,125,126,-1,5,-18,-13,-10,242,11.600928074,11.693735499,-0.092807425,0.464037123,-1.670533643,-1.20649652
2016,Iowa,Monona County,8898,-76,91,142,-51,3,-21,-18,-7,205,10.183527305,15.890778872,-5.707251567,0.3357206804,-2.350044763,-2.014324082
2016,Iowa,Monroe County,7870,-77,90,80,10,1,-86,-85,-2,110,11.380160587,10.115698299,1.2644622874,0.1264462287,-10.87437567,-10.74792944
2016,Iowa,Montgomery County,10225,-2,123,130,-7,3,7,10,-5,197,12.028163505,12.712693135,-0.68452963,0.2933698416,0.6845296304,0.9778994719
2016,Iowa,Muscatine County,42940,-77,544,364,180,75,-302,-227,-30,536,12.657491536,8.4693509545,4.1881405819,1.7450585758,-7.026769199,-5.281710623
2016,Iowa,O'Brien County,14020,31,174,190,-16,12,45,57,-10,385,12.424577814,13.567067728,-1.142489914,0.8568674355,3.213252883,4.0701203185
2016,Iowa,Osceola County,6064,-63,77,73,4,6,-68,-62,-5,94,12.632269707,11.976047904,0.656221803,0.9843327045,-11.15577065,-10.17143795
2016,Iowa,Page County,15391,-130,171,193,-22,12,-108,-96,-12,1455,11.063664596,12.487060041,-1.423395445,0.7763975155,-6.98757764,-6.211180124
2016,Iowa,Palo Alto County,9047,-92,111,114,-3,16,-104,-88,-1,299,12.207192346,12.537116463,-0.329924117,1.7595952931,-11.43736941,-9.677774112
2016,Iowa,Plymouth County,25200,287,300,228,72,25,195,220,-5,313,11.972941153,9.0994352763,2.8735058767,0.9977450961,7.7824117494,8.7801568455
2016,Iowa,Pocahontas County,6886,-105,76,88,-12,3,-91,-88,-5,110,10.95337609,12.682856525,-1.729480435,0.4323701088,-13.11522663,-12.68285653
2016,Iowa,Polk County,474045,7357,6986,3466,3520,1343,2539,3882,-45,9690,14.852248194,7.3687220497,7.483526144,2.8552203441,5.3979184317,8.2531387758
2016,Iowa,Pottawattamie County,93582,48,1160,928,232,57,-171,-114,-70,2216,12.398725924,9.9189807392,2.4797451848,0.6092477394,-1.827743218,-1.218495479
2016,Iowa,Poweshiek County,18533,21,177,209,-32,50,-13,37,16,1648,9.5559454717,11.283574032,-1.72762856,2.6994196248,-0.701849102,1.9975705223
2016,Iowa,Ringgold County,5068,14,53,65,-12,2,25,27,-1,174,10.472238688,12.843311598,-2.37107291,0.3951788184,4.9397352302,5.3349140486
2016,Iowa,Sac County,9876,-133,110,128,-18,0,-118,-118,3,200,11.063615791,12.874025647,-1.810409857,0.0,-11.86824239,-11.86824239
2016,Iowa,Scott County,172474,304,2229,1454,775,238,-603,-365,-106,3426,12.93508664,8.4376922273,4.4973944128,1.3811353164,-3.499263008,-2.118127691
2016,Iowa,Shelby County,11800,-113,120,144,-24,27,-116,-89,0,205,10.121030658,12.14523679,-2.024206132,2.2772318981,-9.78366297,-7.506431072
2016,Iowa,Sioux County,34898,146,506,255,251,61,-149,-88,-17,2313,14.529791816,7.3223259153,7.2074659009,1.751615219,-4.278535535,-2.526920316
2016,Iowa,Story County,97090,744,886,502,384,875,-472,403,-43,11836,9.160652619,5.1903471949,3.970305424,9.0469199115,-4.880167084,4.1667528278
2016,Iowa,Tama County,17319,-22,238,197,41,5,-68,-63,0,293,13.733410271,11.367570687,2.3658395845,0.2885170225,-3.923831506,-3.635314484
2016,Iowa,Taylor County,6216,-13,80,57,23,9,-43,-34,-2,80,12.856568903,9.1603053435,3.6962635597,1.4463640016,-6.910405785,-5.464041784
2016,Iowa,Union County,12420,-27,123,138,-15,9,-20,-11,-1,457,9.8926287851,11.09904693,-1.206418145,0.7238508867,-1.608557526,-0.884706639
2016,Iowa,Van Buren County,7271,-54,83,92,-9,0,-44,-44,-1,53,11.372978898,12.606193478,-1.233214579,0.0,-6.029049055,-6.029049055
2016,Iowa,Wapello County,34982,-266,441,389,52,78,-408,-330,12,877,12.558735583,11.077886943,1.4808486402,2.2212729603,-11.61896625,-9.397693293
2016,Iowa,Warren County,49691,985,549,415,134,40,799,839,12,1636,11.158876795,8.4352165208,2.7236602742,0.8130329177,16.24033253,17.053365448
2016,Iowa,Washington County,22281,30,324,234,90,9,-61,-52,-8,314,14.551333872,10.509296686,4.0420371867,0.4042037187,-2.739602982,-2.335399263
2016,Iowa,Wayne County,6452,66,82,94,-12,1,76,77,1,95,12.774575479,14.644025549,-1.86945007,0.1557875058,11.839850444,11.99563795
2016,Iowa,Webster County,36769,-223,450,427,23,47,-275,-228,-18,2666,12.201569935,11.577934139,0.6236357967,1.2743861932,-7.45651496,-6.182128767
2016,Iowa,Winnebago County,10631,64,117,122,-5,0,77,77,-8,415,11.038777243,11.51051986,-0.471742617,0.0,7.2648363053,7.2648363053
2016,Iowa,Winneshiek County,20561,-193,166,171,-5,3,-178,-175,-13,2269,8.0358223406,8.2778651821,-0.242042842,0.1452257049,-8.61672516,-8.471499455
2016,Iowa,Woodbury County,102779,315,1514,927,587,237,-459,-222,-50,2553,14.753243716,9.0331947984,5.7200489176,2.3094575698,-4.472746939,-2.163289369
2016,Iowa,Worth County,7572,10,80,75,5,0,8,8,-3,89,10.572221488,9.911457645,0.660763843,0.0,1.0572221488,1.0572221488
2016,Iowa,Wright County,12779,-24,152,165,-13,8,-10,-2,-9,216,11.883355484,12.899695098,-1.016339614,0.6254397623,-0.781799703,-0.156359941
2016,Kansas,Kansas,2907289,568,38702,25128,13574,5851,-18595,-12744,-262,79042,13.313358594,8.6439479808,4.6694106133,2.0127244363,-6.396617825,-4.383893389
2016,Kansas,Allen County,12714,-10,152,171,-19,5,0,5,4,382,11.950625049,13.44445318,-1.493828131,0.3931126661,0.0,0.3931126661
2016,Kansas,Anderson County,7827,3,96,99,-3,-2,15,13,-7,103,12.267586736,12.650948821,-0.383362085,-0.255574724,1.9168104274,1.6612357038
2016,Kansas,Atchison County,16380,-29,199,171,28,3,-56,-53,-4,1382,12.138217085,10.430327244,1.7078898411,0.1829881973,-3.415779682,-3.232791485
2016,Kansas,Barber County,4688,-133,56,51,5,1,-137,-136,-2,40,11.77831528,10.726679987,1.0516352929,0.2103270586,-28.81480702,-28.60447997
2016,Kansas,Barton County,26775,-317,339,307,32,8,-345,-337,-12,672,12.586555776,11.398444317,1.1881114597,0.2970278649,-12.80932667,-12.51229881
2016,Kansas,Bourbon County,14617,-107,220,156,64,16,-199,-183,12,410,14.99608057,10.633584404,4.3624961658,1.0906240414,-13.56463652,-12.47401247
2016,Kansas,Brown County,9684,-61,118,122,-4,3,-64,-61,4,116,12.14679088,12.558546503,-0.411755623,0.3088167173,-6.588089969,-6.279273251
2016,Kansas,Butler County,67025,424,743,630,113,51,264,315,-4,2307,11.120590304,9.4293026806,1.6912876237,0.7633245027,3.9513268376,4.7146513403
2016,Kansas,Chase County,2669,-7,32,13,19,1,-31,-30,4,145,11.973807297,4.8643592142,7.1094480823,0.374181478,-11.59962582,-11.22544434
2016,Kansas,Chautauqua County,3374,-18,30,42,-12,2,-10,-8,2,79,8.8678687555,12.415016258,-3.547147502,0.5911912504,-2.955956252,-2.364765001
2016,Kansas,Cherokee County,20246,-315,238,265,-27,1,-274,-273,-15,202,11.664665376,12.987967751,-1.323302375,0.0490111991,-13.42906854,-13.38005734
2016,Kansas,Cheyenne County,2661,-26,31,43,-12,4,-22,-18,4,49,11.593118923,16.080777861,-4.487658938,1.4958863126,-8.22737472,-6.731488407
2016,Kansas,Clark County,2072,-17,16,18,-2,1,-14,-13,-2,57,7.6904590243,8.6517664023,-0.961307378,0.480653689,-6.729151646,-6.248497957
2016,Kansas,Clay County,8143,-197,108,112,-4,0,-194,-194,1,140,13.104410605,13.589759146,-0.485348541,0.0,-23.53940423,-23.53940423
2016,Kansas,Cloud County,9150,-85,103,139,-36,18,-72,-54,5,498,11.204786511,15.121022573,-3.916236062,1.958118031,-7.832472124,-5.874354093
2016,Kansas,Coffey County,8433,74,88,80,8,5,63,68,-2,130,10.481181515,9.5283468318,0.9528346832,0.595521677,7.5035731301,8.0990948071
2016,Kansas,Comanche County,1862,23,18,15,3,0,13,13,7,65,9.7271007836,8.1059173196,1.6211834639,0.0,7.0251283437,7.0251283437
2016,Kansas,Cowley County,35753,-24,450,408,42,58,-103,-45,-21,2006,12.582133371,11.407800923,1.1743324479,1.62169719,-2.879910527,-1.258213337
2016,Kansas,Crawford County,39164,-67,550,365,185,102,-350,-248,-4,1775,14.031507111,9.3118183558,4.7196887557,2.6022067734,-8.929140889,-6.326934116
2016,Kansas,Decatur County,2832,-94,37,37,0,0,-99,-99,5,81,12.851684613,12.851684613,0.0,0.0,-34.38693991,-34.38693991
2016,Kansas,Dickinson County,19064,-228,220,209,11,9,-238,-229,-10,307,11.471477735,10.897903848,0.5735738867,0.4692877255,-12.41005319,-11.94076546
2016,Kansas,Doniphan County,7664,-92,61,70,-9,7,-92,-85,2,427,7.9118028534,9.0791180285,-1.167315175,0.9079118029,-11.93255512,-11.02464332
2016,Kansas,Douglas County,119440,1525,1224,655,569,641,303,944,12,8800,10.313665185,5.5191590655,4.7945061195,5.4011923069,2.5531377051,7.954330012
2016,Kansas,Edwards County,2938,-32,34,25,9,3,-43,-40,-1,35,11.509817197,8.4631008802,3.0467163169,1.0155721056,-14.55653351,-13.54096141
2016,Kansas,Elk County,2547,-55,29,35,-6,0,-47,-47,-2,40,11.26432317,13.594872791,-2.330549621,0.0,-18.25597203,-18.25597203
2016,Kansas,Ellis County,28893,-131,325,255,70,60,-253,-193,-8,1033,11.22295699,8.8057047154,2.4172522748,2.0719305213,-8.736640365,-6.664709843
2016,Kansas,Ellsworth County,6328,-2,54,71,-17,0,18,18,-3,979,8.5321535788,11.218201928,-2.686048349,0.0,2.8440511929,2.8440511929
2016,Kansas,Finney County,36722,-278,684,208,476,142,-889,-747,-7,547,18.556197607,5.642820325,12.913377282,3.8523100296,-24.1176311,-20.26532107
2016,Kansas,Ford County,33971,-292,637,231,406,157,-878,-721,23,708,18.671043761,6.7708180672,11.900225694,4.6018114137,-25.73497084,-21.13315942
2016,Kansas,Franklin County,25560,1,310,255,55,15,-80,-65,11,478,12.128562765,9.9767209844,2.1518417809,0.5868659403,-3.129951681,-2.543085741
2016,Kansas,Geary County,35586,-1395,1068,214,854,180,-2436,-2256,7,847,29.434867088,5.8979977125,23.536869376,4.9609326553,-67.13795527,-62.17702261
2016,Kansas,Gove County,2589,-68,39,38,1,0,-69,-69,0,56,14.868471216,14.487228364,0.3812428517,0.0,-26.30575677,-26.30575677
2016,Kansas,Graham County,2564,-25,25,34,-9,2,-18,-16,0,40,9.7030855812,13.19619639,-3.493110809,0.7762468465,-6.986221618,-6.209974772
2016,Kansas,Grant County,7646,-44,126,28,98,-8,-140,-148,6,79,16.431924883,3.6515388628,12.78038602,-1.043296818,-18.25769431,-19.30099113
2016,Kansas,Gray County,6034,-61,79,44,35,6,-100,-94,-2,78,13.02663039,7.255338445,5.7712919449,0.9893643334,-16.48940556,-15.50004122
2016,Kansas,Greeley County,1296,-21,16,12,4,0,-27,-27,2,26,12.246460008,9.1848450057,3.0616150019,0.0,-20.66590126,-20.66590126
2016,Kansas,Greenwood County,6151,-93,66,72,-6,0,-87,-87,0,90,10.649455426,11.617587737,-0.968132311,0.0,-14.03791852,-14.03791852
2016,Kansas,Hamilton County,2536,55,38,15,23,7,27,34,-2,0,15.148495117,5.979669125,9.1688259916,2.7905122583,10.763404425,13.553916683
2016,Kansas,Harper County,5685,-96,82,97,-15,2,-79,-77,-4,129,14.30315716,16.919588348,-2.616431188,0.3488574917,-13.77987092,-13.43101343
2016,Kansas,Harvey County,34913,5,423,337,86,50,-123,-73,-8,1314,12.116698415,9.6532561837,2.4634422308,1.4322338551,-3.523295284,-2.091061429
2016,Kansas,Haskell County,4006,-52,48,17,31,7,-93,-86,3,33,11.904761905,4.2162698413,7.6884920635,1.7361111111,-23.06547619,-21.32936508
2016,Kansas,Hodgeman County,1870,-26,25,30,-5,2,-23,-21,0,14,13.276686139,15.932023367,-2.655337228,1.0621348911,-12.21455125,-11.15241636
2016,Kansas,Jackson County,13291,-37,164,135,29,0,-61,-61,-5,133,12.322025621,10.143130846,2.1788947744,0.0,-4.583192457,-4.583192457
2016,Kansas,Jefferson County,18897,11,175,150,25,-2,-20,-22,8,235,9.26342535,7.9400788715,1.3233464786,-0.105867718,-1.058677183,-1.164544901
2016,Kansas,Jewell County,2901,-77,33,33,0,0,-81,-81,4,27,11.226399047,11.226399047,0.0,0.0,-27.55570675,-27.55570675
2016,Kansas,Johnson County,584451,5693,7336,3890,3446,1137,1001,2138,109,5159,12.613382462,6.6883939172,5.9249885446,1.9549367311,1.7211008512,3.6760375822
2016,Kansas,Kearny County,3917,-31,59,25,34,10,-72,-62,-3,81,15.00317864,6.3572790846,8.645899555,2.5429116338,-18.30896376,-15.76605213
2016,Kansas,Kingman County,7467,-186,72,108,-36,-2,-151,-153,3,190,9.5238095238,14.285714286,-4.761904762,-0.264550265,-19.97354497,-20.23809524
2016,Kansas,Kiowa County,2483,-75,27,26,1,4,-82,-78,2,149,10.712160286,10.315413608,0.3967466772,1.586986709,-32.53322753,-30.94624083
2016,Kansas,Labette County,20444,-305,254,234,20,7,-327,-320,-5,480,12.332192363,11.361153594,0.9710387687,0.3398635691,-15.87648387,-15.5366203
2016,Kansas,Lane County,1636,-27,21,18,3,0,-36,-36,6,3,12.731130646,10.912397696,1.8187329494,0.0,-21.82479539,-21.82479539
2016,Kansas,Leavenworth County,80204,997,984,592,392,100,533,633,-28,6535,12.345446676,7.4273419024,4.9181047732,1.2546185646,6.6871169493,7.9417355139
2016,Kansas,Lincoln County,3073,-53,37,35,2,2,-57,-55,0,50,11.93740926,11.292143894,0.6452653654,0.6452653654,-18.39006291,-17.74479755
2016,Kansas,Linn County,9558,-3,112,117,-5,2,-13,-11,13,63,11.716093938,12.239133846,-0.523039908,0.2092159632,-1.359903761,-1.150687797
2016,Kansas,Logan County,2831,17,37,23,14,5,-5,0,3,41,13.10894597,8.1488042516,4.9601417183,1.7714791851,-1.771479185,0.0
2016,Kansas,Lyon County,33510,267,403,266,137,134,16,150,-20,1447,12.074363699,7.9696792654,4.1046844337,4.0148008329,0.4793792039,4.4941800369
2016,Kansas,McPherson County,28804,-140,332,364,-32,20,-157,-137,29,926,11.498233705,12.606497195,-1.10826349,0.692664681,-5.437417746,-4.744753065
2016,Kansas,Marion County,12112,-8,124,142,-18,10,11,21,-11,723,10.234400792,11.720039617,-1.485638825,0.8253549026,0.9078903929,1.7332452955
2016,Kansas,Marshall County,9836,-70,116,114,2,1,-71,-70,-2,164,11.751595583,11.548981866,0.2026137169,0.1013068585,-7.192786952,-7.091480093
2016,Kansas,Meade County,4216,-72,52,38,14,4,-93,-89,3,119,12.22953904,8.9369708373,3.2925682032,0.9407337723,-21.87206021,-20.93132643
2016,Kansas,Miami County,32964,237,407,277,130,4,104,108,-1,644,12.391347369,8.4334231478,3.957924221,0.1217822837,3.1663393768,3.2881216605
2016,Kansas,Mitchell County,6243,-76,92,98,-6,5,-86,-81,11,246,14.647349148,15.602611049,-0.955261901,0.7960515841,-13.69208725,-12.89603566
2016,Kansas,Montgomery County,32746,-570,420,365,55,45,-677,-632,7,1114,12.715328025,11.050225546,1.6651024795,1.3623565741,-20.49589779,-19.13354122
2016,Kansas,Morris County,5573,-77,60,77,-17,3,-57,-54,-6,66,10.692328254,13.72182126,-3.029493005,0.5346164127,-10.15771184,-9.623095429
2016,Kansas,Morton County,2848,-144,38,29,9,-2,-151,-153,0,83,13.01369863,9.9315068493,3.0821917808,-0.684931507,-51.71232877,-52.39726027
2016,Kansas,Nemaha County,10241,32,158,86,72,1,-46,-45,5,259,15.452322738,8.4107579462,7.0415647922,0.097799511,-4.498777506,-4.400977995
2016,Kansas,Neosho County,16146,-187,216,176,40,20,-248,-228,1,450,13.300902121,10.837772099,2.4631300225,1.2315650112,-15.27140614,-14.03984113
2016,Kansas,Ness County,2962,-53,35,44,-9,5,-49,-44,0,70,11.711560984,14.723105237,-3.011544253,1.6730801405,-16.39618538,-14.72310524
2016,Kansas,Norton County,5493,-59,55,71,-16,0,-51,-51,8,821,9.9592575826,12.856496152,-2.897238569,0.0,-9.23494794,-9.23494794
2016,Kansas,Osage County,15843,-69,170,204,-34,6,-35,-29,-6,194,10.706975279,12.848370335,-2.141395056,0.3778932452,-2.204377263,-1.826484018
2016,Kansas,Osborne County,3642,-42,49,39,10,6,-68,-62,10,100,13.377013377,10.647010647,2.73000273,1.638001638,-18.56401856,-16.92601693
2016,Kansas,Ottawa County,5920,-26,49,65,-16,2,-8,-6,-4,98,8.2588909489,10.955671667,-2.696780718,0.3370975898,-1.348390359,-1.011292769
2016,Kansas,Pawnee County,6743,-62,59,74,-15,-1,-50,-51,4,1028,8.7097726602,10.924121642,-2.214348981,-0.147623265,-7.381163271,-7.528786537
2016,Kansas,Phillips County,5428,-3,74,64,10,1,-13,-12,-1,68,13.629247629,11.787457409,1.8417902201,0.184179022,-2.394327286,-2.210148264
2016,Kansas,Pottawatomie County,23661,467,352,185,167,22,281,303,-3,299,15.025077366,7.8967025931,7.1283747732,0.9390673354,11.994450966,12.933518301
2016,Kansas,Pratt County,9584,-134,149,93,56,4,-198,-194,4,380,15.438814631,9.6363071184,5.8025075122,0.4144648223,-20.5160087,-20.10154388
2016,Kansas,Rawlins County,2549,11,39,22,17,5,-13,-8,2,40,15.33320228,8.6494987222,6.6837035581,1.9657951641,-5.111067427,-3.145272263
2016,Kansas,Reno County,63220,-427,719,702,17,10,-409,-399,-45,3118,11.334704848,11.066707654,0.2679971939,0.1576454082,-6.447697195,-6.290051787
2016,Kansas,Republic County,4699,-23,50,66,-16,3,-13,-10,3,103,10.614584439,14.01125146,-3.39666702,0.6368750663,-2.759791954,-2.122916888
2016,Kansas,Rice County,9831,-112,121,100,21,15,-146,-131,-2,649,12.238292708,10.114291494,2.1240012137,1.5171437241,-14.76686558,-13.24972186
2016,Kansas,Riley County,73343,-1969,1062,352,710,580,-3257,-2677,-2,9080,14.28811678,4.7357976523,9.5523191282,7.8033029498,-43.81958225,-36.0162793
2016,Kansas,Rooks County,5076,-83,63,74,-11,1,-73,-72,0,72,12.310698583,14.460185638,-2.149487054,0.195407914,-14.26477772,-14.06936981
2016,Kansas,Rush County,3058,-44,22,28,-6,1,-48,-47,9,66,7.1428571429,9.0909090909,-1.948051948,0.3246753247,-15.58441558,-15.25974026
2016,Kansas,Russell County,6988,-41,88,89,-1,4,-38,-34,-6,89,12.556181779,12.698865663,-0.142683884,0.5707355354,-5.421987587,-4.851252051
2016,Kansas,Saline County,55142,-374,737,481,256,54,-663,-609,-21,1465,13.320320266,8.6934518968,4.6268683692,0.9759800466,-11.98286613,-11.00688608
2016,Kansas,Scott County,5032,52,74,66,8,0,39,39,5,105,14.782261286,13.184178985,1.5980823012,0.0,7.7906512185,7.7906512185
2016,Kansas,Sedgwick County,511995,1635,7278,4407,2871,1090,-2015,-925,-311,7287,14.237715862,8.6212714762,5.6164443858,2.1323317243,-3.941879289,-1.809547564
2016,Kansas,Seward County,22709,-450,431,118,313,97,-879,-782,19,476,18.793058341,5.1451992675,13.647859074,4.2295282114,-38.3273742,-34.09784599
2016,Kansas,Shawnee County,178146,-395,2290,1801,489,167,-960,-793,-91,4399,12.840389473,10.098489712,2.7418997609,0.9363952149,-5.382870696,-4.446475481
2016,Kansas,Sheridan County,2509,8,22,21,1,0,6,6,1,33,8.7824351297,8.3832335329,0.3992015968,0.0,2.3952095808,2.3952095808
2016,Kansas,Sherman County,5965,-11,76,83,-7,-2,-4,-6,2,102,12.729252156,13.901683276,-1.17243112,-0.33498032,-0.66996064,-1.00494096
2016,Kansas,Smith County,3632,-61,27,47,-20,0,-51,-51,10,56,7.3720136519,12.832764505,-5.460750853,0.0,-13.92491468,-13.92491468
2016,Kansas,Stafford County,4208,-28,55,45,10,-1,-38,-39,1,69,13.027001421,10.658455708,2.3685457129,-0.236854571,-9.000473709,-9.23732828
2016,Kansas,Stanton County,2062,9,24,16,8,2,-1,1,0,47,11.664641555,7.7764277035,3.8882138518,0.9720534629,-0.486026731,0.4860267315
2016,Kansas,Stevens County,5584,-147,64,28,36,17,-201,-184,1,72,11.312417145,4.9491825011,6.3632346443,3.0048608042,-35.5280601,-32.52319929
2016,Kansas,Sumner County,23272,-222,257,257,0,13,-224,-211,-11,409,10.990890818,10.990890818,0.0,0.5559594577,-9.579609118,-9.02364966
2016,Kansas,Thomas County,7892,-23,135,62,73,6,-100,-94,-2,353,17.081040046,7.8446257987,9.2364142469,0.7591573354,-12.65262226,-11.89346492
2016,Kansas,Trego County,2872,-51,39,47,-8,1,-43,-42,-1,64,13.459879206,16.220880069,-2.761000863,0.3451251079,-14.84037964,-14.49525453
2016,Kansas,Wabaunsee County,6891,-14,65,49,16,2,-29,-27,-3,90,9.4230211656,7.1035082633,2.3195129023,0.2899391128,-4.204117135,-3.914178023
2016,Kansas,Wallace County,1497,-16,19,15,4,0,-22,-22,2,19,12.624584718,9.9667774086,2.657807309,0.0,-14.6179402,-14.6179402
2016,Kansas,Washington County,5546,-18,67,85,-18,6,-2,4,-4,114,12.061206121,15.301530153,-3.240324032,1.0801080108,-0.360036004,0.7200720072
2016,Kansas,Wichita County,2112,-33,27,18,9,0,-45,-45,3,26,12.684989429,8.4566596195,4.2283298097,0.0,-21.14164905,-21.14164905
2016,Kansas,Wilson County,8723,-129,103,117,-14,1,-116,-115,0,121,11.721194879,13.314366999,-1.593172119,0.1137980085,-13.20056899,-13.08677098
2016,Kansas,Woodson County,3165,41,35,45,-10,0,50,50,1,39,11.130545397,14.310701224,-3.180155828,0.0,15.900779138,15.900779138
2016,Kansas,Wyandotte County,163831,736,2755,1434,1321,667,-1301,-634,49,1335,16.853966953,8.7726274447,8.081339508,4.0804341044,-7.958987661,-3.878553556
2016,Kentucky,Kentucky,4436974,12363,55198,44883,10315,6734,-3429,3305,-1257,131248,12.457816519,10.129790551,2.3280259683,1.5198184072,-0.773902186,0.7459162215
2016,Kentucky,Adair County,19280,16,211,222,-11,8,34,42,-15,1409,10.948526359,11.519302615,-0.570776256,0.4151100042,1.7642175176,2.1793275218
2016,Kentucky,Allen County,20631,70,256,238,18,0,46,46,6,197,12.42959798,11.555641872,0.873956108,0.0,2.2334433871,2.2334433871
2016,Kentucky,Anderson County,22158,229,238,195,43,0,193,193,-7,108,10.796833534,8.8461451221,1.9506884115,0.0,8.7554154286,8.7554154286
2016,Kentucky,Ballard County,8054,-165,81,102,-21,2,-145,-143,-1,127,9.9551404166,12.536102747,-2.58096233,0.2458059362,-17.82093038,-17.57512444
2016,Kentucky,Barren County,43993,317,601,514,87,38,175,213,17,701,13.710661693,11.725923645,1.9847380488,0.8668970788,3.9922891786,4.8591862574
2016,Kentucky,Bath County,12327,66,176,158,18,0,49,49,-1,103,14.315926468,12.851797625,1.4641288433,0.0,3.9856840735,3.9856840735
2016,Kentucky,Bell County,27117,-177,323,360,-37,-1,-128,-129,-11,952,11.872599291,13.232618404,-1.360019114,-0.036757273,-4.704930988,-4.741688262
2016,Kentucky,Boone County,128536,1373,1700,923,777,265,341,606,-10,835,13.296884227,7.2194259657,6.0774582615,2.0727496001,2.667198542,4.7399481422
2016,Kentucky,Bourbon County,20030,-43,239,227,12,11,-52,-41,-14,236,11.919307782,11.320848814,0.5984589682,0.5485873875,-2.593322195,-2.044734808
2016,Kentucky,Boyd County,48132,-356,575,584,-9,6,-335,-329,-18,2143,11.902297661,12.088594494,-0.186296833,0.1241978886,-6.934382116,-6.810184227
2016,Kentucky,Boyle County,30018,211,324,313,11,16,168,184,16,3218,10.831592144,10.463852904,0.3677392394,0.5348934392,5.6163811116,6.1512745508
2016,Kentucky,Bracken County,8400,71,104,102,2,1,73,74,-5,41,12.433498715,12.19439297,0.2391057445,0.1195528723,8.7273596748,8.8469125471
2016,Kentucky,Breathitt County,13284,-146,175,196,-21,2,-123,-121,-4,322,13.101744404,14.673953732,-1.572209328,0.1497342218,-9.208654638,-9.058920416
2016,Kentucky,Breckinridge County,19961,-32,218,201,17,0,-34,-34,-15,300,10.912549432,10.061570806,0.8509786254,0.0,-1.701957251,-1.701957251
2016,Kentucky,Bullitt County,79151,498,828,621,207,5,314,319,-28,340,10.49403057,7.8705229272,2.6235076424,0.0633697498,3.9796202885,4.0429900383
2016,Kentucky,Butler County,12845,-15,147,125,22,19,-51,-32,-5,203,11.437463528,9.7257342929,1.7117292356,1.4783116125,-3.968099592,-2.489787979
2016,Kentucky,Caldwell County,12568,-122,144,158,-14,0,-102,-102,-6,148,11.402327975,12.51088764,-1.108559664,0.0,-8.076648983,-8.076648983
2016,Kentucky,Calloway County,38437,-4,407,408,-1,119,-104,15,-18,3232,10.588204688,10.614219933,-0.026015245,3.0958141471,-2.705585473,0.390228674
2016,Kentucky,Campbell County,92211,286,1191,884,307,161,-146,15,-36,3294,12.936090716,9.6015988183,3.3344918973,1.7487074771,-1.58578442,0.1629230569
2016,Kentucky,Carlisle County,4855,-48,74,60,14,2,-63,-61,-1,60,15.167042427,12.297601968,2.8694404591,0.4099200656,-12.91248207,-12.502562
2016,Kentucky,Carroll County,10679,-39,159,125,34,6,-78,-72,-1,325,14.861896528,11.683880918,3.1780156097,0.5608262841,-7.290741693,-6.729915409
2016,Kentucky,Carter County,27046,-178,350,346,4,9,-171,-162,-20,652,12.89847061,12.751059517,0.1474110927,0.3316749585,-6.301824212,-5.970149254
2016,Kentucky,Casey County,15815,0,198,212,-14,-6,29,23,-9,478,12.519759722,13.404995258,-0.885235536,-0.379386658,1.8337021815,1.4543155232
2016,Kentucky,Christian County,72351,-1133,1622,617,1005,239,-2379,-2140,2,5394,22.244317208,8.4616175815,13.782699626,3.2776768266,-32.62591285,-29.34823602
2016,Kentucky,Clark County,35819,135,388,357,31,13,105,118,-14,458,10.852691495,9.98559501,0.8670964855,0.3636211068,2.9369397088,3.3005608156
2016,Kentucky,Clay County,20766,-281,267,244,23,15,-309,-294,-10,1869,12.771147729,11.671011408,1.1001363212,0.7174802095,-14.78009232,-14.06261211
2016,Kentucky,Clinton County,10177,42,128,103,25,10,12,22,-5,136,12.60338716,10.141788106,2.4615990547,0.9846396219,1.1815675463,2.1662071682
2016,Kentucky,Crittenden County,9188,-10,115,106,9,0,-18,-18,-1,210,12.509518112,11.530512346,0.9790057653,0.0,-1.958011531,-1.958011531
2016,Kentucky,Cumberland County,6738,-18,74,120,-46,7,10,17,11,86,10.967837557,17.785682526,-6.817844968,1.0374981473,1.4821402105,2.5196383578
2016,Kentucky,Daviess County,99674,341,1353,1043,310,76,27,103,-72,2579,13.597511645,10.482043345,3.1154683001,0.7637922284,0.271347239,1.0351394675
2016,Kentucky,Edmonson County,12114,74,107,142,-35,5,102,107,2,354,8.8598161795,11.757886892,-2.898070713,0.4140101018,8.4458060777,8.8598161795
2016,Kentucky,Elliott County,7588,-62,72,72,0,0,-59,-59,-3,1061,9.4500590629,9.4500590629,0.0,0.0,-7.743798399,-7.743798399
2016,Kentucky,Estill County,14307,-54,154,174,-20,0,-22,-22,-12,118,10.74368634,12.13897028,-1.39528394,0.0,-1.534812334,-1.534812334
2016,Kentucky,Fayette County,318449,3682,4107,2231,1876,1350,607,1957,-151,13900,12.971876895,7.0465686275,5.9253082676,4.2639478472,1.9171972913,6.1811451385
2016,Kentucky,Fleming County,14507,-106,186,174,12,-1,-112,-113,-5,22,12.774725275,11.950549451,0.8241758242,-0.068681319,-7.692307692,-7.760989011
2016,Kentucky,Floyd County,37110,-569,437,560,-123,9,-436,-427,-19,670,11.686210539,14.975464306,-3.289253767,0.2406771049,-11.65946864,-11.41879153
2016,Kentucky,Franklin County,50560,287,585,507,78,65,157,222,-13,1906,11.603344143,10.056231591,1.5471125524,1.2892604604,3.1140598812,4.4033203416
2016,Kentucky,Fulton County,6179,-80,80,102,-22,1,-64,-63,5,445,12.86380447,16.401350699,-3.537546229,0.1607975559,-10.29104358,-10.13024602
2016,Kentucky,Gallatin County,8609,47,92,66,26,7,-17,-10,31,85,10.715741657,7.6873798847,3.0283617728,0.8153281696,-1.980082698,-1.164754528
2016,Kentucky,Garrard County,17292,117,164,175,-11,4,127,131,-3,109,9.5163489715,10.154640671,-0.638291699,0.2321060725,7.3693678011,7.6014738736
2016,Kentucky,Grant County,24923,183,353,223,130,-4,63,59,-6,456,14.21581459,8.9805287639,5.2352858265,-0.161085718,2.5371000544,2.3760143366
2016,Kentucky,Graves County,37182,-69,485,411,74,26,-139,-113,-30,463,13.031854151,11.043488775,1.9883653756,0.6986148617,-3.73490253,-3.036287668
2016,Kentucky,Grayson County,26184,-49,334,292,42,0,-76,-76,-15,768,12.743957113,11.141423584,1.6025335292,0.0,-2.899822577,-2.899822577
2016,Kentucky,Green County,11060,38,116,129,-13,8,52,60,-9,113,10.50629472,11.6837243,-1.177429581,0.7245720496,4.7097183226,5.4342903722
2016,Kentucky,Greenup County,35893,-138,381,460,-79,2,-39,-37,-22,454,10.594516434,12.791279684,-2.19676325,0.0556142595,-1.08447806,-1.028863801
2016,Kentucky,Hancock County,8810,100,128,81,47,-1,59,58,-5,90,14.611872146,9.2465753425,5.3652968037,-0.114155251,6.7351598174,6.6210045662
2016,Kentucky,Hardin County,107316,830,1442,938,504,207,112,319,7,3257,13.489116098,8.7744735784,4.7146425197,1.9363710349,1.0476983377,2.9840693726
2016,Kentucky,Harlan County,27168,-445,340,392,-52,3,-392,-389,-4,627,12.413062923,14.31153137,-1.898468447,0.1095270258,-14.31153137,-14.20200434
2016,Kentucky,Harrison County,18646,-66,215,205,10,21,-93,-72,-4,275,11.510252155,10.974891589,0.5353605653,1.1242571872,-4.978853258,-3.85459607
2016,Kentucky,Hart County,18627,138,257,194,63,8,77,85,-10,227,13.848475051,10.453712685,3.3947623666,0.4310809354,4.1491540037,4.5802349391
2016,Kentucky,Henderson County,46253,-135,561,535,26,2,-144,-142,-19,1165,12.111268229,11.54996168,0.5613065489,0.0431774268,-3.108774733,-3.065597306
2016,Kentucky,Henry County,15818,274,146,159,-13,5,289,294,-7,80,9.3106306996,10.13965946,-0.829028761,0.3188572157,18.42994707,18.748804285
2016,Kentucky,Hickman County,4627,-15,45,72,-27,0,14,14,-2,212,9.7097853059,15.535656489,-5.825871184,0.0,3.0208220952,3.0208220952
2016,Kentucky,Hopkins County,45904,-377,566,543,23,23,-408,-385,-15,1086,12.279655041,11.780658459,0.498996583,0.498996583,-8.851765472,-8.352768889
2016,Kentucky,Jackson County,13368,22,155,153,2,0,29,29,-9,110,11.604402186,11.454667964,0.1497342218,0.0,2.1711462155,2.1711462155
2016,Kentucky,Jefferson County,765352,1843,9918,7513,2405,2460,-2488,-28,-534,15195,12.974364576,9.8282316051,3.1461329709,3.2180819577,-3.254710533,-0.036628575
2016,Kentucky,Jessamine County,52357,421,681,400,281,111,13,124,16,1723,13.059361606,7.6706969787,5.3886646275,2.1286184116,0.2492976518,2.3779160634
2016,Kentucky,Johnson County,22978,-234,283,297,-14,1,-204,-203,-17,531,12.253734575,12.859926391,-0.606191816,0.0432994155,-8.833080753,-8.789781338
2016,Kentucky,Kenton County,164945,603,2357,1460,897,176,-397,-221,-73,2508,14.315779244,8.8676443346,5.4481349097,1.0689763033,-2.411270412,-1.342294108
2016,Kentucky,Knott County,15544,-156,191,192,-1,6,-154,-148,-7,792,12.226347459,12.290359749,-0.06401229,0.3840737422,-9.857892715,-9.473818973
2016,Kentucky,Knox County,31687,19,385,450,-65,-4,73,69,15,692,12.153736879,14.205666483,-2.051929603,-0.126272591,2.3044747849,2.178202194
2016,Kentucky,Larue County,14096,-97,138,162,-24,-3,-65,-68,-5,313,9.7564424335,11.453215031,-1.696772597,-0.212096575,-4.595425784,-4.807522359
2016,Kentucky,Laurel County,60250,149,719,649,70,11,75,86,-7,698,11.948384309,10.78512019,1.1632641191,0.1827986473,1.2463544133,1.4291530606
2016,Kentucky,Lawrence County,15863,-30,200,210,-10,21,-34,-13,-7,108,12.596044842,13.225847084,-0.629802242,1.3225847084,-2.141327623,-0.818742915
2016,Kentucky,Lee County,6580,-157,72,105,-33,-1,-118,-119,-5,179,10.813246227,15.769317414,-4.956071187,-0.150183975,-17.72170909,-17.87189307
2016,Kentucky,Leslie County,10538,-169,131,167,-36,0,-148,-148,15,227,12.332313486,15.721346199,-3.389032714,0.0,-13.93269004,-13.93269004
2016,Kentucky,Letcher County,22773,-318,266,298,-32,2,-301,-299,13,243,11.5995116,12.994941566,-1.395429967,0.0872143729,-13.12576313,-13.03854875
2016,Kentucky,Lewis County,13442,-134,137,149,-12,0,-119,-119,-3,139,10.141387223,11.029683914,-0.888296691,0.0,-8.808942187,-8.808942187
2016,Kentucky,Lincoln County,24372,-16,291,272,19,0,-30,-30,-5,219,11.936013126,11.156685808,0.7793273175,0.0,-1.230516817,-1.230516817
2016,Kentucky,Livingston County,9269,-55,100,124,-24,5,-38,-33,2,69,10.756736406,13.338353144,-2.581616737,0.5378368203,-4.087559834,-3.549723014
2016,Kentucky,Logan County,26593,-146,302,280,22,0,-170,-170,2,277,11.325283132,10.500262507,0.8250206255,0.0,-6.375159379,-6.375159379
2016,Kentucky,Lyon County,8069,-220,53,129,-76,1,-144,-143,-1,1019,6.4800097811,15.772099279,-9.292089497,0.1222643355,-17.60606431,-17.48379998
2016,Kentucky,McCracken County,65162,189,728,848,-120,9,351,360,-51,1190,11.188381296,13.032619972,-1.844238675,0.1383179006,5.394398125,5.5327160257
2016,Kentucky,McCreary County,17511,-350,195,169,26,2,-370,-368,-8,1991,11.025670021,9.5555806853,1.4700893362,0.1130837951,-20.92050209,-20.8074183
2016,Kentucky,McLean County,9475,-21,102,114,-12,0,-15,-15,6,82,10.753254968,12.018343788,-1.26508882,0.0,-1.581361025,-1.581361025
2016,Kentucky,Madison County,89547,1271,1013,716,297,72,906,978,-4,6285,11.393351816,8.0529515305,3.3404002857,0.8097940086,10.189907942,10.999701951
2016,Kentucky,Magoffin County,12684,-110,145,153,-8,3,-113,-110,8,127,11.382369103,12.010361881,-0.627992778,0.2354972918,-8.87039799,-8.634900699
2016,Kentucky,Marion County,19205,-58,260,196,64,9,-134,-125,3,502,13.517729022,10.190288032,3.3274409899,0.4679213892,-6.966829573,-6.498908183
2016,Kentucky,Marshall County,31365,256,335,430,-95,11,346,357,-6,464,10.724461376,13.765726542,-3.041265166,0.3521464929,11.076607869,11.428754362
2016,Kentucky,Martin County,12002,-350,110,160,-50,4,-298,-294,-6,1508,9.0334236676,13.139525335,-4.106101667,0.3284881334,-24.47236594,-24.1438778
2016,Kentucky,Mason County,17190,113,197,192,5,0,121,121,-13,298,11.497942627,11.206116672,0.291825955,0.0,7.062188111,7.062188111
2016,Kentucky,Meade County,28126,273,241,215,26,64,181,245,2,212,8.6103717465,7.6814519731,0.9289197735,2.2865717501,6.4667107308,8.7532824809
2016,Kentucky,Menifee County,6408,45,63,89,-26,0,73,73,-2,272,9.8661028894,13.937827891,-4.071725002,0.0,11.432150967,11.432150967
2016,Kentucky,Mercer County,21477,29,238,267,-29,15,53,68,-10,128,11.089108911,12.440302854,-1.351193943,0.6988934188,2.4694234129,3.1683168317
2016,Kentucky,Metcalfe County,10018,98,120,137,-17,1,112,113,2,121,12.037315679,13.742602066,-1.705286388,0.100310964,11.234827967,11.335138931
2016,Kentucky,Monroe County,10588,-65,133,152,-19,7,-47,-40,-6,143,12.522950897,14.311943882,-1.788992985,0.6591026788,-4.4254037,-3.766301022
2016,Kentucky,Montgomery County,27771,140,385,281,104,0,40,40,-4,355,13.89841522,10.144038121,3.7543770983,0.0,1.4439911917,1.4439911917
2016,Kentucky,Morgan County,13298,6,130,157,-27,13,12,25,8,1808,9.7781120722,11.808950733,-2.030838661,0.9778112072,0.9025949605,1.8804061677
2016,Kentucky,Muhlenberg County,31028,-118,333,434,-101,-1,-19,-20,3,2096,10.71187313,13.960819635,-3.248946505,-0.032167787,-0.611187956,-0.643355744
2016,Kentucky,Nelson County,45559,442,582,390,192,3,253,256,-6,496,12.836913847,8.6020556707,4.2348581764,0.066169659,5.5803079095,5.6464775685
2016,Kentucky,Nicholas County,7084,-4,78,115,-37,0,39,39,-6,95,11.00762066,16.229184307,-5.221563647,0.0,5.5038103302,5.5038103302
2016,Kentucky,Ohio County,24378,162,257,262,-5,42,140,182,-15,307,10.577437544,10.783224266,-0.205786723,1.7286084702,5.7620282339,7.4906367041
2016,Kentucky,Oldham County,65560,934,565,390,175,30,731,761,-2,5113,8.6798887745,5.9914276497,2.6884611249,0.46087905,11.230086184,11.690965234
2016,Kentucky,Owen County,10642,-68,96,106,-10,0,-62,-62,4,0,8.9921318846,9.9288122892,-0.936680405,0.0,-5.807418509,-5.807418509
2016,Kentucky,Owsley County,4491,21,53,60,-7,-1,26,25,3,90,11.829036938,13.391362571,-1.562325633,-0.223189376,5.8029237808,5.5797344046
2016,Kentucky,Pendleton County,14560,97,180,152,28,0,68,68,1,215,12.403955484,10.474451297,1.9295041863,0.0,4.6859387382,4.6859387382
2016,Kentucky,Perry County,27343,-203,387,440,-53,1,-162,-161,11,611,14.10118603,16.03235621,-1.93117018,0.0364371732,-5.902822059,-5.866384886
2016,Kentucky,Pike County,60555,-1249,623,831,-208,11,-1052,-1041,0,1615,10.183149584,13.582981227,-3.399831643,0.1797987888,-17.19530235,-17.01550356
2016,Kentucky,Powell County,12308,37,164,141,23,-1,20,19,-5,188,13.344725172,11.473208837,1.8715163351,-0.081370275,1.6274055088,1.5460352333
2016,Kentucky,Pulaski County,63956,129,716,795,-79,38,185,223,-15,962,11.206498517,12.442969722,-1.236471205,0.5947583012,2.8955338347,3.4902921359
2016,Kentucky,Robertson County,2155,-3,24,31,-7,0,7,7,-3,57,11.129144447,14.375144911,-3.246000464,0.0,3.2460004637,3.2460004637
2016,Kentucky,Rockcastle County,16850,-100,174,242,-68,1,-24,-23,-9,341,10.295857988,14.319526627,-4.023668639,0.0591715976,-1.420118343,-1.360946746
2016,Kentucky,Rowan County,24451,-216,266,204,62,8,-293,-285,7,3179,10.831059897,8.3065271387,2.5245327578,0.3257461623,-11.93045319,-11.60470703
2016,Kentucky,Russell County,17722,86,202,220,-18,14,97,111,-7,177,11.425985633,12.444142768,-1.018157136,0.7918999943,5.4867356751,6.2786356694
2016,Kentucky,Scott County,53972,1645,653,384,269,53,1282,1335,41,1651,12.286098646,7.2249033387,5.0611953076,0.9971871796,24.120640834,25.117828013
2016,Kentucky,Shelby County,46408,817,628,308,320,95,420,515,-18,1832,13.652322308,6.6957249535,6.9565973543,2.0652398396,9.1305340275,11.195773867
2016,Kentucky,Simpson County,18083,93,220,157,63,10,22,32,-2,327,12.197488426,8.704571286,3.4929171402,0.5544312921,1.2197488426,1.7741801347
2016,Kentucky,Spencer County,18274,295,219,150,69,0,221,221,5,113,12.081758751,8.2751772267,3.8065815243,0.0,12.192094447,12.192094447
2016,Kentucky,Taylor County,25397,-170,319,321,-2,41,-203,-162,-6,1378,12.518640609,12.597127384,-0.078486775,1.6089788871,-7.96640766,-6.357428773
2016,Kentucky,Todd County,12295,-142,146,134,12,1,-168,-167,13,195,11.806566392,10.836163675,0.9704027171,0.0808668931,-13.58563804,-13.50477115
2016,Kentucky,Trigg County,14264,54,131,172,-41,0,101,101,-6,78,9.2013766945,12.081196881,-2.879820187,0.0,7.094191192,7.094191192
2016,Kentucky,Trimble County,8620,-143,96,101,-5,0,-145,-145,7,41,11.045274118,11.620548812,-0.575274694,0.0,-16.68296612,-16.68296612
2016,Kentucky,Union County,14880,-173,188,178,10,6,-185,-179,-4,1663,12.561387098,11.89322821,0.6681588882,0.4008953329,-12.36093943,-11.9600441
2016,Kentucky,Warren County,125532,2373,1636,929,707,535,1115,1650,16,6453,13.156889473,7.4711187779,5.6857706954,4.3025280368,8.9669509552,13.269478992
2016,Kentucky,Washington County,12189,84,129,129,0,32,55,87,-3,426,10.61990615,10.61990615,0.0,2.6343953239,4.527866963,7.162262287
2016,Kentucky,Wayne County,20453,49,221,197,24,-4,24,20,5,331,10.818219644,9.6433903615,1.1748292826,-0.19580488,1.1748292826,0.9790244022
2016,Kentucky,Webster County,13316,77,184,152,32,13,39,52,-7,393,13.858030503,11.447938241,2.4100922613,0.9790999812,2.9372999435,3.9163999247
2016,Kentucky,Whitley County,36096,96,571,442,129,11,-48,-37,4,1739,15.839991123,12.261429206,3.5785619174,0.3051486906,-1.331557923,-1.026409232
2016,Kentucky,Wolfe County,7159,-71,82,103,-21,0,-57,-57,7,132,11.397595385,14.316491765,-2.918896379,0.0,-7.922718743,-7.922718743
2016,Kentucky,Woodford County,26124,248,282,226,56,37,150,187,5,327,10.846153846,8.6923076923,2.1538461538,1.4230769231,5.7692307692,7.1923076923
2016,Louisiana,Louisiana,4681666,12706,63570,45030,18540,7223,-12243,-5020,-814,128612,13.596950621,9.6314407185,3.9655099028,1.5449233025,-2.618648206,-1.073724904
2016,Louisiana,Acadia Parish,62645,44,875,668,207,52,-217,-165,2,1050,13.972502116,10.66700733,3.3054947863,0.83036584,-3.465180525,-2.634814685
2016,Louisiana,Allen Parish,25684,82,319,240,79,7,-2,5,-2,4180,12.440042117,9.3592793355,3.0807627813,0.2729789806,-0.077993994,0.1949849862
2016,Louisiana,Ascension Parish,121587,2214,1765,842,923,116,1152,1268,23,790,14.649734396,6.9887118194,7.6610225764,0.962815405,9.561752988,10.524568393
2016,Louisiana,Assumption Parish,22695,-151,249,222,27,15,-177,-162,-16,199,10.935201247,9.7494565337,1.1857447136,0.6587470631,-7.773215344,-7.114468281
2016,Louisiana,Avoyelles Parish,41117,40,535,457,78,35,-79,-44,6,3343,13.017981848,11.120033092,1.8979487554,0.8516436723,-1.922281432,-1.070637759
2016,Louisiana,Beauregard Parish,36927,450,498,378,120,21,292,313,17,1295,13.568742848,10.299166258,3.2695765898,0.5721759032,7.9559697019,8.5281456051
2016,Louisiana,Bienville Parish,13865,-6,188,204,-16,0,7,7,3,319,13.556388809,14.710124027,-1.153735218,0.0,0.5047591578,0.5047591578
2016,Louisiana,Bossier Parish,126057,469,1814,1050,764,260,-535,-275,-20,2567,14.41713525,8.3450893123,6.0720459377,2.0664030678,-4.252021697,-2.185618629
2016,Louisiana,Caddo Parish,248851,-2554,3506,2731,775,233,-3479,-3246,-83,6259,14.016823386,10.918409774,3.0984136122,0.9315230602,-13.90887865,-12.97735559
2016,Louisiana,Calcasieu Parish,200601,1908,2775,1997,778,189,1043,1232,-102,3801,13.899532675,10.002654686,3.8968779897,0.9466708741,5.2242207496,6.1708916237
2016,Louisiana,Caldwell Parish,10087,55,154,125,29,3,18,21,5,584,15.308911974,12.426064914,2.88284706,0.2982255579,1.7893533476,2.0875789055
2016,Louisiana,Cameron Parish,6882,80,66,62,4,0,70,70,6,20,9.6463022508,9.061677872,0.5846243788,0.0,10.23092663,10.23092663
2016,Louisiana,Catahoula Parish,9921,-153,107,119,-12,18,-154,-136,-5,866,10.702675669,11.902975744,-1.200300075,1.8004501125,-15.40385096,-13.60340085
2016,Louisiana,Claiborne Parish,16132,-119,175,191,-16,10,-114,-104,1,2913,10.808140073,11.79631288,-0.988172807,0.6176080042,-7.040731248,-6.423123244
2016,Louisiana,Concordia Parish,19920,-277,267,247,20,6,-306,-300,3,1485,13.311065134,12.313981604,0.9970835307,0.2991250592,-15.25537802,-14.95625296
2016,Louisiana,De Soto Parish,27149,85,330,284,46,5,47,52,-13,215,12.17420176,10.477191817,1.6970099423,0.1844576024,1.7339014627,1.9183590652
2016,Louisiana,East Baton Rouge Parish,447037,821,6034,3880,2154,1036,-2126,-1090,-243,11154,13.510170131,8.6873483772,4.8228217537,2.319611577,-4.760129549,-2.440517972
2016,Louisiana,East Carroll Parish,7271,-24,117,73,44,-1,-75,-76,8,1067,16.064808458,10.023342029,6.0414664287,-0.137306055,-10.29795414,-10.43526019
2016,Louisiana,East Feliciana Parish,19683,8,208,229,-21,0,6,6,23,2405,10.569642766,11.636770161,-1.067127395,0.0,0.3048935413,0.3048935413
2016,Louisiana,Evangeline Parish,33709,-80,495,383,112,70,-241,-171,-21,1380,14.667101247,11.3484844,3.3186168479,2.0741355299,-7.140952325,-5.066816795
2016,Louisiana,Franklin Parish,20330,-73,259,275,-16,1,-47,-46,-11,732,12.716961677,13.502565487,-0.78560381,0.0491002381,-2.307711192,-2.258610954
2016,Louisiana,Grant Parish,22365,19,268,180,88,6,-82,-76,7,2951,11.988101362,8.0517098701,3.936391492,0.268390329,-3.668001163,-3.399610834
2016,Louisiana,Iberia Parish,73273,-680,1113,770,343,92,-1111,-1019,-4,944,15.119612025,10.460108948,4.6595030769,1.2497792509,-15.09244291,-13.84266366
2016,Louisiana,Iberville Parish,32920,-216,406,292,114,17,-345,-328,-2,3991,12.292600218,8.840983408,3.45161681,0.5147147875,-10.44568245,-9.930967664
2016,Louisiana,Jackson Parish,15808,-58,178,210,-32,0,-25,-25,-1,1038,11.239502431,13.260087138,-2.020584707,0.0,-1.578581802,-1.578581802
2016,Louisiana,Jefferson Parish,436523,968,5796,4301,1495,1659,-1903,-244,-283,3315,13.292388984,9.863796587,3.4285923966,3.8047055424,-4.364288515,-0.559582973
2016,Louisiana,Jefferson Davis Parish,31413,-21,456,399,57,6,-102,-96,18,567,14.511432527,12.697503461,1.8139290658,0.1909399017,-3.245978328,-3.055038427
2016,Louisiana,Lafayette Parish,241398,1969,3477,1870,1607,480,-132,348,14,5171,14.462582176,7.7782653636,6.6843168125,1.9965600933,-0.549054026,1.4475060677
2016,Louisiana,Lafourche Parish,98305,143,1245,863,382,128,-330,-202,-37,1630,12.673884164,8.7851903882,3.8886937755,1.3030178096,-3.35934279,-2.056324981
2016,Louisiana,LaSalle Parish,15052,48,180,177,3,11,30,41,4,1243,11.977641735,11.778014373,0.1996273623,0.7319669949,1.9962736226,2.7282406175
2016,Louisiana,Lincoln Parish,47745,26,565,413,152,194,-329,-135,9,4936,11.836922819,8.6524763262,3.1844464929,4.0643593396,-6.892650633,-2.828291293
2016,Louisiana,Livingston Parish,140138,2463,1864,1115,749,60,1654,1714,0,1192,13.419098458,8.0269821787,5.3921162797,0.4319452293,11.907290156,12.339235385
2016,Louisiana,Madison Parish,11528,-47,181,158,23,0,-65,-65,-5,1596,15.668960741,13.677877332,1.9910834091,0.0,-5.626974852,-5.626974852
2016,Louisiana,Morehouse Parish,26071,-357,367,367,0,7,-376,-369,12,768,13.98121869,13.98121869,0.0,0.2666717461,-14.32408236,-14.05741062
2016,Louisiana,Natchitoches Parish,39162,25,494,403,91,26,-100,-74,8,2205,12.61829653,10.293873485,2.324423045,0.66412087,-2.554311038,-1.890190168
2016,Louisiana,Orleans Parish,391495,1757,5102,3418,1684,1020,-759,261,-188,13424,13.061404216,8.7502704059,4.3111338103,2.6112568209,-1.943082281,0.6681745395
2016,Louisiana,Ouachita Parish,156983,-35,2281,1644,637,93,-677,-584,-88,5554,14.528616151,10.471304232,4.0573119194,0.5923548014,-4.312088178,-3.719733377
2016,Louisiana,Plaquemines Parish,23464,-104,324,189,135,16,-244,-228,-11,272,13.777853376,8.0370811362,5.7407722402,0.6803878211,-10.37591427,-9.69552645
2016,Louisiana,Pointe Coupee Parish,22159,-86,287,248,39,9,-117,-108,-17,116,12.926763355,11.17016485,1.7565985046,0.4053688857,-5.269795514,-4.864426628
2016,Louisiana,Rapides Parish,132424,108,1884,1441,443,136,-397,-261,-74,4501,14.232832213,10.886152451,3.3466797613,1.0274231321,-2.999168996,-1.971745864
2016,Louisiana,Red River Parish,8550,-79,110,114,-4,15,-86,-71,-4,164,12.806333314,13.272018162,-0.465684848,1.7463181792,-10.01222423,-8.265906048
2016,Louisiana,Richland Parish,20430,-99,266,241,25,6,-127,-121,-3,1039,12.988598354,11.767865426,1.2207329281,0.2929759027,-6.201323274,-5.908347372
2016,Louisiana,Sabine Parish,23977,-169,280,229,51,0,-230,-230,10,438,11.636847246,9.5172786402,2.1195686054,0.0,-9.558838809,-9.558838809
2016,Louisiana,St. Bernard Parish,45688,304,661,378,283,39,-32,7,14,293,14.515987351,8.3011243851,6.2148629656,0.8564652143,-0.702740689,0.1537245257
2016,Louisiana,St. Charles Parish,52923,221,636,428,208,55,-47,8,5,592,12.04260355,8.1041420118,3.9384615385,1.0414201183,-0.889940828,0.1514792899
2016,Louisiana,St. Helena Parish,10512,-57,119,105,14,6,-70,-64,-7,121,11.289787012,9.9615767753,1.3282102367,0.5692329586,-6.641051184,-6.071818225
2016,Louisiana,St. James Parish,21557,40,286,210,76,2,-44,-42,6,204,13.279472536,9.750661652,3.5288108836,0.0928634443,-2.042995775,-1.95013233
2016,Louisiana,St. John the Baptist Parish,43631,-8,579,421,158,83,-266,-183,17,471,13.269164661,9.6482181735,3.6209464879,1.9021427753,-6.096023834,-4.193881059
2016,Louisiana,St. Landry Parish,83883,93,1271,1026,245,3,-162,-159,7,1105,15.160461136,12.238106314,2.9223548216,0.0357839366,-1.932332576,-1.896548639
2016,Louisiana,St. Martin Parish,54007,86,801,502,299,54,-316,-262,49,701,14.843228819,9.3024979616,5.5407308576,1.0006671114,-5.855755689,-4.855088578
2016,Louisiana,St. Mary Parish,52093,-761,777,547,230,80,-1054,-974,-17,868,14.807474249,10.424309413,4.3831648356,1.5245790732,-20.08632929,-18.56175022
2016,Louisiana,St. Tammany Parish,253602,3634,3012,2285,727,333,2416,2749,158,1277,11.962587128,9.0752030502,2.8873840777,1.3225569434,9.5954882142,10.918045158
2016,Louisiana,Tangipahoa Parish,130710,1954,1909,1283,626,132,1115,1247,81,3656,14.714837397,9.8895423678,4.825295029,1.0174743512,8.5945750118,9.6120493629
2016,Louisiana,Tensas Parish,4597,-129,54,50,4,0,-135,-135,2,16,11.584253995,10.726161107,0.8580928886,0.0,-28.96063499,-28.96063499
2016,Louisiana,Terrebonne Parish,113220,-805,1680,1087,593,122,-1566,-1444,46,1479,14.785803868,9.5667671456,5.2190367225,1.0737309952,-13.78248146,-12.70875047
2016,Louisiana,Union Parish,22487,42,277,233,44,14,1,15,-17,476,12.329742722,10.371227633,1.9585150895,0.6231638921,0.0445117066,0.6676755987
2016,Louisiana,Vermilion Parish,60205,244,841,582,259,61,-58,3,-18,536,13.99730373,9.6866002031,4.3107035268,1.0152622206,-0.965331292,0.0499309289
2016,Louisiana,Vernon Parish,50569,-137,948,369,579,175,-878,-703,-13,2260,18.721303382,7.2870896075,11.434213774,3.4559368057,-17.33892866,-13.88299185
2016,Louisiana,Washington Parish,46310,-12,602,609,-7,-13,27,14,-19,1582,12.997668192,13.148803869,-0.151135677,-0.280680542,0.5829518957,0.3022713533
2016,Louisiana,Webster Parish,39710,-365,489,542,-53,5,-284,-279,-33,1231,12.257943222,13.586513756,-1.328570533,0.1253368428,-7.119132669,-6.993795826
2016,Louisiana,West Baton Rouge Parish,25795,311,365,208,157,12,146,158,-4,556,14.235847033,8.1124826927,6.1233643402,0.4680278477,5.6943388132,6.1623666608
2016,Louisiana,West Carroll Parish,11114,-168,134,153,-19,1,-148,-147,-2,434,11.966422575,13.663154135,-1.696731559,0.089301661,-13.21664583,-13.12734417
2016,Louisiana,West Feliciana Parish,15344,-24,119,119,0,3,-21,-18,-6,5315,7.7494139099,7.7494139099,0.0,0.1953633759,-1.367543631,-1.172180255
2016,Louisiana,Winn Parish,14376,-151,150,194,-44,-1,-97,-98,-9,1760,10.379545376,13.42421202,-3.044666644,-0.069196969,-6.71210601,-6.781302979
2016,Maine,Maine,1331479,2026,12542,13842,-1300,1785,2169,3954,-628,35892,9.4267722738,10.40387353,-0.977101256,1.3416351865,1.6302558652,2.9718910517
2016,Maine,Androscoggin County,107319,74,1215,1052,163,168,-198,-30,-59,2833,11.325292221,9.8059320296,1.5193601909,1.5659663317,-1.845603177,-0.279636845
2016,Maine,Aroostook County,67959,-793,639,841,-202,34,-599,-565,-26,2087,9.3481870515,12.303325994,-2.955138943,0.497399624,-8.763011023,-8.265611399
2016,Maine,Cumberland County,292041,1577,2880,2657,223,902,593,1495,-141,9288,9.8883271388,9.1226684749,0.7656586639,3.0969691247,2.0360340255,5.1330031502
2016,Maine,Franklin County,30001,-38,247,324,-77,35,22,57,-18,1115,8.2278481013,10.792804797,-2.564956696,1.1658894071,0.7328447702,1.8987341772
2016,Maine,Hancock County,54419,151,474,626,-152,82,240,322,-19,867,8.7222942946,11.519316938,-2.797022643,1.50892011,4.4163515416,5.9252716516
2016,Maine,Kennebec County,120569,360,1221,1295,-74,77,440,517,-83,3696,10.142122619,10.756796717,-0.614674098,0.6395933183,3.6548189619,4.2944122802
2016,Maine,Knox County,39744,-35,339,441,-102,56,50,106,-39,1318,8.5258352929,11.091130868,-2.565295575,1.4083975705,1.2574978308,2.6658954013
2016,Maine,Lincoln County,34216,199,277,415,-138,51,313,364,-27,474,8.1192384916,12.164202072,-4.044963581,1.494877845,9.1744463822,10.669324227
2016,Maine,Oxford County,57217,61,483,668,-185,15,232,247,-1,896,8.4460493298,11.681078576,-3.235029246,0.2622996686,4.0569015414,4.3192012101
2016,Maine,Penobscot County,151806,-672,1380,1577,-197,132,-488,-356,-119,7476,9.0704736365,10.365316612,-1.294842976,0.8676105217,-3.207529808,-2.339919286
2016,Maine,Piscataquis County,16843,-83,131,219,-88,3,8,11,-6,253,7.7585951612,12.97047588,-5.211880719,0.1776777518,0.4738073381,0.6514850899
2016,Maine,Sagadahoc County,35273,100,359,401,-42,5,106,111,31,263,10.192203958,11.384606649,-1.192402691,0.1419527014,3.0093972688,3.1513499702
2016,Maine,Somerset County,50915,-141,455,535,-80,26,-69,-43,-18,723,8.9241058732,10.493179433,-1.56907356,0.509948907,-1.353325946,-0.843377039
2016,Maine,Waldo County,39364,235,322,418,-96,70,270,340,-9,528,8.2045532723,10.650631266,-2.446077994,1.7835985374,6.8795943587,8.6631928962
2016,Maine,Washington County,31450,-154,289,409,-120,17,-19,-2,-32,831,9.1667459638,12.973007264,-3.8062613,0.5392203508,-0.602658039,-0.063437688
2016,Maine,York County,202343,1185,1831,1964,-133,112,1268,1380,-62,3244,9.0755661076,9.7347961963,-0.659230089,0.5551411273,6.2849906196,6.8401317469
2016,Maryland,Maryland,6016447,21464,73321,50036,23285,26408,-26232,176,-1997,140535,12.208538034,8.331397677,3.8771403571,4.3971450527,-4.367839633,0.0293054199
2016,Maryland,Allegany County,72130,-401,667,928,-261,90,-179,-89,-51,7600,9.2215593698,12.829995645,-3.608436275,1.2442883707,-2.474751315,-1.230462944
2016,Maryland,Anne Arundel County,568346,4509,6980,4385,2595,1123,1079,2202,-288,14709,12.330162173,7.7460975832,4.5840645903,1.9837782408,1.9060522901,3.8898305309
2016,Maryland,Baltimore County,831026,1817,9945,8589,1356,3415,-2483,932,-471,21434,11.980231714,10.346728023,1.6335036907,4.1138754453,-2.99114282,1.1227326252
2016,Maryland,Calvert County,91251,631,916,702,214,100,304,404,13,640,10.073073772,7.7197574105,2.3533163616,1.0996805428,3.3430288501,4.4427093929
2016,Maryland,Caroline County,32850,259,383,336,47,59,163,222,-10,444,11.705200104,10.268791736,1.4364083678,1.8031509298,4.9815864672,6.784737397
2016,Maryland,Carroll County,167656,5,1658,1557,101,80,-151,-71,-25,3360,9.8894445985,9.2870116043,0.6024329942,0.4771746489,-0.90066715,-0.423492501
2016,Maryland,Cecil County,102603,206,1149,982,167,99,4,103,-64,1447,11.209756098,9.5804878049,1.6292682927,0.9658536585,0.0390243902,1.0048780488
2016,Maryland,Charles County,157705,1782,1850,1063,787,202,796,998,-3,1406,11.797416047,6.7787314908,5.0186845562,1.2881502927,5.076077391,6.3642276838
2016,Maryland,Dorchester County,32258,-133,380,405,-25,33,-120,-87,-21,502,11.755788953,12.529196121,-0.773407168,1.0208974617,-3.712354406,-2.691456944
2016,Maryland,Frederick County,247591,2214,2815,1752,1063,793,448,1241,-90,4312,11.420619594,7.10796644,4.312653154,3.217247367,1.8175621947,5.0348095617
2016,Maryland,Garrett County,29425,-21,285,343,-58,21,24,45,-8,528,9.6821864755,11.652596355,-1.970409879,0.7134242666,0.815342019,1.5287662856
2016,Maryland,Harford County,251032,894,2703,2156,547,359,81,440,-93,2738,10.786758984,8.6038669513,2.1828920326,1.4326476046,0.32324361,1.7558912146
2016,Maryland,Howard County,317233,4522,3583,1766,1817,1599,1277,2876,-171,1697,11.37561434,5.6068475928,5.7687667475,5.0766417332,4.0543286387,9.130970372
2016,Maryland,Kent County,19730,-38,159,276,-117,16,72,88,-9,1498,8.051040559,13.975391159,-5.9243506,0.8101676034,3.6457542154,4.4559218188
2016,Maryland,Montgomery County,1043863,7630,13100,6275,6825,9614,-8240,1374,-569,9290,12.595572512,6.0333753827,6.5621971294,9.2438041321,-7.922711259,1.3210928726
2016,Maryland,Prince George's County,908049,2046,12149,6484,5665,5525,-8677,-3152,-467,20066,13.394323867,7.148637415,6.2456864522,6.0913358603,-9.566429187,-3.475093327
2016,Maryland,Queen Anne's County,48929,40,455,389,66,30,-57,-27,1,436,9.3029912695,7.9535463821,1.3494448874,0.6133840397,-1.165429676,-0.552045636
2016,Maryland,St. Mary's County,112587,959,1479,822,657,215,114,329,-27,2809,13.192694512,7.3322480655,5.8604464465,1.9178021096,1.0168811186,2.9346832282
2016,Maryland,Somerset County,25928,182,244,269,-25,41,170,211,-4,5339,9.443820877,10.411425475,-0.967604598,1.5868715408,6.5797112668,8.1665828076
2016,Maryland,Talbot County,37278,-245,324,469,-145,38,-150,-112,12,372,8.662985789,12.539939306,-3.876953517,1.0160291975,-4.010641569,-2.994612371
2016,Maryland,Washington County,150292,722,1741,1538,203,281,224,505,14,8235,11.61200819,10.258052037,1.3539561532,1.8741954632,1.4940205828,3.368216046
2016,Maryland,Wicomico County,102577,558,1237,1007,230,441,-156,285,43,4860,12.092123013,9.8437897124,2.2483333007,4.3109347201,-1.5249565,2.7859782205
2016,Maryland,Worcester County,51444,64,465,672,-207,39,233,272,-1,722,9.0445810317,13.070878394,-4.026297362,0.7585777639,4.5320158718,5.2905936357
2016,Maryland,Baltimore city,614664,-6738,8654,6871,1783,2195,-11008,-8813,292,26091,14.00248854,11.117529323,2.8849592174,3.5515902873,-17.81134664,-14.25975636
2016,Massachusetts,Massachusetts,6811779,27539,72024,57563,14461,40898,-25606,15292,-2214,252586,10.594866041,8.4676257072,2.1272403341,6.0161728224,-3.766690823,2.2494819991
2016,Massachusetts,Barnstable County,214276,-345,1506,2908,-1402,391,745,1136,-79,4148,7.0226651154,13.560365309,-6.537700194,1.8232815804,3.4740275637,5.2973091442
2016,Massachusetts,Berkshire County,126903,-768,1046,1467,-421,258,-488,-230,-117,5898,8.2176498778,11.52513611,-3.307486232,2.026915553,-3.833855775,-1.806940222
2016,Massachusetts,Bristol County,558324,1357,5625,5198,427,1295,-139,1156,-226,16363,10.087053513,9.3213340733,0.76571944,2.3222638755,-0.2492623,2.0730015754
2016,Massachusetts,Dukes County,17246,29,152,138,14,0,8,8,7,105,8.8210544642,8.0085889215,0.8124655428,0.0,0.4642660244,0.4642660244
2016,Massachusetts,Essex County,779018,2907,8518,6834,1684,4501,-2947,1554,-331,19783,10.954718226,8.7889814929,2.1657367331,5.7885873133,-3.790039283,1.9985480304
2016,Massachusetts,Franklin County,70382,-168,589,684,-95,177,-215,-38,-35,1587,8.3586410467,9.7068089575,-1.348167911,2.5118496864,-3.051116851,-0.539267164
2016,Massachusetts,Hampden County,468467,-611,5204,4426,778,3048,-4356,-1308,-81,15830,11.101333803,9.4416801327,1.65965367,6.5020878998,-9.292353967,-2.790266067
2016,Massachusetts,Hampshire County,161816,767,1056,1239,-183,838,109,947,3,22591,6.5414337262,7.6750344571,-1.133600731,5.1910241122,0.675204807,5.8662289192
2016,Massachusetts,Middlesex County,1589774,8737,17592,11727,5865,12192,-8845,3347,-475,56732,11.096214817,7.3968457912,3.6993690258,7.6901461487,-5.579014328,2.1111318208
2016,Massachusetts,Nantucket County,11008,150,143,53,90,63,-1,62,-2,59,13.079667063,4.8477087716,8.2319582914,5.762370804,-0.091466203,5.6709046008
2016,Massachusetts,Norfolk County,697181,2286,7278,5946,1332,3437,-1988,1449,-495,17614,10.45632566,8.5426370399,1.9136886204,4.9379487902,-2.856165899,2.0817828912
2016,Massachusetts,Plymouth County,513565,3685,5216,4603,613,1464,1600,3064,8,12169,10.19302454,8.9951096542,1.1979148855,2.8609255993,3.1266946441,5.9876202434
2016,Massachusetts,Suffolk County,784230,7542,9470,5152,4318,9498,-6314,3184,40,50631,12.133885316,6.6012436271,5.5326416891,12.16976164,-8.090111076,4.0796505646
2016,Massachusetts,Worcester County,819589,1971,8629,7188,1441,3736,-2775,961,-431,29076,10.541122778,8.7808078026,1.7603149754,4.5638700543,-3.38991954,1.1739505145
2016,Michigan,Michigan,9928300,10585,113437,94353,19084,22511,-27839,-5328,-3171,230466,11.431715637,9.5085083832,1.9232072534,2.2685662588,-2.805500248,-0.536933989
2016,Michigan,Alcona County,10352,19,53,167,-114,4,122,126,7,127,5.1244863428,16.146966401,-11.02248006,0.3867536862,11.795987431,12.182741117
2016,Michigan,Alger County,9219,-128,59,123,-64,3,-70,-67,3,1054,6.355703975,13.250026931,-6.894322956,0.3231713886,-7.540665733,-7.217494345
2016,Michigan,Allegan County,115548,887,1394,926,468,55,407,462,-43,955,12.110734159,8.0448635805,4.0658705785,0.4778266705,3.535917362,4.0137440326
2016,Michigan,Alpena County,28704,-87,274,340,-66,2,-16,-14,-7,512,9.5312635881,11.827115401,-2.295851813,0.0695712671,-0.556570137,-0.486998869
2016,Michigan,Antrim County,23144,11,201,267,-66,0,84,84,-7,226,8.6868206669,11.539209543,-2.852388876,0.0,3.6303131145,3.6303131145
2016,Michigan,Arenac County,15122,-158,130,206,-76,0,-66,-66,-16,207,8.5520689428,13.551740017,-4.999671074,0.0,-4.341819617,-4.341819617
2016,Michigan,Baraga County,8503,-43,76,103,-27,4,-15,-11,-5,1010,8.9154789137,12.082820107,-3.167341193,0.4692357323,-1.759633996,-1.290398264
2016,Michigan,Barry County,59702,309,638,558,80,12,236,248,-19,613,10.714135774,9.3706704732,1.3434653008,0.2015197951,3.9632226374,4.1647424325
2016,Michigan,Bay County,104747,-810,1011,1168,-157,49,-629,-580,-73,1438,9.6146530736,11.107729763,-1.493076689,0.4659920876,-5.981816799,-5.515824711
2016,Michigan,Benzie County,17572,136,155,212,-57,-1,198,197,-4,252,8.85511883,12.111517367,-3.256398537,-0.057129799,11.311700183,11.254570384
2016,Michigan,Berrien County,154010,-619,1786,1662,124,431,-1077,-646,-97,3535,11.573391567,10.769863821,0.803527746,2.7929069236,-6.979027278,-4.186120354
2016,Michigan,Branch County,43427,-180,516,408,108,54,-325,-271,-17,1974,11.857435025,9.3756462991,2.4817887262,1.2408943631,-7.468345704,-6.227451341
2016,Michigan,Calhoun County,134386,-61,1638,1405,233,281,-510,-229,-65,4129,12.18600395,10.452585806,1.7334181443,2.0905171612,-3.794177054,-1.703659893
2016,Michigan,Cass County,51599,-66,511,542,-31,3,-21,-18,-17,611,9.8969631236,10.497365975,-0.600402851,0.0581035017,-0.406724512,-0.34862101
2016,Michigan,Charlevoix County,26174,-41,231,284,-53,48,-26,22,-10,279,8.8186451354,10.841970643,-2.023325507,1.8324457424,-0.992574777,0.8398709653
2016,Michigan,Cheboygan County,25401,-14,209,358,-149,3,157,160,-25,388,8.2257556675,14.090050378,-5.86429471,0.1180730479,6.1791561713,6.2972292191
2016,Michigan,Chippewa County,37724,-279,362,360,2,57,-340,-283,2,4802,9.5606586818,9.5078373632,0.0528213187,1.5054075825,-8.979624176,-7.474216594
2016,Michigan,Clare County,30358,-252,336,388,-52,2,-212,-210,10,391,11.022175568,12.727988453,-1.705812885,0.0656081879,-6.954467918,-6.88885973
2016,Michigan,Clinton County,77888,505,749,580,169,112,285,397,-61,655,9.6476483052,7.4708091015,2.1768392037,1.4426389989,3.671001024,5.1136400229
2016,Michigan,Crawford County,13744,-65,125,166,-41,5,-20,-15,-9,197,9.0734221319,12.049504591,-2.976082459,0.3629368853,-1.451747541,-1.088810656
2016,Michigan,Delta County,36202,-205,380,426,-46,6,-144,-138,-21,623,10.467021995,11.734082552,-1.267060557,0.1652687683,-3.96645044,-3.801181672
2016,Michigan,Dickinson County,25535,-205,231,306,-75,-3,-116,-119,-11,453,9.0102389078,11.935641151,-2.925402243,-0.11701609,-4.524622136,-4.641638225
2016,Michigan,Eaton County,109160,484,1157,983,174,161,211,372,-62,1633,10.622670266,9.0251381773,1.5975320884,1.4781762427,1.9372371876,3.4154134303
2016,Michigan,Emmet County,33182,50,310,316,-6,20,21,41,15,505,9.3494586362,9.5304159001,-0.180957264,0.6031908798,0.6333504237,1.2365413035
2016,Michigan,Genesee County,408615,-1827,4831,4510,321,218,-2115,-1897,-251,5821,11.796492796,11.012664564,0.7838282317,0.5323194845,-5.164475732,-4.632156248
2016,Michigan,Gladwin County,25122,-88,262,374,-112,10,17,27,-3,289,10.410871811,14.86132083,-4.450449019,0.3973615195,0.6755145832,1.0728761027
2016,Michigan,Gogebic County,15243,-200,118,213,-95,9,-116,-107,2,1469,7.6908036238,13.882552304,-6.19174868,0.5865867171,-7.56045102,-6.973864303
2016,Michigan,Grand Traverse County,92084,460,944,833,111,27,327,354,-5,2419,10.277179001,9.0687395214,1.20843948,0.2939447384,3.5599973872,3.8539421255
2016,Michigan,Gratiot County,41202,-311,401,437,-36,7,-284,-277,2,5253,9.6959439038,10.566402708,-0.870458804,0.1692558786,-6.86695279,-6.697696911
2016,Michigan,Hillsdale County,45774,-166,518,463,55,2,-213,-211,-10,1654,11.295985346,10.096604662,1.1993806834,0.043613843,-4.644874283,-4.60126044
2016,Michigan,Houghton County,36555,173,364,346,18,199,-28,171,-16,3114,9.9812166664,9.4876400181,0.4935766483,5.4567640567,-0.767785897,4.6889781592
2016,Michigan,Huron County,31481,-341,289,465,-176,13,-153,-140,-25,524,9.1306889089,14.69124686,-5.560557951,0.4107230305,-4.833894128,-4.423171098
2016,Michigan,Ingham County,288051,2316,3381,2184,1197,1971,-702,1269,-150,18479,11.784881471,7.6125942425,4.172287229,6.8701571666,-2.446905292,4.4232518744
2016,Michigan,Ionia County,64232,59,725,522,203,18,-149,-131,-13,5371,11.292395156,8.1305245123,3.1618706437,0.2803629142,-2.320781901,-2.040418987
2016,Michigan,Iosco County,25327,-25,240,392,-152,12,132,144,-17,400,9.4713786776,15.469918507,-5.998539829,0.4735689339,5.2092582727,5.6828272065
2016,Michigan,Iron County,11195,-147,89,190,-101,3,-48,-45,-1,355,7.8981230865,16.861161645,-8.963038559,0.2662288681,-4.259661889,-3.993433021
2016,Michigan,Isabella County,71282,592,687,457,230,236,160,396,-34,6572,9.6779646691,6.4378891612,3.2400755078,3.3245992167,2.2539655707,5.5785647874
2016,Michigan,Jackson County,158460,-1005,1808,1624,184,89,-1200,-1111,-78,8834,11.373751671,10.21624597,1.157505701,0.559880475,-7.548950224,-6.989069749
2016,Michigan,Kalamazoo County,261654,1688,3175,2175,1000,609,78,687,1,8282,12.173612975,8.339404164,3.834208811,2.3350331659,0.2990682873,2.6341014532
2016,Michigan,Kalkaska County,17263,1,173,171,2,11,-45,-34,33,138,10.021723389,9.905865315,0.1158580739,0.6372194062,-2.606806662,-1.969587256
2016,Michigan,Kent County,642173,6078,8986,4695,4291,1502,596,2098,-311,11599,14.059649463,7.3458773903,6.7137720728,2.3500549181,0.932511805,3.2825667231
2016,Michigan,Keweenaw County,2199,23,18,16,2,1,17,18,3,10,8.2285714286,7.3142857143,0.9142857143,0.4571428571,7.7714285714,8.2285714286
2016,Michigan,Lake County,11496,103,98,146,-48,0,126,126,25,397,8.5630652278,12.757219625,-4.194154397,0.0,11.009655293,11.009655293
2016,Michigan,Lapeer County,88340,-104,826,867,-41,65,-84,-19,-44,1699,9.3447370803,9.808579962,-0.463842882,0.7353606661,-0.950312245,-0.214951579
2016,Michigan,Leelanau County,21765,-153,168,231,-63,22,-96,-74,-16,284,7.6917794108,10.57619669,-2.884417279,1.0072568276,-4.39530252,-3.388045693
2016,Michigan,Lenawee County,98504,115,1037,985,52,36,103,139,-76,5490,10.533640099,10.005434424,0.5282056752,0.365680852,1.0462535489,1.4119344009
2016,Michigan,Livingston County,188624,1274,1798,1502,296,64,873,937,41,1385,9.5644911616,7.9899141962,1.5745769654,0.3404490736,4.6439381447,4.9843872183
2016,Michigan,Luce County,6358,-80,53,85,-32,4,-56,-52,4,1161,8.2838386996,13.285401688,-5.001562988,0.6251953736,-8.75273523,-8.127539856
2016,Michigan,Mackinac County,10820,-77,81,133,-52,12,-34,-22,-3,95,7.4595938666,12.248468941,-4.788875075,1.1051250173,-3.131187549,-2.026062532
2016,Michigan,Macomb County,867730,3223,9377,8438,939,2843,-50,2793,-509,7518,10.826463123,9.7423158609,1.0841472616,3.2824607718,-0.057728821,3.2247319507
2016,Michigan,Manistee County,24373,-85,191,305,-114,7,44,51,-22,1423,7.8228993877,12.492064467,-4.66916508,0.2867031189,1.8021338904,2.0888370093
2016,Michigan,Marquette County,66435,-870,617,664,-47,38,-821,-783,-40,3891,9.2268580828,9.9297143712,-0.702856288,0.5682667863,-12.27755346,-11.70928668
2016,Michigan,Mason County,28876,64,303,296,7,16,64,80,-23,442,10.504784357,10.26209957,0.2426847871,0.5547080849,2.2188323395,2.7735404244
2016,Michigan,Mecosta County,43221,129,417,355,62,71,-14,57,10,3338,9.6625073859,8.2258755923,1.4366317936,1.6451751185,-0.324400728,1.3207743909
2016,Michigan,Menominee County,23281,-233,222,239,-17,9,-214,-205,-11,382,9.488193183,10.214766535,-0.726573352,0.3846564804,-9.146276312,-8.761619831
2016,Michigan,Midland County,83462,-156,883,734,149,165,-436,-271,-34,1272,10.569786928,8.7862101987,1.7835767297,1.9751017477,-5.219056739,-3.243954992
2016,Michigan,Missaukee County,15102,175,183,163,20,9,139,148,7,194,12.188218056,10.856172367,1.3320456892,0.5994205601,9.2577175397,9.8571380998
2016,Michigan,Monroe County,149208,-286,1456,1420,36,87,-338,-251,-71,1463,9.7488466766,9.5078037643,0.2410429123,0.5825203715,-2.263125121,-1.68060475
2016,Michigan,Montcalm County,62974,148,688,592,96,16,72,88,-36,2830,10.93799682,9.4117647059,1.5262321145,0.2543720191,1.1446740859,1.3990461049
2016,Michigan,Montmorency County,9173,-92,63,163,-100,0,5,5,3,156,6.8337129841,17.680876451,-10.84716347,0.0,0.5423581733,0.5423581733
2016,Michigan,Muskegon County,173408,711,2059,1734,325,94,355,449,-63,6372,11.898123402,10.020080611,1.8780427905,0.5431877609,2.0514005865,2.5945883475
2016,Michigan,Newaygo County,47938,-46,551,523,28,17,-53,-36,-38,557,11.488501074,10.904693397,0.5838076771,0.3544546611,-1.105064532,-0.750609871
2016,Michigan,Oakland County,1243970,3669,13486,10789,2697,5229,-3469,1760,-788,13315,10.857108584,8.6858478805,2.1712607038,4.2096856583,-2.792770998,1.4169146603
2016,Michigan,Oceana County,26027,-91,298,250,48,13,-176,-163,24,303,11.429667274,9.5886470419,1.841020232,0.4986096462,-6.750407517,-6.251797871
2016,Michigan,Ogemaw County,20904,-46,186,280,-94,15,29,44,4,244,8.888039375,13.37984422,-4.491804845,0.7167773689,1.38576958,2.1025469489
2016,Michigan,Ontonagon County,5911,-97,27,109,-82,1,-11,-10,-5,83,4.5305814246,18.29012501,-13.75954359,0.167799312,-1.845792432,-1.67799312
2016,Michigan,Osceola County,23110,44,250,231,19,6,35,41,-16,455,10.828135828,10.005197505,0.8229383229,0.2598752599,1.5159390159,1.7758142758
2016,Michigan,Oscoda County,8264,-14,93,109,-16,1,1,2,0,65,11.244105912,13.178575747,-1.934469834,0.1209043646,0.1209043646,0.2418087293
2016,Michigan,Otsego County,24470,226,262,286,-24,15,254,269,-19,345,10.756661329,11.742004352,-0.985343023,0.6158393891,10.428213655,11.044053044
2016,Michigan,Ottawa County,282250,2227,3415,1842,1573,438,225,663,-9,8734,12.147124262,6.5519774202,5.5951468415,1.5579620576,0.8003229748,2.3582850324
2016,Michigan,Presque Isle County,12762,-87,98,183,-85,1,7,8,-10,230,7.6529616181,14.29073445,-6.637772832,0.0780914451,0.5466401156,0.6247315607
2016,Michigan,Roscommon County,23700,-103,166,366,-200,22,70,92,5,277,6.9890322716,15.409553081,-8.420520809,0.926257289,2.9471822832,3.8734395722
2016,Michigan,Saginaw County,192326,-964,2208,2122,86,216,-1164,-948,-102,7077,11.451806979,11.005767396,0.4460395834,1.1202854653,-6.037093897,-4.916808431
2016,Michigan,St. Clair County,159587,-287,1569,1705,-136,125,-165,-40,-111,2000,9.8227952708,10.674229405,-0.851434134,0.7825681382,-1.032989942,-0.250421804
2016,Michigan,St. Joseph County,60853,10,795,577,218,46,-227,-181,-27,765,13.06534315,9.48264528,3.5826978701,0.7559821194,-3.730607415,-2.974625296
2016,Michigan,Sanilac County,41409,-67,427,489,-62,10,17,27,-32,564,10.303432467,11.799481209,-1.496048742,0.2412981842,0.4102069132,0.6515050974
2016,Michigan,Schoolcraft County,8001,-156,62,105,-43,1,-106,-105,-8,140,7.6742171061,12.996658002,-5.322440896,0.1237776953,-13.1204357,-12.996658
2016,Michigan,Shiawassee County,68554,37,708,706,2,12,55,67,-32,821,10.330412706,10.301230749,0.0291819568,0.1750917408,0.8025038119,0.9775955527
2016,Michigan,Tuscola County,53338,-466,569,643,-74,16,-366,-350,-42,1079,10.621418305,12.002762689,-1.381344384,0.298669056,-6.832054656,-6.5333856
2016,Michigan,Van Buren County,75223,159,877,788,89,44,77,121,-51,877,11.671002815,10.486602301,1.1844005137,0.5855463214,1.0247060624,1.6102523838
2016,Michigan,Washtenaw County,364709,3862,3709,2323,1386,2195,309,2504,-28,22313,10.223883477,6.4033651434,3.8205183335,6.0505322815,0.8517605809,6.9022928623
2016,Michigan,Wayne County,1749366,-7696,23209,18231,4978,4279,-17346,-13067,393,22889,13.237973231,10.398616484,2.8393567471,2.44066041,-9.893829276,-7.453168866
2016,Michigan,Wexford County,33163,197,411,323,88,6,119,125,-16,389,12.430249966,9.7687852531,2.6614647129,0.1814635032,3.5990261459,3.780489649
2016,Minnesota,Minnesota,5519952,37517,69190,41938,27252,13644,-1762,11882,-1617,132543,12.577270732,7.6234366233,4.9538341089,2.4801890717,-0.320294133,2.1598949392
2016,Minnesota,Aitkin County,15583,-86,106,198,-92,6,0,6,0,274,6.7835658518,12.671189044,-5.887623192,0.3839754256,0.0,0.3839754256
2016,Minnesota,Anoka County,345957,2135,4181,1958,2223,495,-426,69,-157,2981,12.122723365,5.6771806622,6.4455427028,1.4352423022,-1.235178224,0.2000640785
2016,Minnesota,Becker County,33734,242,402,380,22,46,178,224,-4,458,11.959658465,11.305149793,0.6545086722,1.3685181329,5.2955701663,6.6640882992
2016,Minnesota,Beltrami County,46106,432,658,426,232,48,137,185,15,2064,14.338635868,9.2830682066,5.0555676618,1.0459795162,2.9853998693,4.0313793855
2016,Minnesota,Benton County,39992,269,565,322,243,12,-24,-12,38,1049,14.17550022,8.0787806561,6.0967195634,0.301072571,-0.602145142,-0.301072571
2016,Minnesota,Big Stone County,5050,12,48,70,-22,2,34,36,-2,137,9.5162569389,13.877874703,-4.361617764,0.3965107058,6.7406819984,7.1371927042
2016,Minnesota,Blue Earth County,66441,664,700,454,246,120,285,405,13,4165,10.588573417,6.8674461874,3.7211272293,1.8151840143,4.3110620339,6.1262460482
2016,Minnesota,Brown County,25331,14,281,272,9,4,11,15,-10,1112,11.096193334,10.740799242,0.3553940926,0.15795293,0.4343705576,0.5923234876
2016,Minnesota,Carlton County,35738,202,366,368,-2,6,206,212,-8,2007,10.270224766,10.326346213,-0.056121447,0.1683643404,5.7805090215,5.948873362
2016,Minnesota,Carver County,100262,1652,1198,513,685,77,916,993,-26,889,12.04795044,5.1590973088,6.8888531317,0.7743674323,9.2119554286,9.9863228609
2016,Minnesota,Cass County,28993,325,346,304,42,7,286,293,-10,223,12.001179307,10.544388755,1.4567905517,0.2427984253,9.9200499471,10.162848372
2016,Minnesota,Chippewa County,12133,-1,188,131,57,25,-84,-59,1,237,15.494292661,10.796554992,4.6977376684,2.0604112581,-6.922981827,-4.862570569
2016,Minnesota,Chisago County,54748,440,563,387,176,10,271,281,-17,1681,10.324970657,7.0972711268,3.2276995305,0.1833920188,4.9699237089,5.1533157277
2016,Minnesota,Clay County,62875,757,864,456,408,79,298,377,-28,3152,13.824774187,7.2964085989,6.5283655885,1.264070788,4.768267023,6.0323378109
2016,Minnesota,Clearwater County,8827,52,111,84,27,3,29,32,-7,115,12.612203159,9.544369958,3.0678332008,0.3408703556,3.2950801045,3.6359504602
2016,Minnesota,Cook County,5286,78,49,36,13,14,54,68,-3,51,9.338669716,6.8610634648,2.4776062512,2.6681913474,10.291595197,12.959786545
2016,Minnesota,Cottonwood County,11470,-34,164,144,20,1,-53,-52,-2,244,14.277008793,12.535910159,1.7410986332,0.0870549317,-4.613911378,-4.526856446
2016,Minnesota,Crow Wing County,63940,489,716,653,63,42,395,437,-11,741,11.240982487,10.251901626,0.9890808613,0.6593872409,6.2013800033,6.8607672442
2016,Minnesota,Dakota County,417486,3187,5226,2509,2717,658,-133,525,-55,2832,12.565747158,6.032808959,6.5329381992,1.5821396154,-0.319794178,1.2623454378
2016,Minnesota,Dodge County,20506,125,250,143,107,22,6,28,-10,149,12.228825788,6.9948883508,5.2339374373,1.0761366694,0.2934918189,1.3696284883
2016,Minnesota,Douglas County,37456,399,426,430,-4,17,406,423,-20,522,11.434246373,11.541610189,-0.107363816,0.4562962168,10.897427295,11.353723511
2016,Minnesota,Faribault County,13935,-122,154,165,-11,0,-119,-119,8,336,11.003143755,11.789082595,-0.78593884,0.0,-8.502429266,-8.502429266
2016,Minnesota,Fillmore County,21003,171,256,237,19,13,137,150,2,359,12.238556233,11.330225887,0.9083303454,0.6214891837,6.549539859,7.1710290427
2016,Minnesota,Freeborn County,30446,-124,327,357,-30,16,-79,-63,-31,637,10.718500066,11.701848695,-0.98334863,0.5244526026,-2.589484725,-2.065032123
2016,Minnesota,Goodhue County,46676,238,504,468,36,14,189,203,-1,901,10.825439783,10.052194085,0.7732456988,0.3007066607,4.0595399188,4.3602465795
2016,Minnesota,Grant County,5956,78,70,57,13,0,72,72,-7,110,11.830319419,9.633260098,2.1970593206,0.0,12.168328545,12.168328545
2016,Minnesota,Hennepin County,1232483,12024,16737,8563,8174,5524,-985,4539,-689,25724,13.646470239,6.981820198,6.6646500406,4.5039793032,-0.803117236,3.7008620669
2016,Minnesota,Houston County,18814,44,205,194,11,6,29,35,-2,257,10.908897403,10.323541933,0.5853554704,0.319284802,1.5432098765,1.8624946786
2016,Minnesota,Hubbard County,20718,47,221,178,43,10,-15,-5,9,154,10.679165962,8.6013191911,2.0778467709,0.4832201793,-0.724830269,-0.24161009
2016,Minnesota,Isanti County,39025,572,430,284,146,23,377,400,26,465,11.09992514,7.3311133483,3.7688117917,0.5937169261,9.7317948321,10.325511758
2016,Minnesota,Itasca County,45242,-155,472,510,-38,7,-122,-115,-2,1020,10.414942795,11.253433952,-0.838491157,0.1544588974,-2.691997926,-2.537539028
2016,Minnesota,Jackson County,9944,-140,109,106,3,0,-138,-138,-5,110,10.884761334,10.585180747,0.2995805872,0.0,-13.78070701,-13.78070701
2016,Minnesota,Kanabec County,15830,10,148,159,-11,4,10,14,7,246,9.3522906793,10.047393365,-0.695102686,0.252764613,0.6319115324,0.8846761453
2016,Minnesota,Kandiyohi County,42495,-64,586,353,233,147,-430,-283,-14,1057,13.779481271,8.3006090249,5.4788722459,3.4566275543,-10.11122346,-6.654595904
2016,Minnesota,Kittson County,4333,-72,46,58,-12,0,-58,-58,-2,111,10.528725109,13.27534905,-2.746623941,0.0,-13.27534905,-13.27534905
2016,Minnesota,Koochiching County,12628,-201,97,147,-50,11,-160,-149,-2,241,7.6206937188,11.548886357,-3.928192639,0.8642023805,-12.57021644,-11.70601406
2016,Minnesota,Lac qui Parle County,6715,-137,55,92,-37,4,-98,-94,-6,154,8.1079088966,13.562320336,-5.45441144,0.5896661016,-14.44681949,-13.85715339
2016,Minnesota,Lake County,10625,-11,92,136,-44,5,12,17,16,224,8.6543436339,12.793377546,-4.139033912,0.4703447627,1.1288274305,1.5991721932
2016,Minnesota,Lake of the Woods County,3814,-92,35,46,-11,4,-97,-93,12,53,9.067357513,11.917098446,-2.849740933,1.0362694301,-25.12953368,-24.09326425
2016,Minnesota,Le Sueur County,27591,-39,303,224,79,7,-121,-114,-4,270,10.974085946,8.1128556165,2.861230329,0.253526738,-4.382390757,-4.128864019
2016,Minnesota,Lincoln County,5783,16,70,81,-11,0,15,15,12,135,12.121212121,14.025974026,-1.904761905,0.0,2.5974025974,2.5974025974
2016,Minnesota,Lyon County,25699,28,356,240,116,58,-147,-89,1,1050,13.860229706,9.3439750827,4.5162546233,2.2581273117,-5.723184738,-3.465057427
2016,Minnesota,McLeod County,35842,-77,422,333,89,20,-160,-140,-26,476,11.761263082,9.2808071236,2.480455958,0.5574058333,-4.459246666,-3.901840833
2016,Minnesota,Mahnomen County,5465,35,95,59,36,0,-5,-5,4,79,17.43919229,10.830656264,6.6085360257,0.0,-0.917852226,-0.917852226
2016,Minnesota,Marshall County,9324,-64,105,85,20,1,-96,-95,11,76,11.222744763,9.0850790936,2.1376656691,0.1068832835,-10.26079521,-10.15391193
2016,Minnesota,Martin County,19829,-181,219,237,-18,1,-170,-169,6,348,10.994251864,11.897889003,-0.903637139,0.0502020633,-8.534350762,-8.484148699
2016,Minnesota,Meeker County,23110,35,264,202,62,21,-38,-17,-10,354,11.432283209,8.7474288189,2.68485439,0.9093861643,-1.645555916,-0.736169752
2016,Minnesota,Mille Lacs County,25866,123,311,267,44,3,93,96,-17,523,12.052161445,10.347032494,1.7051289504,0.1162587921,3.6040225542,3.7202813463
2016,Minnesota,Morrison County,32821,96,367,342,25,4,77,81,-10,527,11.198242456,10.4354194,0.7628230556,0.1220516889,2.3494950111,2.4715467
2016,Minnesota,Mower County,39163,-52,500,365,135,98,-307,-209,22,632,12.758682283,9.3138380668,3.4448442165,2.5007017275,-7.833830922,-5.333129194
2016,Minnesota,Murray County,8329,-83,78,95,-17,12,-71,-59,-7,163,9.3184397587,11.349381757,-2.030941999,1.4336061167,-8.482169524,-7.048563407
2016,Minnesota,Nicollet County,33575,174,402,243,159,35,-23,12,3,2858,12.004300048,7.2563306259,4.7479694219,1.0451505017,-0.686813187,0.3583373149
2016,Minnesota,Nobles County,21848,131,357,163,194,186,-233,-47,-16,385,16.38930334,7.4830712728,8.906232067,8.5389647653,-10.69666016,-2.157695398
2016,Minnesota,Norman County,6579,-93,70,92,-22,3,-71,-68,-3,149,10.565240359,13.885744472,-3.320504113,0.4527960154,-10.71617236,-10.26337635
2016,Minnesota,Olmsted County,153102,1851,2184,1006,1178,551,133,684,-11,2513,14.35175602,6.6107447602,7.74101126,3.6207955893,0.8739851423,4.4947807316
2016,Minnesota,Otter Tail County,58085,311,670,687,-17,65,320,385,-57,1184,11.565782546,11.8592427,-0.293460154,1.1220535306,5.5239558429,6.6460093735
2016,Minnesota,Pennington County,14235,-18,188,127,61,23,-91,-68,-11,327,13.198539736,8.9160348217,4.2825049143,1.6147149677,-6.388654872,-4.773939905
2016,Minnesota,Pine County,28874,-172,264,282,-18,3,-144,-141,-13,1656,9.1160220994,9.7375690608,-0.621546961,0.1035911602,-4.972375691,-4.86878453
2016,Minnesota,Pipestone County,9202,-60,113,117,-4,6,-54,-48,-8,205,12.240034662,12.673310225,-0.433275563,0.6499133449,-5.849220104,-5.199306759
2016,Minnesota,Polk County,31660,180,406,348,58,36,99,135,-13,1272,12.860310421,11.023123218,1.837187203,1.1403230915,3.1358885017,4.2762115933
2016,Minnesota,Pope County,11049,20,121,123,-2,1,11,12,10,184,10.961137784,11.142313615,-0.181175831,0.0905879156,0.9964670713,1.0870549869
2016,Minnesota,Ramsey County,540649,4578,7874,4137,3737,3292,-2116,1176,-335,17865,14.625900884,7.6844490675,6.9414518166,6.114867375,-3.930455457,2.1844119177
2016,Minnesota,Red Lake County,4007,-42,47,23,24,1,-73,-72,6,34,11.668321748,5.7100297915,5.9582919563,0.2482621648,-18.12313803,-17.87487587
2016,Minnesota,Redwood County,15263,-221,187,171,16,9,-270,-261,24,373,12.163788337,11.123036394,1.0407519433,0.5854229681,-17.56268904,-16.97726607
2016,Minnesota,Renville County,14660,-201,160,185,-25,9,-177,-168,-8,342,10.839741201,12.533450764,-1.693709563,0.6097354426,-11.9914637,-11.38172826
2016,Minnesota,Rice County,65622,344,682,454,228,119,-20,99,17,7273,10.420168067,6.9365928189,3.4835752483,1.8181818182,-0.305576776,1.512605042
2016,Minnesota,Rock County,9564,-44,110,105,5,0,-41,-41,-8,260,11.475067807,10.953473816,0.5215939912,0.0,-4.277070728,-4.277070728
2016,Minnesota,Roseau County,15626,-53,178,134,44,12,-106,-94,-3,191,11.371985306,8.5609327583,2.8110525475,0.7666506948,-6.772081137,-6.005430442
2016,Minnesota,St. Louis County,199980,-242,2000,2082,-82,148,-187,-39,-121,9005,9.994952549,10.404745603,-0.409793055,0.7396264886,-0.934528063,-0.194901575
2016,Minnesota,Scott County,143680,2067,1834,647,1187,305,535,840,40,1307,12.856957584,4.5356878718,8.3212697122,2.1381527062,3.7505301567,5.8886828629
2016,Minnesota,Sherburne County,93528,1905,1165,523,642,78,1169,1247,16,2194,12.584323066,5.6494428872,6.9348801789,0.8425555358,12.627531042,13.470086578
2016,Minnesota,Sibley County,14827,-50,147,134,13,13,-76,-63,0,230,9.8976568812,9.0223538917,0.8753029895,0.8753029895,-5.117155939,-4.241852949
2016,Minnesota,Stearns County,155652,695,1949,975,974,394,-626,-232,-47,7570,12.549539775,6.2779893693,6.2715504058,2.5369516015,-4.030791123,-1.493839522
2016,Minnesota,Steele County,36805,122,476,301,175,17,-66,-49,-4,594,12.954495972,8.1918136294,4.7626823427,0.4626605704,-1.796211626,-1.333551056
2016,Minnesota,Stevens County,9693,-98,119,74,45,15,-153,-138,-5,1019,12.215150893,7.5959761856,4.6191747075,1.5397249025,-15.70519401,-14.1654691
2016,Minnesota,Swift County,9419,65,109,101,8,7,42,49,8,150,11.612422096,10.760134235,0.8522878602,0.7457518777,4.4745112662,5.2202631439
2016,Minnesota,Todd County,24233,13,297,203,94,8,-98,-90,9,346,12.25930283,8.3792541226,3.880048707,0.3302169112,-4.045157163,-3.714940251
2016,Minnesota,Traverse County,3356,-42,31,34,-3,0,-37,-37,-2,100,9.1797453361,10.068107788,-0.888362452,0.0,-10.95647024,-10.95647024
2016,Minnesota,Wabasha County,21273,30,223,185,38,14,-12,2,-10,246,10.490168407,8.7026060777,1.7875623295,0.6585755951,-0.564493367,0.0940822279
2016,Minnesota,Wadena County,13761,-77,194,184,10,2,-77,-75,-12,482,14.05848038,13.333816443,0.7246639371,0.1449327874,-5.579912316,-5.434979528
2016,Minnesota,Waseca County,18911,-90,219,147,72,9,-163,-154,-8,1081,11.553070268,7.7548005908,3.7982696771,0.4747837096,-8.598860519,-8.124076809
2016,Minnesota,Washington County,253117,2014,2816,1571,1245,384,367,751,18,3299,11.1697275,6.2314069255,4.9383205744,1.5231446591,1.4557137757,2.9788584348
2016,Minnesota,Watonwan County,10908,-42,164,115,49,17,-104,-87,-4,150,15.005947479,10.522463171,4.4834843078,1.5554945558,-9.515966694,-7.960472138
2016,Minnesota,Wilkin County,6358,-34,65,86,-21,0,-13,-13,0,152,10.196078431,13.490196078,-3.294117647,0.0,-2.039215686,-2.039215686
2016,Minnesota,Winona County,50948,9,467,445,22,93,-77,16,-29,4277,9.1670183635,8.7351673913,0.4318509722,1.8255518368,-1.511478403,0.3140734343
2016,Minnesota,Wright County,132550,1295,1744,742,1002,81,247,328,-35,1105,13.221887379,5.625367222,7.5965201569,0.6140899528,1.8725952882,2.486685241
2016,Minnesota,Yellow Medicine County,9935,36,116,114,2,1,36,37,-3,290,11.697085812,11.495411919,0.2016738933,0.1008369467,3.6301300797,3.7309670263
2016,Mississippi,Mississippi,2988726,-664,37880,31006,6874,2223,-9690,-7467,-71,93060,12.672888917,10.373167734,2.2997211831,0.7437125676,-3.241824013,-2.498111445
2016,Mississippi,Adams County,31248,-44,369,418,-49,85,-67,18,-13,2396,11.800447713,13.367444835,-1.566997122,2.7182603134,-2.142628718,0.5756315958
2016,Mississippi,Alcorn County,37304,-27,409,449,-40,35,1,36,-23,741,10.960005359,12.031888524,-1.071883165,0.9378977691,0.0267970791,0.9646948483
2016,Mississippi,Amite County,12458,-107,141,154,-13,0,-89,-89,-5,116,11.269631939,12.308676018,-1.039044079,0.0,-7.113455621,-7.113455621
2016,Mississippi,Attala County,18934,-61,232,264,-32,2,-23,-21,-8,341,12.233383427,13.920746658,-1.687363231,0.105460202,-1.212792322,-1.107332121
2016,Mississippi,Benton County,8264,100,87,89,-2,-2,106,104,-2,79,10.591672754,10.835159484,-0.24348673,-0.24348673,12.904796689,12.661309959
2016,Mississippi,Bolivar County,32737,-612,452,429,23,13,-629,-616,-19,1756,13.679145356,12.98308265,0.6960627062,0.393426747,-19.03580183,-18.64237509
2016,Mississippi,Calhoun County,14610,-86,178,185,-7,0,-68,-68,-11,211,12.147683068,12.625400942,-0.477717873,0.0,-4.640687914,-4.640687914
2016,Mississippi,Carroll County,10255,17,102,118,-16,0,32,32,1,377,9.9546186503,11.516127458,-1.561508808,0.0,3.1230176158,3.1230176158
2016,Mississippi,Chickasaw County,17246,-122,255,199,56,18,-192,-174,-4,496,14.73392269,11.498237707,3.235684983,1.0400416017,-11.09377708,-10.05373548
2016,Mississippi,Choctaw County,8242,-52,94,108,-14,2,-40,-38,0,122,11.369134011,13.062409289,-1.693275278,0.2418964683,-4.837929366,-4.596032898
2016,Mississippi,Claiborne County,9139,-32,130,102,28,9,-74,-65,5,1112,14.19989077,11.141452758,3.058438012,0.983069361,-8.083014746,-7.099945385
2016,Mississippi,Clarke County,15888,-115,186,201,-15,2,-98,-96,-4,52,11.664732997,12.605437271,-0.940704274,0.1254272365,-6.14593459,-6.020507353
2016,Mississippi,Clay County,19850,-172,196,238,-42,0,-128,-128,-2,303,9.8314606742,11.938202247,-2.106741573,0.0,-6.420545746,-6.420545746
2016,Mississippi,Coahoma County,23809,-686,384,293,91,4,-796,-792,15,706,15.899304405,12.131500497,3.7678039086,0.1656177542,-32.95793309,-32.79231534
2016,Mississippi,Copiah County,28482,-272,337,318,19,21,-326,-305,14,999,11.775805437,11.111887623,0.663917814,0.7338038996,-11.39143197,-10.65762807
2016,Mississippi,Covington County,19569,-8,266,210,56,5,-56,-51,-13,222,13.590149696,10.729065549,2.8610841465,0.2554539417,-2.861084147,-2.605630205
2016,Mississippi,DeSoto County,175611,2399,2111,1335,776,75,1580,1655,-32,609,12.103559685,7.6543117856,4.4492478994,0.430017516,9.0590356714,9.4890531874
2016,Mississippi,Forrest County,75979,58,1022,757,265,147,-334,-187,-20,3255,13.456221198,9.9670836076,3.4891375905,1.935483871,-4.39763002,-2.462146149
2016,Mississippi,Franklin County,7782,23,89,74,15,0,0,0,8,67,11.453574416,9.5231967055,1.9303777106,0.0,0.0,0.0
2016,Mississippi,George County,23695,263,350,241,109,32,117,149,5,559,14.853481019,10.227682645,4.6257983746,1.3580325503,4.9653065122,6.3233390625
2016,Mississippi,Greene County,13408,-77,133,132,1,-1,-74,-75,-3,2397,9.8910497155,9.8166809207,0.0743687949,-0.074368795,-5.503290819,-5.577659614
2016,Mississippi,Grenada County,21275,-232,259,251,8,1,-247,-246,6,247,12.107895844,11.733906783,0.3739890608,0.0467486326,-11.54691225,-11.50016362
2016,Mississippi,Hancock County,46791,425,524,441,83,27,326,353,-11,548,11.249825563,9.4678875447,1.7819380186,0.5796665844,6.9989372779,7.5786038623
2016,Mississippi,Harrison County,203234,2272,2850,1845,1005,306,825,1131,136,5068,14.102069293,9.1292343319,4.9728349613,1.5141169136,4.0821779533,5.5962948668
2016,Mississippi,Hinds County,241229,-2005,3209,2107,1102,234,-3381,-3147,40,9008,13.247657716,8.6982906847,4.5493670311,0.9660180447,-13.95772226,-12.99170422
2016,Mississippi,Holmes County,17999,-357,266,249,17,0,-387,-387,13,897,14.63347545,13.698253335,0.9352221153,0.0,-21.29005639,-21.29005639
2016,Mississippi,Humphreys County,8513,-145,104,118,-14,5,-135,-130,-1,83,12.113447091,13.74410343,-1.630656339,0.582377264,-15.72418613,-15.14180886
2016,Mississippi,Issaquena County,1294,-36,8,6,2,0,-41,-41,3,281,6.0975609756,4.5731707317,1.5243902439,0.0,-31.25,-31.25
2016,Mississippi,Itawamba County,23529,-120,273,250,23,5,-160,-155,12,994,11.573190894,10.598160159,0.9750307347,0.2119632032,-6.782822502,-6.570859299
2016,Mississippi,Jackson County,141241,8,1642,1379,263,264,-434,-170,-85,1252,11.625848751,9.7637304672,1.8621182835,1.8691985811,-3.072849183,-1.203650601
2016,Mississippi,Jasper County,16578,17,218,182,36,0,-16,-16,-3,87,13.156703582,10.984036935,2.1726666465,0.0,-0.965629621,-0.965629621
2016,Mississippi,Jefferson County,7297,-192,101,77,24,0,-219,-219,3,382,13.661571757,10.415257676,3.2463140809,0.0,-29.62261599,-29.62261599
2016,Mississippi,Jefferson Davis County,11385,-219,116,148,-32,0,-177,-177,-10,111,10.091783027,12.875723172,-2.783940145,0.0,-15.39866893,-15.39866893
2016,Mississippi,Jones County,67953,-271,947,803,144,10,-391,-381,-34,1881,13.908369255,11.793474669,2.1148945857,0.1468676796,-5.742526271,-5.595658591
2016,Mississippi,Kemper County,9896,-47,95,103,-8,1,-47,-46,7,954,9.5770956197,10.383587882,-0.806492263,0.1008115328,-4.738142043,-4.637330511
2016,Mississippi,Lafayette County,53796,782,559,400,159,55,539,594,29,6125,10.467184721,7.4899353993,2.9772493212,1.0298661174,10.092687951,11.122554068
2016,Mississippi,Lamar County,60914,344,732,376,356,22,-25,-3,-9,311,12.050969675,6.1901155708,5.8608541042,0.3621876132,-0.411576833,-0.04938922
2016,Mississippi,Lauderdale County,77755,-750,1000,851,149,68,-925,-857,-42,3719,12.799180852,10.892102905,1.907077947,0.870344298,-11.83924229,-10.96889799
2016,Mississippi,Lawrence County,12749,131,164,139,25,0,108,108,-2,0,12.930184886,10.959120117,1.9710647692,0.0,8.5149998029,8.5149998029
2016,Mississippi,Leake County,22620,-86,283,290,-7,-3,-66,-69,-10,1596,12.487314124,12.796187619,-0.308873494,-0.132374355,-2.912235803,-3.044610158
2016,Mississippi,Lee County,85381,86,1130,1047,83,29,-64,-35,38,1058,13.241463357,12.268860297,0.9726030608,0.3398251658,-0.749958987,-0.410133821
2016,Mississippi,Leflore County,29856,-444,464,367,97,23,-548,-525,-16,1409,15.426557617,12.20160915,3.2249484673,0.7646785026,-18.2192965,-17.45461799
2016,Mississippi,Lincoln County,34523,-78,460,399,61,6,-130,-124,-15,700,13.309414964,11.544470806,1.7649441583,0.1736010648,-3.761356403,-3.587755338
2016,Mississippi,Lowndes County,59602,-142,745,585,160,121,-386,-265,-37,1375,12.484708327,9.8034286863,2.6812796407,2.0277177283,-6.468587133,-4.440869405
2016,Mississippi,Madison County,105114,1705,1346,1188,158,162,1149,1311,236,1751,12.909846875,11.394426514,1.5154203613,1.5537854337,11.020367058,12.574152492
2016,Mississippi,Marion County,25251,-282,297,338,-41,-2,-227,-229,-12,716,11.696597353,13.311279143,-1.61468179,-0.078764965,-8.939823566,-9.018588532
2016,Mississippi,Marshall County,35801,-126,437,447,-10,8,-111,-103,-13,1852,12.184920812,12.463751952,-0.27883114,0.2230649119,-3.095025652,-2.871960741
2016,Mississippi,Monroe County,35873,96,423,393,30,1,76,77,-11,405,11.807397069,10.969993022,0.8374040475,0.0279134682,2.1214235869,2.1493370551
2016,Mississippi,Montgomery County,10187,29,123,121,2,0,33,33,-6,99,12.091422954,11.894814451,0.1966085033,0.0,3.2440403047,3.2440403047
2016,Mississippi,Neshoba County,29403,-11,417,359,58,-2,-61,-63,-6,394,14.179573933,12.207355016,1.9722189163,-0.068007549,-2.07423024,-2.142237788
2016,Mississippi,Newton County,21558,-112,282,311,-29,9,-97,-88,5,552,13.047099102,14.38882206,-1.341722957,0.4163967799,-4.487831961,-4.071435181
2016,Mississippi,Noxubee County,11038,-26,172,146,26,12,-70,-58,6,159,15.564202335,13.211474075,2.3527282599,1.0858745815,-6.334268392,-5.248393811
2016,Mississippi,Oktibbeha County,49833,104,560,369,191,121,-194,-73,-14,4709,11.249271811,7.4124666037,3.8368052068,2.4306462305,-3.897069163,-1.466422932
2016,Mississippi,Panola County,34164,12,498,431,67,-2,-57,-59,4,315,14.579307922,12.617834768,1.9614731542,-0.058551437,-1.668715967,-1.727267404
2016,Mississippi,Pearl River County,55310,147,613,643,-30,9,178,187,-10,1329,11.097734288,11.640853421,-0.543119133,0.16293574,3.2225068569,3.3854425968
2016,Mississippi,Perry County,12245,20,131,124,7,0,14,14,-1,101,10.706988149,10.134859011,0.5721291377,0.0,1.1442582754,1.1442582754
2016,Mississippi,Pike County,39667,-293,535,528,7,7,-288,-281,-19,847,13.437653057,13.261833298,0.1758197596,0.1758197596,-7.233727253,-7.057907494
2016,Mississippi,Pontotoc County,31550,638,460,258,202,1,452,453,-17,236,14.728955205,8.2610227018,6.467932503,0.0320194678,14.472799462,14.50481893
2016,Mississippi,Prentiss County,25256,-57,268,215,53,-1,-119,-120,10,877,10.599379066,8.5032332061,2.0961458601,-0.039549922,-4.706440705,-4.745990627
2016,Mississippi,Quitman County,7349,-165,93,104,-11,2,-166,-164,10,137,12.514297248,13.994482944,-1.480185696,0.269124672,-22.33734778,-22.0682231
2016,Mississippi,Rankin County,150228,1458,1826,1181,645,55,841,896,-83,5104,12.214128523,7.8997183928,4.3144101298,0.3678954374,5.6254556887,5.9933511261
2016,Mississippi,Scott County,28207,-68,468,313,155,45,-257,-212,-11,227,16.571651145,11.083176941,5.4884742042,1.5934279948,-9.100244326,-7.506816331
2016,Mississippi,Sharkey County,4552,-42,61,49,12,2,-59,-57,3,106,13.339164662,10.715066696,2.6240979663,0.4373496611,-12.901815,-12.46446534
2016,Mississippi,Simpson County,26912,-210,287,301,-14,8,-195,-187,-9,625,10.622941111,11.14113336,-0.518192249,0.2961098568,-7.217677758,-6.921567902
2016,Mississippi,Smith County,15909,-148,186,179,7,0,-151,-151,-4,104,11.6373647,11.199399362,0.4379653382,0.0,-9.447538009,-9.447538009
2016,Mississippi,Stone County,18012,-49,217,175,42,9,-103,-94,3,1410,12.031159039,9.7025476118,2.3286114268,0.4989881629,-5.710642309,-5.211654146
2016,Mississippi,Sunflower County,26407,-516,311,285,26,-1,-539,-540,-2,3926,11.663228952,10.688168011,0.9750609413,-0.037502344,-20.21376336,-20.2512657
2016,Mississippi,Tallahatchie County,14394,-229,165,158,7,0,-230,-230,-6,2450,11.372643623,10.890167833,0.4824757901,0.0,-15.85277596,-15.85277596
2016,Mississippi,Tate County,28201,-167,330,302,28,6,-190,-184,-11,1308,11.66716753,10.677226043,0.9899414874,0.2121303187,-6.717460093,-6.505329774
2016,Mississippi,Tippah County,22190,108,283,235,48,5,62,67,-7,314,12.784604265,10.61619082,2.1684134442,0.2258764004,2.8008673654,3.0267437658
2016,Mississippi,Tishomingo County,19491,-18,186,285,-99,6,68,74,7,276,9.5384615385,14.615384615,-5.076923077,0.3076923077,3.4871794872,3.7948717949
2016,Mississippi,Tunica County,10234,-108,185,94,91,12,-212,-200,1,104,17.982115086,9.1368584759,8.8452566096,1.166407465,-20.60653188,-19.44012442
2016,Mississippi,Union County,28311,-7,342,251,91,53,-136,-83,-15,277,12.078616963,8.8647159583,3.2139010048,1.8718324533,-4.80319271,-2.931360257
2016,Mississippi,Walthall County,14599,-30,179,177,2,2,-35,-33,1,122,12.248528808,12.111673738,0.1368550705,0.1368550705,-2.394963733,-2.258108663
2016,Mississippi,Warren County,47140,-402,607,518,89,48,-520,-472,-19,525,12.821866881,10.941889694,1.8799771868,1.0139202805,-10.98413637,-9.970216092
2016,Mississippi,Washington County,47231,-822,731,664,67,8,-888,-880,-9,726,15.343604383,13.93728223,1.4063221527,0.167919063,-18.63901599,-18.47109693
2016,Mississippi,Wayne County,20480,-30,267,201,66,-2,-85,-87,-9,137,13.027567699,9.8072700659,3.2202976336,-0.097584777,-4.147353013,-4.24493779
2016,Mississippi,Webster County,9767,-102,108,149,-41,0,-74,-74,13,57,11.000203707,15.176206967,-4.176003259,0.0,-7.537176614,-7.537176614
2016,Mississippi,Wilkinson County,9047,-55,100,130,-30,0,-33,-33,8,1055,11.019890903,14.325858174,-3.305967271,0.0,-3.636563998,-3.636563998
2016,Mississippi,Winston County,18160,-141,193,225,-32,-1,-111,-112,3,444,10.586654233,12.341954417,-1.755300184,-0.054853131,-6.088697512,-6.143550643
2016,Mississippi,Yalobusha County,12471,20,163,173,-10,0,23,23,7,155,13.080812134,13.883315946,-0.802503812,0.0,1.8457587674,1.8457587674
2016,Mississippi,Yazoo County,27264,-113,358,259,99,22,-239,-217,5,4127,13.103713329,9.4800607602,3.6236525686,0.8052561264,-8.748009736,-7.94275361
2016,Missouri,Missouri,6093000,16796,74423,58723,15700,8413,-6250,2163,-1067,175397,12.231366982,9.6510831768,2.5802838049,1.382670551,-1.027183043,0.3554875076
2016,Missouri,Adair County,25359,-71,260,194,66,93,-234,-141,4,2908,10.238437457,7.6394494871,2.5989879698,3.6622103211,-9.214593711,-5.55238339
2016,Missouri,Andrew County,17350,59,189,164,25,-1,39,38,-4,192,10.911925175,9.4685488294,1.4433763459,-0.057735054,2.2516670997,2.1939320458
2016,Missouri,Atchison County,5293,-8,53,77,-24,1,9,10,6,98,10.005663583,14.536530111,-4.530866528,0.1887861053,1.6990749481,1.8878610534
2016,Missouri,Audrain County,26021,-61,348,278,70,10,-127,-117,-14,2485,13.35815596,10.671170566,2.6869853943,0.3838550563,-4.874959215,-4.491104159
2016,Missouri,Barry County,35732,-34,406,403,3,69,-106,-37,0,296,11.356961034,11.273042603,0.0839184313,1.9301239196,-2.965117905,-1.034993986
2016,Missouri,Barton County,11908,31,144,138,6,5,21,26,-1,90,12.108471726,11.603952071,0.5045196552,0.420433046,1.7658187934,2.1862518394
2016,Missouri,Bates County,16417,7,183,191,-8,2,23,25,-10,311,11.14935876,11.636762421,-0.487403662,0.1218509154,1.4012855272,1.5231364426
2016,Missouri,Benton County,18839,152,165,287,-122,0,285,285,-11,244,8.793902894,15.296061397,-6.502158503,0.0,15.189468635,15.189468635
2016,Missouri,Bollinger County,12052,-109,130,127,3,0,-107,-107,-5,163,10.738033288,10.49023252,0.2478007682,0.0,-8.838227399,-8.838227399
2016,Missouri,Boone County,176594,2048,2119,1064,1055,698,255,953,40,9019,12.069260124,6.0602608646,6.0089992596,3.9756222589,1.4524121433,5.4280344022
2016,Missouri,Buchanan County,88938,-78,1113,892,221,198,-440,-242,-57,4485,12.508850602,10.025062657,2.4837879452,2.2252941771,-4.945098171,-2.719803994
2016,Missouri,Butler County,42739,-120,528,575,-47,12,-55,-43,-30,874,12.33673684,13.434893339,-1.098156499,0.2803803827,-1.285076754,-1.004696371
2016,Missouri,Caldwell County,9062,42,98,86,12,1,27,28,2,214,10.839508904,9.5122220993,1.3272868046,0.1106072337,2.9863953103,3.097002544
2016,Missouri,Callaway County,45078,339,507,394,113,48,179,227,-1,4026,11.289622232,8.7733947916,2.5162274402,1.0688399746,3.9858824053,5.05472238
2016,Missouri,Camden County,44497,168,417,486,-69,56,140,196,41,774,9.3891428185,10.94274199,-1.553599171,1.2608920811,3.1522302029,4.413122284
2016,Missouri,Cape Girardeau County,78913,336,906,730,176,150,1,151,9,3836,11.505492412,9.2704298686,2.2350625437,1.9048828497,0.012699219,1.9175820687
2016,Missouri,Carroll County,8913,-32,92,118,-26,2,-6,-4,-2,88,10.303505432,13.215365662,-2.911860231,0.2239892485,-0.671967746,-0.447978497
2016,Missouri,Carter County,6168,-82,69,89,-20,0,-56,-56,-6,40,11.112900628,14.334031245,-3.221130617,0.0,-9.019165727,-9.019165727
2016,Missouri,Cass County,102845,1349,1169,909,260,48,1021,1069,20,1045,11.441658796,8.8968929388,2.5447658571,0.4698029275,9.9930997695,10.462902697
2016,Missouri,Cedar County,14016,72,178,216,-38,1,114,115,-5,156,12.732474964,15.450643777,-2.718168813,0.0715307582,8.1545064378,8.226037196
2016,Missouri,Chariton County,7516,-76,84,104,-20,0,-54,-54,-2,213,11.119936458,13.767540376,-2.647603918,0.0,-7.14853058,-7.14853058
2016,Missouri,Christian County,84401,1119,1035,641,394,33,665,698,27,582,12.344721886,7.645378482,4.6993434039,0.3935998282,7.9316329026,8.3252327308
2016,Missouri,Clark County,6723,-87,76,74,2,2,-91,-89,0,90,11.231803739,10.936229956,0.2955737826,0.2955737826,-13.44860711,-13.15303333
2016,Missouri,Clay County,239085,3614,3070,1753,1317,316,2011,2327,-30,2652,12.938409798,7.3879584285,5.5504513693,1.3317711714,8.4752905874,9.8070617588
2016,Missouri,Clinton County,20610,-25,237,241,-4,-3,-12,-15,-6,447,11.492302097,11.686265002,-0.193962905,-0.145472178,-0.581888714,-0.727360892
2016,Missouri,Cole County,76631,-149,908,654,254,94,-468,-374,-29,4950,11.837482319,8.5261161194,3.3113661993,1.2254662312,-6.101257407,-4.875791175
2016,Missouri,Cooper County,17712,96,185,179,6,3,94,97,-7,1528,10.473278986,10.133605072,0.339673913,0.1698369565,5.321557971,5.4913949275
2016,Missouri,Crawford County,24302,-185,290,287,3,0,-194,-194,6,332,11.887925557,11.764947017,0.1229785402,0.0,-7.952612269,-7.952612269
2016,Missouri,Dade County,7631,35,66,106,-40,0,77,77,-2,133,8.6688119787,13.92263742,-5.253825442,0.0,10.113613975,10.113613975
2016,Missouri,Dallas County,16448,35,199,202,-3,-1,54,53,-15,199,12.111621679,12.294208941,-0.182587261,-0.06086242,3.2865707069,3.2257082864
2016,Missouri,Daviess County,8209,-43,129,88,41,3,-90,-87,3,152,15.673409878,10.691938521,4.9814713565,0.3644979041,-10.93493712,-10.57043922
2016,Missouri,DeKalb County,12613,-32,106,93,13,1,-45,-44,-1,3502,8.3933803151,7.364003484,1.0293768311,0.0791828332,-3.563227492,-3.484044659
2016,Missouri,Dent County,15387,-229,190,202,-12,6,-216,-210,-7,201,12.256878367,13.030997,-0.774118634,0.3870593168,-13.93413541,-13.54707609
2016,Missouri,Douglas County,13358,-14,145,162,-17,-2,-3,-5,8,123,10.849233071,12.121212121,-1.27197905,-0.149644594,-0.224466891,-0.374111485
2016,Missouri,Dunklin County,30535,-342,418,438,-20,0,-313,-313,-9,671,13.612974663,14.264313164,-0.651338501,0.0,-10.19344753,-10.19344753
2016,Missouri,Franklin County,102838,456,1215,1018,197,10,276,286,-27,858,11.840951174,9.9210603255,1.9198908488,0.0974563883,2.6897963161,2.7872527044
2016,Missouri,Gasconade County,14808,-18,149,205,-56,2,37,39,-1,250,10.056016738,13.83545927,-3.779442532,0.1349800904,2.4971316731,2.6321117635
2016,Missouri,Gentry County,6661,-24,95,79,16,2,-40,-38,-2,177,14.236475348,11.838753184,2.3977221639,0.2997152705,-5.99430541,-5.694590139
2016,Missouri,Greene County,288690,766,3590,2753,837,341,-385,-44,-27,11263,12.452004287,9.54884897,2.9031553171,1.182766981,-1.335382075,-0.152615094
2016,Missouri,Grundy County,10165,103,151,137,14,8,88,96,-7,350,14.930538389,13.546250062,1.3842883275,0.7910219014,8.7012409156,9.492262817
2016,Missouri,Harrison County,8556,-57,104,119,-15,1,-47,-46,4,145,12.114858175,13.862193488,-1.747335314,0.1164890209,-5.474983983,-5.358494962
2016,Missouri,Henry County,21594,-149,236,305,-69,1,-73,-72,-8,233,10.891386113,14.075732053,-3.18434594,0.0461499412,-3.368945705,-3.322795763
2016,Missouri,Hickory County,9269,76,86,140,-54,0,88,88,42,75,9.3164337558,15.166287509,-5.849853754,0.0,9.533095006,9.533095006
2016,Missouri,Holt County,4448,-23,46,62,-16,0,-2,-2,-5,101,10.315057742,13.902903913,-3.587846171,0.0,-0.448480771,-0.448480771
2016,Missouri,Howard County,10058,-65,116,76,40,7,-108,-101,-4,717,11.495961548,7.5318368763,3.9641246717,0.6937218176,-10.70313661,-10.0094148
2016,Missouri,Howell County,40210,75,506,511,-5,18,75,93,-13,608,12.595681125,12.720144377,-0.124463252,0.448067708,1.8669487834,2.3150164914
2016,Missouri,Iron County,10022,-77,96,158,-62,4,-11,-7,-8,276,9.5422692709,15.704984842,-6.162715571,0.397594553,-1.093385021,-0.695790468
2016,Missouri,Jackson County,691801,5428,9423,6473,2950,895,1973,2868,-390,11041,13.674615832,9.3935889082,4.281026924,1.2988200329,2.8632088546,4.1620288875
2016,Missouri,Jasper County,119111,735,1667,1094,573,181,21,202,-40,2484,14.038663169,9.2131358769,4.825527292,1.5242939614,0.1768517856,1.7011457469
2016,Missouri,Jefferson County,224226,318,2529,2045,484,83,-255,-172,6,1984,11.286802608,9.1267344143,2.1600681939,0.3704249175,-1.138052458,-0.76762754
2016,Missouri,Johnson County,53942,68,709,405,304,114,-326,-212,-24,3855,13.152036803,7.5127995845,5.639237219,2.1147139571,-6.047339912,-3.932625955
2016,Missouri,Knox County,3934,35,47,40,7,0,28,28,0,87,12.00051066,10.213200562,1.7873100983,0.0,7.1492403932,7.1492403932
2016,Missouri,Laclede County,35490,3,480,383,97,4,-97,-93,-1,345,13.525508263,10.792228468,2.7332797949,0.1127125689,-2.733279795,-2.620567226
2016,Missouri,Lafayette County,32618,-61,373,365,8,3,-58,-55,-14,724,11.424720891,11.179686662,0.2450342282,0.0918878356,-1.776498155,-1.684610319
2016,Missouri,Lawrence County,38381,237,484,426,58,-1,198,197,-18,559,12.64946096,11.133616465,1.5158444953,-0.02613525,5.1747794838,5.1486442339
2016,Missouri,Lewis County,10134,-52,119,112,7,5,-57,-52,-7,785,11.712598425,11.023622047,0.688976378,0.4921259843,-5.61023622,-5.118110236
2016,Missouri,Lincoln County,55267,592,721,455,266,12,325,337,-11,632,13.116006622,8.2770915574,4.8389150643,0.2182969202,5.9122082553,6.1305051755
2016,Missouri,Linn County,12164,-129,158,169,-11,0,-108,-108,-10,152,12.920636219,13.820174183,-0.899537965,0.0,-8.831827289,-8.831827289
2016,Missouri,Livingston County,15235,225,148,191,-43,7,250,257,11,1875,9.7867416102,12.630186808,-2.843445198,0.4628864275,16.531658125,16.994544553
2016,Missouri,McDonald County,22620,-28,305,217,88,43,-170,-127,11,157,13.475302642,9.5873464699,3.8879561721,1.8997967659,-7.510824423,-5.611027658
2016,Missouri,Macon County,15170,-151,166,182,-16,3,-128,-125,-10,286,10.88845889,11.937948903,-1.049490013,0.1967793775,-8.395920108,-8.19914073
2016,Missouri,Madison County,12443,74,138,176,-38,17,86,103,9,164,11.123649847,14.186683863,-3.063034016,1.3703046913,6.9321296147,8.302434306
2016,Missouri,Maries County,8858,-100,86,95,-9,8,-94,-86,-5,67,9.6542433767,10.664571172,-1.010327795,0.8980691513,-10.55231253,-9.654243377
2016,Missouri,Marion County,28894,32,375,307,68,15,-51,-36,0,1370,12.985663827,10.63093012,2.3547337073,0.5194265531,-1.76605028,-1.246623727
2016,Missouri,Mercer County,3699,-3,43,35,8,1,-10,-9,-2,51,11.620051344,9.4581813268,2.1618700176,0.2702337522,-2.702337522,-2.43210377
2016,Missouri,Miller County,25206,130,307,280,27,-1,105,104,-1,271,12.211129231,11.137186269,1.0739429617,-0.039775665,4.176444851,4.1366691858
2016,Missouri,Mississippi County,13799,-224,136,168,-32,-4,-182,-186,-6,1873,9.776435914,12.076773776,-2.300337862,-0.287542233,-13.08317159,-13.37071382
2016,Missouri,Moniteau County,16018,105,195,152,43,11,46,57,5,1373,12.213836084,9.5205286399,2.6933074442,0.6889856253,2.8812126147,3.57019824
2016,Missouri,Monroe County,8558,-2,90,92,-2,0,6,6,-6,129,10.515247108,10.748919266,-0.233672158,0.0,0.7010164739,0.7010164739
2016,Missouri,Montgomery County,11620,-79,125,145,-20,7,-58,-51,-8,394,10.720871392,12.436210815,-1.715339423,0.600368798,-4.974484326,-4.374115528
2016,Missouri,Morgan County,20213,55,270,284,-14,0,77,77,-8,302,13.375938173,14.069505338,-0.693567165,0.0,3.814619405,3.814619405
2016,Missouri,New Madrid County,17915,-252,216,228,-12,3,-246,-243,3,332,11.972728784,12.637880384,-0.665151599,0.1662878998,-13.63560778,-13.46931988
2016,Missouri,Newton County,58694,127,707,611,96,44,-1,43,-12,880,12.058570198,10.421197158,1.6373730396,0.7504626432,-0.017055969,0.733406674
2016,Missouri,Nodaway County,22670,-106,223,182,41,31,-171,-140,-7,3624,9.8138450029,8.0095057871,1.8043392158,1.3642564802,-7.525414778,-6.161158298
2016,Missouri,Oregon County,10789,-147,137,148,-11,-1,-157,-158,22,121,12.612197929,13.624856157,-1.012658228,-0.092059839,-14.45339471,-14.54545455
2016,Missouri,Osage County,13664,38,140,127,13,3,31,34,-9,405,10.26016856,9.3074386222,0.9527299377,0.2198607549,2.2718944668,2.4917552217
2016,Missouri,Ozark County,9237,-170,76,128,-52,-1,-115,-116,-2,123,8.1527569191,13.730959022,-5.578202103,-0.107273117,-12.3364085,-12.44368161
2016,Missouri,Pemiscot County,17073,-369,264,244,20,1,-386,-385,-4,202,15.297696654,14.13878024,1.1589164132,0.0579458207,-22.36708677,-22.30914095
2016,Missouri,Perry County,19285,155,209,214,-5,7,134,141,19,286,10.881166211,11.141481192,-0.260314981,0.3644409736,6.9764414942,7.3408824678
2016,Missouri,Pettis County,42213,31,585,397,188,36,-167,-131,-26,851,13.863380532,9.4081402927,4.4552402394,0.8531311097,-3.957580425,-3.104449316
2016,Missouri,Phelps County,44608,-2,502,436,66,186,-236,-50,-18,3011,11.253334529,9.7738124594,1.4795220695,4.169562196,-5.290412249,-1.120850053
2016,Missouri,Pike County,18438,84,219,193,26,1,67,68,-10,2293,11.904761905,10.491411176,1.4133507284,0.0543596434,3.6420961078,3.6964557513
2016,Missouri,Platte County,98309,2092,1155,629,526,204,1418,1622,-56,869,11.875019278,6.4670018404,5.4080174373,2.0974060023,14.579027996,16.676433999
2016,Missouri,Polk County,31285,102,375,371,4,7,88,95,3,1510,12.006147147,11.878081578,0.1280655696,0.2241147468,2.8174425306,3.0415572773
2016,Missouri,Pulaski County,52654,-502,780,271,509,233,-1242,-1009,-2,10010,14.743407995,5.1223891882,9.6210188073,4.4041205935,-23.47604196,-19.07192137
2016,Missouri,Putnam County,4853,-10,64,55,9,2,-17,-15,-4,57,13.174145739,11.321531494,1.8526142445,0.4116920543,-3.499382462,-3.087690408
2016,Missouri,Ralls County,10224,47,90,86,4,0,36,36,7,54,8.823096907,8.4309592667,0.3921376403,0.0,3.5292387628,3.5292387628
2016,Missouri,Randolph County,24989,-101,276,253,23,9,-148,-139,15,2456,11.022584317,10.104035624,0.9185486931,0.3594320973,-5.910661155,-5.551229058
2016,Missouri,Ray County,22754,-61,248,266,-18,0,-34,-34,-9,311,10.884592596,11.674603349,-0.790010753,0.0,-1.492242533,-1.492242533
2016,Missouri,Reynolds County,6455,37,51,90,-39,0,76,76,0,101,7.9235609415,13.982754603,-6.059193661,0.0,11.807659442,11.807659442
2016,Missouri,Ripley County,13817,6,171,213,-42,-1,54,53,-5,63,12.3787462,15.419140003,-3.040393803,-0.072390329,3.9090777472,3.8366874186
2016,Missouri,St. Charles County,390918,5747,4538,2718,1820,579,3151,3730,197,5444,11.694535034,7.0043513051,4.6901837289,1.4920969116,8.1202027087,9.6122996203
2016,Missouri,St. Clair County,9272,-178,94,150,-56,1,-146,-145,23,207,10.041662216,16.023929067,-5.982266852,0.1068261938,-15.59662429,-15.4897981
2016,Missouri,Ste. Genevieve County,18030,135,184,183,1,76,74,150,-16,277,10.243562978,10.187891441,0.0556715379,4.2310368824,4.1196938065,8.3507306889
2016,Missouri,St. Francois County,66627,181,715,766,-51,14,190,204,28,7011,10.745981529,11.512478114,-0.766496585,0.2104108271,2.8555755112,3.0659863383
2016,Missouri,St. Louis County,998581,-3124,11591,10027,1564,2186,-6170,-3984,-704,19414,11.589342724,10.025566344,1.56377638,2.1856874467,-6.169117816,-3.983430369
2016,Missouri,Saline County,22980,-129,278,232,46,38,-196,-158,-17,1277,12.063616047,10.06747814,1.9961379071,1.6489834885,-8.505283256,-6.856299768
2016,Missouri,Schuyler County,4394,-40,66,47,19,1,-69,-68,9,47,14.952424105,10.647938378,4.3044857272,0.2265518804,-15.63207975,-15.40552787
2016,Missouri,Scotland County,4932,73,75,53,22,0,49,49,2,76,15.320192013,10.826269023,4.4939229905,0.0,10.009192115,10.009192115
2016,Missouri,Scott County,38745,-259,480,431,49,19,-315,-296,-12,559,12.34742569,11.086959318,1.2604663726,0.4887522669,-8.102998109,-7.614245842
2016,Missouri,Shannon County,8168,-65,80,76,4,0,-72,-72,3,80,9.7555027132,9.2677275776,0.4877751357,0.0,-8.779952442,-8.779952442
2016,Missouri,Shelby County,6082,-50,75,65,10,1,-68,-67,7,198,12.280989029,10.643523825,1.6374652039,0.1637465204,-11.13476339,-10.97101687
2016,Missouri,Stoddard County,29588,-198,365,401,-36,-1,-152,-153,-9,690,12.294943915,13.507595917,-1.212652003,-0.033684778,-5.120086233,-5.153771011
2016,Missouri,Stone County,31047,145,235,353,-118,4,287,291,-28,300,7.5868859869,11.396471291,-3.809585304,0.1291384849,9.2656862903,9.3948247752
2016,Missouri,Sullivan County,6262,-61,74,67,7,21,-97,-76,8,108,11.760031784,10.647596345,1.112435439,3.337306317,-15.4151768,-12.07787048
2016,Missouri,Taney County,54735,402,648,544,104,45,294,339,-41,1751,11.882495324,9.9754281732,1.9070671508,0.8251732864,5.3911321377,6.2163054241
2016,Missouri,Texas County,25775,124,289,281,8,2,101,103,13,1897,11.239450861,10.928324194,0.3111266674,0.0777816669,3.9279741765,4.0057558433
2016,Missouri,Vernon County,20723,-80,263,243,20,36,-135,-99,-1,759,12.666762992,11.703511053,0.9632519385,1.7338534894,-6.501950585,-4.768097096
2016,Missouri,Warren County,33802,257,408,302,106,3,159,162,-11,317,12.116352621,8.9684766953,3.1478759262,0.0890908281,4.7218138893,4.8109047174
2016,Missouri,Washington County,24839,44,279,281,-2,1,49,50,-4,1087,11.242293589,11.322883507,-0.080589918,0.0402949591,1.9744529959,2.014747955
2016,Missouri,Wayne County,13139,-234,131,203,-72,0,-150,-150,-12,133,9.8823174412,15.313820157,-5.431502716,0.0,-11.31563066,-11.31563066
2016,Missouri,Webster County,38106,580,566,354,212,0,372,372,-4,956,14.967209647,9.3611169875,5.6060926592,0.0,9.8371059869,9.8371059869
2016,Missouri,Worth County,2024,-27,20,24,-4,0,-31,-31,8,52,9.8159509202,11.779141104,-1.963190184,0.0,-15.21472393,-15.21472393
2016,Missouri,Wright County,18286,29,238,214,24,0,13,13,-8,195,13.025750486,11.712229428,1.3135210574,0.0,0.7114905727,0.7114905727
2016,Missouri,St. Louis city,311404,-3471,4547,3070,1477,981,-6189,-5208,260,11871,14.52068487,9.8039372229,4.7167476476,3.1327890605,-19.76435423,-16.63156517
2016,Montana,Montana,1042520,10447,12431,9597,2834,569,6853,7422,191,28872,11.984037351,9.2519351989,2.7321021521,0.5485413283,6.606597053,7.1551383814
2016,Montana,Beaverhead County,9401,140,86,87,-1,-2,147,145,-4,443,9.2165898618,9.3237595113,-0.10716965,-0.214339299,15.753938485,15.539599186
2016,Montana,Big Horn County,13343,87,283,157,126,0,-54,-54,15,137,21.278995451,11.804955073,9.4740403775,0.0,-4.060303019,-4.060303019
2016,Montana,Blaine County,6601,14,110,68,42,4,-36,-32,4,220,16.681831968,10.312405217,6.3694267516,0.6066120716,-5.459508644,-4.852896573
2016,Montana,Broadwater County,5747,68,41,49,-8,1,78,79,-3,52,7.1766147383,8.5769298092,-1.400315071,0.1750393839,13.653071941,13.828111325
2016,Montana,Carbon County,10460,72,63,84,-21,5,88,93,0,52,6.0437452034,8.0583269378,-2.014581734,0.4796623177,8.442056792,8.9217191097
2016,Montana,Carter County,1203,32,18,11,7,0,25,25,0,11,15.164279697,9.2670598147,5.8972198821,0.0,21.061499579,21.061499579
2016,Montana,Cascade County,81755,-363,1124,813,311,70,-694,-624,-50,2463,13.717940112,9.9223178925,3.7956222196,0.8543201137,-8.469973699,-7.615653585
2016,Montana,Chouteau County,5759,2,54,56,-2,2,1,3,1,135,9.378256339,9.7255991664,-0.347342827,0.3473428274,0.1736714137,0.5210142411
2016,Montana,Custer County,11924,-223,163,158,5,4,-225,-221,-7,413,13.543267833,13.127830169,0.4154376636,0.3323501309,-18.69469486,-18.36234473
2016,Montana,Daniels County,1755,-8,20,13,7,3,-17,-14,-1,41,11.370096646,7.3905628198,3.979533826,1.7055144969,-9.664582149,-7.959067652
2016,Montana,Dawson County,9327,-298,131,93,38,1,-333,-332,-4,498,13.82439848,9.8142676235,4.0101308569,0.1055297594,-35.14140988,-35.03588012
2016,Montana,Deer Lodge County,9085,-63,72,125,-53,1,-9,-8,-2,842,7.8977677837,13.711402402,-5.813634619,0.1096912192,-0.987220973,-0.877529754
2016,Montana,Fallon County,3120,-64,59,30,29,0,-91,-91,-2,34,18.718274112,9.5177664975,9.2005076142,0.0,-28.87055838,-28.87055838
2016,Montana,Fergus County,11413,29,122,152,-30,0,65,65,-6,465,10.703162697,13.33508795,-2.631925253,0.0,5.7025047155,5.7025047155
2016,Montana,Flathead County,98082,2003,1129,867,262,18,1705,1723,18,992,11.629523952,8.9307327424,2.6987912094,0.1854131365,17.56274432,17.748157457
2016,Montana,Gallatin County,104502,3766,1224,544,680,108,2886,2994,92,3265,11.927615744,5.3011625527,6.6264531909,1.0524366833,28.123446925,29.175883608
2016,Montana,Garfield County,1310,-2,14,13,1,0,-7,-7,4,0,10.678871091,9.9160945843,0.7627765065,0.0,-5.339435545,-5.339435545
2016,Montana,Glacier County,13694,60,239,155,84,8,-26,-18,-6,690,17.491217799,11.343676815,6.1475409836,0.5854800937,-1.902810304,-1.317330211
2016,Montana,Golden Valley County,831,1,8,4,4,0,-4,-4,1,89,9.6327513546,4.8163756773,4.8163756773,0.0,-4.816375677,-4.816375677
2016,Montana,Granite County,3368,129,24,31,-7,2,135,137,-1,40,7.2650219464,9.3839866808,-2.118964734,0.6054184955,40.865748449,41.471166944
2016,Montana,Hill County,16542,24,305,157,148,6,-120,-114,-10,593,18.451300665,9.4978826376,8.9534180278,0.3629764065,-7.259528131,-6.896551724
2016,Montana,Jefferson County,11853,182,81,124,-43,7,213,220,5,230,6.8865839143,10.542424758,-3.655840843,0.5951368815,18.109165108,18.704301989
2016,Montana,Judith Basin County,1940,9,14,6,8,0,1,1,0,0,7.2332730561,3.0999741669,4.1332988892,0.0,0.5166623611,0.5166623611
2016,Montana,Lake County,29758,292,357,324,33,55,210,265,-6,585,12.055923274,10.941510199,1.1144130758,1.8573551263,7.0917195731,8.9490746994
2016,Montana,Lewis and Clark County,67282,803,763,608,155,51,545,596,52,1950,11.408407533,9.0908411271,2.3175664058,0.7625541077,8.1488625235,8.9114166312
2016,Montana,Liberty County,2409,8,24,25,-1,0,11,11,-2,403,9.9792099792,10.395010395,-0.415800416,0.0,4.5738045738,4.5738045738
2016,Montana,Lincoln County,19259,212,162,249,-87,4,280,284,15,209,8.4582049809,13.000574323,-4.542369342,0.2088445674,14.61911972,14.827964288
2016,Montana,McCone County,1700,17,18,12,6,0,1,1,10,19,10.641442507,7.0942950044,3.5471475022,0.0,0.5911912504,0.5911912504
2016,Montana,Madison County,7924,13,57,70,-13,1,25,26,0,163,7.199242185,8.8411746132,-1.641932428,0.1263024945,3.1575623619,3.2838648563
2016,Montana,Meagher County,1827,9,14,24,-10,0,20,20,-1,174,7.6817558299,13.16872428,-5.48696845,0.0,10.9739369,10.9739369
2016,Montana,Mineral County,4184,-60,41,56,-15,0,-49,-49,4,22,9.7294731846,13.289036545,-3.55956336,0.0,-11.62790698,-11.62790698
2016,Montana,Missoula County,116130,2148,1234,856,378,85,1673,1758,12,3638,10.725212071,7.4398553748,3.2853566959,0.7387706856,14.540745376,15.279516062
2016,Montana,Musselshell County,4589,11,43,55,-12,5,16,21,2,52,9.3814770372,11.999563652,-2.618086615,1.0908694229,3.4907821534,4.5816515763
2016,Montana,Park County,16114,133,156,159,-3,2,135,137,-1,108,9.7211403645,9.9080853716,-0.186945007,0.1246300047,8.4125253155,8.5371553201
2016,Montana,Petroleum County,489,16,0,0,0,0,15,15,1,0,0.0,0.0,0.0,0.0,31.185031185,31.185031185
2016,Montana,Phillips County,4133,-22,61,37,24,0,-43,-43,-3,127,14.72007722,8.9285714286,5.7915057915,0.0,-10.37644788,-10.37644788
2016,Montana,Pondera County,6084,-64,74,57,17,8,-91,-83,2,645,12.09941138,9.3198168738,2.7795945062,1.3080444735,-14.87900589,-13.57096141
2016,Montana,Powder River County,1746,-34,13,18,-5,0,-33,-33,4,35,7.3737946682,10.209869541,-2.836074872,0.0,-18.71809416,-18.71809416
2016,Montana,Powell County,6858,27,53,71,-18,0,41,41,4,1549,7.7434436409,10.373292425,-2.629848784,0.0,5.9902111184,5.9902111184
2016,Montana,Prairie County,1182,19,15,10,5,0,9,9,5,21,12.793176972,8.5287846482,4.2643923241,0.0,7.6759061834,7.6759061834
2016,Montana,Ravalli County,42088,793,377,435,-58,7,812,819,32,479,9.0426106041,10.433781466,-1.391170862,0.1678999316,19.47639207,19.644292002
2016,Montana,Richland County,11482,-456,190,83,107,-3,-558,-561,-2,34,16.225448335,7.0879590094,9.1374893254,-0.256191289,-47.65157985,-47.90777114
2016,Montana,Roosevelt County,11305,-195,255,164,91,0,-290,-290,4,186,22.363516773,14.382810787,7.9807059855,0.0,-25.43301907,-25.43301907
2016,Montana,Rosebud County,9287,-116,166,101,65,8,-190,-182,1,65,17.763509898,10.807918673,6.9555912253,0.8560727662,-20.3317282,-19.47565543
2016,Montana,Sanders County,11534,218,122,127,-5,6,199,205,18,188,10.67833698,11.115973742,-0.437636761,0.5251641138,17.417943107,17.943107221
2016,Montana,Sheridan County,3648,-43,49,49,0,1,-44,-43,0,85,13.353317891,13.353317891,0.0,0.2725166916,-11.99073443,-11.71821774
2016,Montana,Silver Bow County,34553,-26,408,430,-22,52,-42,10,-14,998,11.803506336,12.439969913,-0.636463577,1.5043684546,-1.215066829,0.2893016259
2016,Montana,Stillwater County,9406,-77,79,85,-6,7,-82,-75,4,112,8.3646566785,8.9999470591,-0.635290381,0.7411721108,-8.682301869,-7.941129758
2016,Montana,Sweet Grass County,3623,-1,27,31,-4,0,7,7,-4,45,7.4513591831,8.5552642473,-1.103905064,0.0,1.9318338623,1.9318338623
2016,Montana,Teton County,6056,-39,84,55,29,2,-67,-65,-3,461,13.82602255,9.0527528598,4.7732696897,0.3291910131,-11.02789894,-10.69870793
2016,Montana,Toole County,4977,-122,49,42,7,-1,-128,-129,0,796,9.7260817785,8.3366415244,1.3894402541,-0.198491465,-25.4069075,-25.60539897
2016,Montana,Treasure County,692,-3,10,5,5,0,-10,-10,2,0,14.419610671,7.2098053353,7.2098053353,0.0,-14.41961067,-14.41961067
2016,Montana,Valley County,7539,-87,88,66,22,2,-107,-105,-4,126,11.605670953,8.7042532146,2.9014177382,0.2637652489,-14.11144082,-13.84767557
2016,Montana,Wheatland County,2117,13,21,21,0,0,13,13,0,147,9.9502487562,9.9502487562,0.0,0.0,6.1596778015,6.1596778015
2016,Montana,Wibaux County,1093,-28,12,16,-4,0,-27,-27,3,24,10.840108401,14.453477868,-3.613369467,0.0,-24.3902439,-24.3902439
2016,Montana,Yellowstone County,158437,1491,2025,1459,566,39,874,913,12,3721,12.841529188,9.2522425115,3.5892866768,0.2473183399,5.5424674126,5.7897857526
2016,Nebraska,Nebraska,1907116,13351,26553,15355,11198,4187,-2144,2043,110,52354,13.972023854,8.0797057314,5.8923181231,2.2031734222,-1.128159498,1.0750139244
2016,Nebraska,Adams County,31684,99,426,308,118,10,-10,0,-19,1479,13.466310515,9.7362057248,3.7301047907,0.3161105755,-0.316110575,0.0
2016,Nebraska,Antelope County,6329,-69,85,67,18,4,-105,-101,14,61,13.357429088,10.528797046,2.8286320421,0.6285848982,-16.50035358,-15.87176868
2016,Nebraska,Arthur County,469,12,4,4,0,0,11,11,1,0,8.6393088553,8.6393088553,0.0,0.0,23.758099352,23.758099352
2016,Nebraska,Banner County,798,1,7,2,5,2,-10,-8,4,0,8.7774294671,2.5078369906,6.2695924765,2.5078369906,-12.53918495,-10.03134796
2016,Nebraska,Blaine County,484,-8,8,6,2,0,-11,-11,1,0,16.393442623,12.295081967,4.0983606557,0.0,-22.54098361,-22.54098361
2016,Nebraska,Boone County,5332,37,66,68,-2,3,42,45,-6,94,12.421191305,12.797591042,-0.376399737,0.5645996048,7.9043944669,8.4689940717
2016,Nebraska,Box Butte County,11194,-117,173,101,72,5,-192,-187,-2,177,15.374361253,8.9757831593,6.3985780938,0.444345701,-17.06287492,-16.61852922
2016,Nebraska,Boyd County,1982,-29,15,22,-7,1,-23,-22,0,31,7.513148009,11.019283747,-3.506135738,0.5008765339,-11.52016028,-11.01928375
2016,Nebraska,Brown County,2960,17,25,29,-4,0,13,13,8,38,8.4702693546,9.8255124513,-1.355243097,0.0,4.4045400644,4.4045400644
2016,Nebraska,Buffalo County,49383,651,729,358,371,147,112,259,21,2083,14.860113133,7.2975589869,7.5625541456,2.9964837181,2.2830352138,5.2795189319
2016,Nebraska,Burt County,6546,-35,68,95,-27,1,-23,-22,14,126,10.360326046,14.473984917,-4.113658871,0.152357736,-3.504227927,-3.351870191
2016,Nebraska,Butler County,8052,-52,82,96,-14,1,-38,-37,-1,166,10.151027482,11.884129735,-1.733102253,0.1237930181,-4.704134687,-4.580341669
2016,Nebraska,Cass County,25767,244,281,235,46,2,211,213,-15,295,10.957301618,9.1635796452,1.7937219731,0.0779879119,8.2277247027,8.3057126145
2016,Nebraska,Cedar County,8671,103,120,103,17,0,81,81,5,148,13.921921225,11.949649052,1.9722721736,0.0,9.397296827,9.397296827
2016,Nebraska,Chase County,3937,-49,45,50,-5,10,-53,-43,-1,67,11.359333586,12.621481762,-1.262148176,2.5242963524,-13.37877067,-10.85447432
2016,Nebraska,Cherry County,5832,3,87,59,28,-2,-34,-36,11,45,14.921533316,10.119200755,4.8023325615,-0.343023754,-5.831403825,-6.174427579
2016,Nebraska,Cheyenne County,10051,-105,123,70,53,0,-171,-171,13,95,12.173999109,6.928292176,5.2457069332,0.0,-16.92482803,-16.92482803
2016,Nebraska,Clay County,6163,-148,81,80,1,-1,-146,-147,-2,91,12.987012987,12.826679493,0.1603334937,-0.160333494,-23.40869008,-23.56902357
2016,Nebraska,Colfax County,10414,-127,190,68,122,49,-312,-263,14,80,18.134096874,6.4900978287,11.643999046,4.6766881413,-29.77809592,-25.10140778
2016,Nebraska,Cuming County,9016,-114,126,86,40,18,-177,-159,5,131,13.887358095,9.4786729858,4.4086851097,1.9839082993,-19.50843161,-17.52452331
2016,Nebraska,Custer County,10807,5,140,129,11,-3,7,4,-10,127,12.957563978,11.939469665,1.0180943126,-0.277662085,0.6478781989,0.3702161137
2016,Nebraska,Dakota County,20465,-248,359,133,226,29,-512,-483,9,251,17.436495216,6.4597600661,10.97673515,1.4085191121,-24.86764777,-23.45912866
2016,Nebraska,Dawes County,8979,-62,90,90,0,23,-98,-75,13,1150,9.9889012209,9.9889012209,0.0,2.5527192009,-10.87680355,-8.324084351
2016,Nebraska,Dawson County,23640,-205,412,199,213,64,-472,-408,-10,296,17.352848268,8.3815941876,8.9712540802,2.6955880804,-19.87996209,-17.18437401
2016,Nebraska,Deuel County,1873,-51,19,20,-1,0,-52,-52,2,18,10.007900974,10.534632605,-0.52673163,0.0,-27.39004477,-27.39004477
2016,Nebraska,Dixon County,5762,-27,78,59,19,5,-55,-50,4,79,13.505324214,10.215565752,3.2897584625,0.8657259112,-9.522985023,-8.657259112
2016,Nebraska,Dodge County,36757,81,516,422,94,22,-31,-9,-4,1214,14.053627116,11.493470238,2.5601568777,0.5991856522,-0.844307055,-0.245121403
2016,Nebraska,Douglas County,554995,5827,8660,3893,4767,1647,-442,1205,-145,12644,15.686089826,7.0514951144,8.6345947111,2.9832551897,-0.800606432,2.1826487575
2016,Nebraska,Dundy County,1831,31,16,21,-5,-1,26,25,11,33,8.8129991738,11.567061416,-2.754062242,-0.550812448,14.321123657,13.770311209
2016,Nebraska,Fillmore County,5720,92,69,79,-10,3,84,87,15,213,12.160733169,13.923158266,-1.762425097,0.5287275291,14.804370814,15.333098343
2016,Nebraska,Franklin County,3014,-1,26,28,-2,0,-6,-6,7,56,8.6249792669,9.2884392105,-0.663459944,0.0,-1.990379831,-1.990379831
2016,Nebraska,Frontier County,2621,4,23,13,10,0,-13,-13,7,113,8.7819778541,4.9637266132,3.8182512409,0.0,-4.963726613,-4.963726613
2016,Nebraska,Furnas County,4787,-62,59,60,-1,0,-59,-59,-2,80,12.245745122,12.453300125,-0.207555002,0.0,-12.24574512,-12.24574512
2016,Nebraska,Gage County,21799,-64,233,268,-35,0,-12,-12,-17,516,10.67289634,12.276121112,-1.603224772,0.0,-0.549677065,-0.549677065
2016,Nebraska,Garden County,1930,3,22,27,-5,0,7,7,1,31,11.40782992,14.000518538,-2.592688618,0.0,3.6297640653,3.6297640653
2016,Nebraska,Garfield County,2011,-10,23,22,1,0,-15,-15,4,60,11.408730159,10.912698413,0.496031746,0.0,-7.44047619,-7.44047619
2016,Nebraska,Gosper County,1971,3,20,20,0,0,5,5,-2,40,10.15486164,10.15486164,0.0,0.0,2.53871541,2.53871541
2016,Nebraska,Grant County,641,4,9,3,6,0,-6,-6,4,3,14.084507042,4.6948356808,9.3896713615,0.0,-9.389671362,-9.389671362
2016,Nebraska,Greeley County,2399,-32,30,31,-1,1,-32,-31,0,57,12.422360248,12.836438923,-0.414078675,0.4140786749,-13.2505176,-12.83643892
2016,Nebraska,Hall County,61705,283,998,540,458,302,-473,-171,-4,1132,16.210904188,8.771431124,7.4394730644,4.905504073,-7.683123929,-2.777619856
2016,Nebraska,Hamilton County,9186,7,88,75,13,2,-7,-5,-1,91,9.5834467738,8.1677103185,1.4157364552,0.2178056085,-0.76231963,-0.544514021
2016,Nebraska,Harlan County,3473,26,37,38,-1,1,18,19,8,47,10.693641618,10.98265896,-0.289017341,0.289017341,5.2023121387,5.4913294798
2016,Nebraska,Hayes County,897,-30,9,2,7,0,-35,-35,-2,0,9.8684210526,2.1929824561,7.6754385965,0.0,-38.37719298,-38.37719298
2016,Nebraska,Hitchcock County,2825,-57,32,43,-11,3,-56,-53,7,32,11.21429823,15.069213247,-3.854915017,1.0513404591,-19.6250219,-18.57368144
2016,Nebraska,Holt County,10250,-58,132,123,9,9,-75,-66,-1,154,12.84171612,11.966144567,0.8755715537,0.8755715537,-7.296429614,-6.42085806
2016,Nebraska,Hooker County,708,-25,8,15,-7,0,-21,-21,3,22,11.103400416,20.818875781,-9.715475364,0.0,-29.14642609,-29.14642609
2016,Nebraska,Howard County,6429,37,86,59,27,1,6,7,3,68,13.415490211,9.2036502613,4.2118399501,0.1559940722,0.9359644334,1.0919585056
2016,Nebraska,Jefferson County,7177,-66,69,82,-13,3,-55,-52,-1,96,9.5700416089,11.373092926,-1.803051318,0.4160887656,-7.628294036,-7.21220527
2016,Nebraska,Johnson County,5171,-16,44,50,-6,2,-9,-7,-3,1027,8.4958486194,9.6543734312,-1.158524812,0.3861749372,-1.737787218,-1.35161228
2016,Nebraska,Kearney County,6552,-28,80,71,9,-1,-45,-46,9,83,12.183978069,10.813280536,1.3706975327,-0.152299726,-6.853487664,-7.00578739
2016,Nebraska,Keith County,8018,-44,76,77,-1,3,-52,-49,6,42,9.4527363184,9.5771144279,-0.124378109,0.3731343284,-6.467661692,-6.094527363
2016,Nebraska,Keya Paha County,791,-12,8,4,4,0,-22,-22,6,0,10.037641154,5.0188205772,5.0188205772,0.0,-27.60351317,-27.60351317
2016,Nebraska,Kimball County,3679,-40,43,37,6,12,-59,-47,1,47,11.62476345,10.002703433,1.6220600162,3.2441200324,-15.95025683,-12.70613679
2016,Nebraska,Knox County,8571,45,114,102,12,6,27,33,0,229,13.335672925,11.93191788,1.4037550447,0.7018775224,3.1584488507,3.860326373
2016,Nebraska,Lancaster County,309637,3932,4065,2031,2034,1090,781,1871,27,14898,13.212164942,6.6012071336,6.6109578088,3.5427453351,2.538425786,6.0811711211
2016,Nebraska,Lincoln County,35550,-68,400,366,34,29,-109,-80,-22,592,11.241007194,10.285521583,0.9554856115,0.8149730216,-3.06317446,-2.248201439
2016,Nebraska,Logan County,772,-4,12,6,6,0,-17,-17,7,0,15.503875969,7.7519379845,7.7519379845,0.0,-21.96382429,-21.96382429
2016,Nebraska,Loup County,591,9,8,2,6,0,-1,-1,4,0,13.640238704,3.410059676,10.230179028,0.0,-1.705029838,-1.705029838
2016,Nebraska,McPherson County,493,16,4,2,2,0,14,14,0,0,8.2474226804,4.1237113402,4.1237113402,0.0,28.865979381,28.865979381
2016,Nebraska,Madison County,35015,-50,512,353,159,68,-260,-192,-17,1058,14.611872146,10.074200913,4.5376712329,1.9406392694,-7.420091324,-5.479452055
2016,Nebraska,Merrick County,7828,48,100,76,24,3,24,27,-3,196,12.813941568,9.738595592,3.0753459764,0.3844182471,3.0753459764,3.4597642235
2016,Nebraska,Morrill County,4787,-57,59,43,16,0,-86,-86,13,78,12.252102585,8.9294984944,3.322604091,0.0,-17.85899699,-17.85899699
2016,Nebraska,Nance County,3576,-20,41,32,9,0,-40,-40,11,143,11.433351924,8.9235917457,2.5097601785,0.0,-11.15448968,-11.15448968
2016,Nebraska,Nemaha County,6971,-54,66,67,-1,1,-71,-70,17,493,9.431266076,9.5741640469,-0.142897971,0.1428979708,-10.14575593,-10.00285796
2016,Nebraska,Nuckolls County,4265,-62,45,56,-11,4,-57,-53,2,50,10.474860335,13.03538175,-2.560521415,0.9310986965,-13.26815642,-12.33705773
2016,Nebraska,Otoe County,16081,124,206,169,37,32,56,88,-1,317,12.859729072,10.549971908,2.3097571634,1.997627817,3.4958486797,5.4934764967
2016,Nebraska,Pawnee County,2652,8,27,27,0,0,9,9,-1,35,10.196374622,10.196374622,0.0,0.0,3.3987915408,3.3987915408
2016,Nebraska,Perkins County,2898,-41,45,21,24,-1,-61,-62,-3,35,15.418879561,7.1954771287,8.2234024328,-0.342641768,-20.90114785,-21.24378962
2016,Nebraska,Phelps County,9266,-18,113,102,11,3,-28,-25,-4,253,12.18328841,10.997304582,1.1859838275,0.3234501348,-3.018867925,-2.69541779
2016,Nebraska,Pierce County,7159,-53,86,70,16,3,-72,-69,0,96,11.96854777,9.741841208,2.2267065618,0.4175074803,-10.02017953,-9.602672048
2016,Nebraska,Platte County,32861,62,493,273,220,53,-192,-139,-19,448,15.01675297,8.315565032,6.7011879379,1.6143770941,-5.848309473,-4.233932379
2016,Nebraska,Polk County,5203,11,47,50,-3,7,5,12,2,105,9.0428090428,9.62000962,-0.577200577,1.3468013468,0.962000962,2.3088023088
2016,Nebraska,Red Willow County,10722,-106,134,117,17,0,-120,-120,-3,397,12.436194896,10.858468677,1.5777262181,0.0,-11.13689095,-11.13689095
2016,Nebraska,Richardson County,8060,-22,84,119,-35,1,22,23,-10,151,10.407632264,14.744145707,-4.336513443,0.1239003841,2.72580845,2.8497088341
2016,Nebraska,Rock County,1390,10,12,13,-1,0,1,1,10,31,8.6642599278,9.3862815884,-0.722021661,0.0,0.7220216606,0.7220216606
2016,Nebraska,Saline County,14331,52,177,133,44,80,-65,15,-7,1008,12.37329605,9.2974484446,3.0758476057,5.5924501922,-4.543865781,1.048584411
2016,Nebraska,Sarpy County,179023,3333,2601,934,1667,332,1222,1554,112,1234,14.665377361,5.2662293178,9.3991480436,1.8719359031,6.8900773301,8.7620132332
2016,Nebraska,Saunders County,21038,21,231,206,25,15,-14,1,-5,336,10.985614077,9.7966948044,1.1889192724,0.7133515634,-0.665794793,0.0475567709
2016,Nebraska,Scotts Bluff County,36422,122,453,408,45,22,81,103,-26,850,12.458403234,11.220813509,1.2375897253,0.6050438657,2.2276615055,2.8327053711
2016,Nebraska,Seward County,17284,162,199,171,28,7,106,113,21,1362,11.567749811,9.9401267221,1.627623089,0.4069057722,6.1617159798,6.568621752
2016,Nebraska,Sheridan County,5234,20,58,60,-2,0,18,18,4,110,11.102603369,11.485451761,-0.382848392,0.0,3.4456355283,3.4456355283
2016,Nebraska,Sherman County,3054,-31,26,41,-15,0,-18,-18,2,55,8.4704349243,13.357224304,-4.886789379,0.0,-5.864147255,-5.864147255
2016,Nebraska,Sioux County,1242,-21,8,3,5,0,-29,-29,3,0,6.3872255489,2.3952095808,3.9920159681,0.0,-23.15369261,-23.15369261
2016,Nebraska,Stanton County,5944,36,67,32,35,3,3,6,-5,1,11.306108674,5.3999325008,5.9061761728,0.506243672,0.506243672,1.0124873439
2016,Nebraska,Thayer County,5101,-44,53,75,-22,0,-24,-24,2,149,10.345500683,14.639859457,-4.294358774,0.0,-4.684755026,-4.684755026
2016,Nebraska,Thomas County,716,30,8,3,5,2,20,22,3,2,11.412268188,4.2796005706,7.1326676177,2.8530670471,28.530670471,31.383737518
2016,Nebraska,Thurston County,7127,58,165,82,83,1,-27,-26,1,50,23.245984784,11.552550014,11.69343477,0.1408847563,-3.803888419,-3.663003663
2016,Nebraska,Valley County,4184,31,53,47,6,1,26,27,-2,45,12.714405662,11.275038983,1.4393666787,0.2398944464,6.2372556075,6.477150054
2016,Nebraska,Washington County,20603,330,215,174,41,18,262,280,9,529,10.519620315,8.5135531852,2.0060671299,0.8807123985,12.819258244,13.699970643
2016,Nebraska,Wayne County,9365,0,90,51,39,18,-60,-42,3,1046,9.6102509343,5.4458088628,4.1644420715,1.9220501869,-6.406833956,-4.484783769
2016,Nebraska,Webster County,3603,-32,34,59,-25,0,-7,-7,0,156,9.3948604587,16.30284609,-6.907985631,0.0,-1.934235977,-1.934235977
2016,Nebraska,Wheeler County,776,23,8,3,5,0,16,16,2,0,10.464355788,3.9241334205,6.5402223676,0.0,20.928711576,20.928711576
2016,Nebraska,York County,13794,-28,179,136,43,12,-83,-71,0,787,12.963499421,9.8493626883,3.1141367323,0.8690614137,-6.011008111,-5.141946698
2016,Nevada,Nevada,2940058,56300,36462,23771,12691,7392,34575,41967,1642,37920,12.521686812,8.1633760407,4.3583107708,2.5385417396,11.873658096,14.412199836
2016,Nevada,Churchill County,24198,39,347,252,95,47,-114,-67,11,342,14.351593358,10.422482784,3.9291105734,1.9438757574,-4.714932688,-2.771056931
2016,Nevada,Clark County,2155664,46375,27352,16501,10851,6566,27735,34301,1223,23321,12.826401604,7.7379516257,5.0884499782,3.0790491712,13.00600499,16.085054161
2016,Nevada,Douglas County,48020,392,363,510,-147,9,497,506,33,229,7.5903312145,10.664101706,-3.073770492,0.1881900301,10.392271663,10.580461693
2016,Nevada,Elko County,52168,372,763,335,428,53,-119,-66,10,849,14.678157824,6.4445384941,8.2336193298,1.0195837021,-2.289253973,-1.26967027
2016,Nevada,Esmeralda County,790,-17,4,3,1,0,-24,-24,6,1,5.0093926111,3.7570444584,1.2523481528,0.0,-30.05635567,-30.05635567
2016,Nevada,Eureka County,1917,-110,18,8,10,0,-133,-133,13,1,9.1277890467,4.0567951318,5.0709939148,0.0,-67.44421907,-67.44421907
2016,Nevada,Humboldt County,16842,-160,258,103,155,23,-334,-311,-4,183,15.246424772,6.0867509751,9.1596737974,1.3591774022,-19.73761967,-18.37844226
2016,Nevada,Lander County,5702,-177,90,30,60,5,-258,-253,16,16,15.542699249,5.1808997496,10.361799499,0.8634832916,-44.55573785,-43.69225455
2016,Nevada,Lincoln County,5055,7,41,50,-9,0,15,15,1,259,8.116401069,9.8980500841,-1.781649015,0.0,2.9694150252,2.9694150252
2016,Nevada,Lyon County,53179,840,563,591,-28,6,821,827,41,360,10.671165109,11.201880248,-0.530715139,0.1137246726,15.56132603,15.675050702
2016,Nevada,Mineral County,4449,-3,42,101,-59,17,26,43,13,52,9.4371418942,22.694079317,-13.25693742,3.8197955286,5.8420402202,9.6618357488
2016,Nevada,Nye County,43423,337,367,663,-296,37,579,616,17,1173,8.4846663353,15.32788496,-6.843218625,0.8554023281,13.385890485,14.241292813
2016,Nevada,Pershing County,6560,-39,61,44,17,0,-57,-57,1,1690,9.2712212174,6.6874382552,2.5837829622,0.0,-8.663272285,-8.663272285
2016,Nevada,Storey County,4051,84,12,15,-3,0,88,88,-1,5,2.9932651534,3.7415814418,-0.748316288,0.0,21.950611125,21.950611125
2016,Nevada,Washoe County,453616,8156,5489,3820,1669,630,5648,6278,209,5300,12.2103137,8.497613105,3.7127005948,1.4014388105,12.564010162,13.965448972
2016,Nevada,White Pine County,9682,-133,113,87,26,0,-163,-163,4,1329,11.591526902,8.9244499154,2.6670769862,0.0,-16.72052111,-16.72052111
2016,Nevada,Carson City,54742,337,579,658,-79,-1,368,367,49,2810,10.609544926,12.057133957,-1.447589031,-0.018323912,6.7431995382,6.7248756264
2016,New Hampshire,New Hampshire,1334795,4684,12274,11572,702,2175,2187,4362,-380,42396,9.211581947,8.6847340957,0.5268478513,1.6323277444,1.6413336906,3.273661435
2016,New Hampshire,Belknap County,60779,352,507,739,-232,49,482,531,53,893,8.3659224791,12.194115803,-3.828193324,0.8085408313,7.9534016468,8.7619424781
2016,New Hampshire,Carroll County,47289,67,352,547,-195,21,271,292,-30,437,7.4488683857,11.575372179,-4.126503793,0.4443927162,5.7347821947,6.1791749109
2016,New Hampshire,Cheshire County,75774,-315,639,693,-54,54,-268,-214,-47,4715,8.4154797416,9.1266470437,-0.711167302,0.7111673021,-3.529496981,-2.818329679
2016,New Hampshire,Coos County,32039,-254,244,420,-176,3,-49,-46,-32,2570,7.5856494435,13.057265436,-5.471615992,0.0932661817,-1.523347634,-1.430081452
2016,New Hampshire,Grafton County,88888,89,764,781,-17,220,-66,154,-48,6621,8.5993910641,8.790738771,-0.191347707,2.4762644425,-0.742879333,1.7333851098
2016,New Hampshire,Hillsborough County,407761,1746,4146,3267,879,1095,-97,998,-131,7980,10.189536187,8.0292365467,2.1602996402,2.6911582549,-0.238394841,2.452763414
2016,New Hampshire,Merrimack County,148582,488,1348,1315,33,303,179,482,-27,6939,9.0873545551,8.8648896439,0.2224649112,2.0426323666,1.2067036093,3.2493359759
2016,New Hampshire,Rockingham County,303251,1611,2678,2378,300,217,1191,1408,-97,2507,8.8544878333,7.8625735876,0.9919142457,0.7174846377,3.9378995555,4.6553841932
2016,New Hampshire,Strafford County,127428,924,1212,1006,206,180,545,725,-7,8969,9.5458626719,7.9233810626,1.6224816092,1.417702377,4.2924877526,5.7101901296
2016,New Hampshire,Sullivan County,43004,-24,384,426,-42,33,-1,32,-14,765,8.9269109169,9.9032917984,-0.976380882,0.7671564069,-0.023247164,0.7439092431
2016,New Jersey,New Jersey,8944469,9048,102166,74762,27404,50087,-66791,-16704,-1652,185907,11.428034513,8.3626912694,3.0653432432,5.6026071749,-7.471075046,-1.868467871
2016,New Jersey,Atlantic County,270991,-2044,3019,2779,240,1518,-3718,-2200,-84,6219,11.098734252,10.21642348,0.8823107719,5.5806156323,-13.66846437,-8.087848743
2016,New Jersey,Bergen County,939151,3141,9338,7176,2162,5733,-4630,1103,-124,10419,9.959678129,7.6537427986,2.3059353304,6.1146749532,-4.938242636,1.176432317
2016,New Jersey,Burlington County,449284,-391,4427,4061,366,954,-1412,-458,-299,13267,9.8491699844,9.0348948061,0.8142751783,2.1224549729,-3.141411344,-1.018956371
2016,New Jersey,Camden County,510150,-145,6242,4735,1507,1692,-3033,-1341,-311,7786,12.233878357,9.2802649824,2.9536133746,3.3162002852,-5.944465405,-2.62826512
2016,New Jersey,Cape May County,94430,-413,941,1308,-367,229,-199,30,-76,2613,9.9433093997,13.821305733,-3.877996333,2.419785178,-2.102782753,0.3170024251
2016,New Jersey,Cumberland County,153797,-1444,2053,1443,610,477,-2511,-2034,-20,10782,13.286391965,9.3386573819,3.9477345828,3.0869990098,-16.25042875,-13.16342974
2016,New Jersey,Essex County,796914,1875,10134,6307,3827,5488,-7674,-2186,234,23409,12.731531647,7.9236007596,4.8079308874,6.8946759107,-9.640988145,-2.746312234
2016,New Jersey,Gloucester County,292330,224,3097,2641,456,391,-532,-141,-91,4230,10.59825199,9.0377731693,1.5604788206,1.3380421466,-1.820558624,-0.482516477
2016,New Jersey,Hudson County,677983,4218,10098,4204,5894,9931,-11970,-2039,363,9472,14.940654619,6.2200942779,8.7205603411,14.693567144,-17.71040164,-3.016834499
2016,New Jersey,Hunterdon County,124676,-714,921,962,-41,161,-781,-620,-53,3567,7.3660553614,7.6939687922,-0.327913431,1.2876600577,-6.246350963,-4.958690906
2016,New Jersey,Mercer County,371023,-176,4193,2974,1219,2572,-3966,-1394,-1,20531,11.298506377,8.0137748544,3.2847315224,6.9305409972,-10.68682955,-3.75628855
2016,New Jersey,Middlesex County,837073,994,9407,6221,3186,7502,-9317,-1815,-377,23413,11.244644838,7.4362640095,3.8083808285,8.967505642,-11.13706346,-2.169557817
2016,New Jersey,Monmouth County,625846,-929,5812,5741,71,1100,-1845,-745,-255,7357,9.2797422365,9.1663799346,0.1133623019,1.7563173538,-2.945823198,-1.189505844
2016,New Jersey,Morris County,498423,4,4572,3797,775,2216,-2823,-607,-164,8703,9.1729682337,7.6180578266,1.5549104071,4.4460405962,-5.663886554,-1.217845958
2016,New Jersey,Ocean County,592497,3706,8359,7108,1251,630,1967,2597,-142,7177,14.152348961,12.034321859,2.1180271026,1.0666323538,3.3302632381,4.3968955919
2016,New Jersey,Passaic County,507945,-453,6719,3734,2985,3692,-7191,-3499,61,11052,13.221914255,7.3479130569,5.8740011984,7.2652637938,-14.15073455,-6.885470752
2016,New Jersey,Salem County,63436,-505,681,770,-89,34,-417,-383,-33,1258,10.692668221,12.090094758,-1.397426537,0.53384834,-6.547492875,-6.013644536
2016,New Jersey,Somerset County,333751,736,3234,2535,699,1786,-1569,217,-180,4113,9.7005546174,7.6038670238,2.0966875935,5.3572017769,-4.706298761,0.6509030155
2016,New Jersey,Sussex County,142522,-863,1236,1241,-5,123,-888,-765,-93,1743,8.6461681596,8.681144568,-0.034976408,0.8604196469,-6.211810134,-5.351390487
2016,New Jersey,Union County,555630,2681,6699,4097,2602,3636,-3597,39,40,6825,12.085742198,7.3914443626,4.6942978353,6.559749012,-6.489388668,0.0703603442
2016,New Jersey,Warren County,106617,-454,984,928,56,222,-685,-463,-47,1971,9.2096888922,8.6855602561,0.5241286361,2.0777956647,-6.411216353,-4.333420688
2016,New Mexico,New Mexico,2081015,687,25491,17799,7692,2637,-9748,-7111,106,43127,12.251333284,8.5544498495,3.696883434,1.2673793052,-4.685025964,-3.417646659
2016,New Mexico,Bernalillo County,676953,1994,7838,5755,2083,987,-948,39,-128,11946,11.595429288,8.5138677665,3.0815615218,1.4601542112,-1.402458148,0.0576960631
2016,New Mexico,Catron County,3508,49,23,23,0,0,41,41,8,106,6.6025549017,6.6025549017,0.0,0.0,11.769771781,11.769771781
2016,New Mexico,Chaves County,65282,-247,912,617,295,13,-578,-565,23,1783,13.943781486,9.4334574309,4.5103240553,0.1987600431,-8.837177302,-8.638417258
2016,New Mexico,Cibola County,27487,165,365,282,83,27,71,98,-16,2567,13.318980459,10.290280793,3.0286996661,0.9852396504,2.590815377,3.5760550275
2016,New Mexico,Colfax County,12253,-134,125,144,-19,10,-131,-121,6,408,10.146103896,11.688311688,-1.542207792,0.8116883117,-10.63311688,-9.821428571
2016,New Mexico,Curry County,50280,74,875,403,472,164,-535,-371,-27,1511,17.415361344,8.0210178532,9.3943434906,3.2641362976,-10.64824951,-7.38411321
2016,New Mexico,De Baca County,1793,-38,14,19,-5,3,-42,-39,6,9,7.7262693157,10.485651214,-2.759381898,1.6556291391,-23.17880795,-21.52317881
2016,New Mexico,Doña Ana County,214207,640,2854,1567,1287,121,-841,-720,73,4582,13.343494462,7.326298466,6.017195996,0.5657192817,-3.931982776,-3.366263494
2016,New Mexico,Eddy County,57621,10,918,547,371,47,-393,-346,-15,995,15.933074146,9.4938905859,6.4391835601,0.8157456262,-6.821021938,-6.005276312
2016,New Mexico,Grant County,28280,-284,295,338,-43,25,-245,-220,-21,589,10.379283654,11.892196186,-1.512912533,0.8796003096,-8.620083034,-7.740482725
2016,New Mexico,Guadalupe County,4376,12,37,36,1,0,10,10,1,572,8.466819222,8.23798627,0.2288329519,0.0,2.2883295195,2.2883295195
2016,New Mexico,Harding County,665,-34,6,7,-1,0,-35,-35,2,0,8.7976539589,10.263929619,-1.46627566,0.0,-51.31964809,-51.31964809
2016,New Mexico,Hidalgo County,4302,-112,48,47,1,0,-112,-112,-1,64,11.014226709,10.784763653,0.2294630564,0.0,-25.69986232,-25.69986232
2016,New Mexico,Lea County,69749,-1099,1200,499,701,62,-1840,-1778,-22,2071,17.070065506,7.0983022397,9.9717632666,0.8819533845,-26.17410044,-25.29214706
2016,New Mexico,Lincoln County,19429,38,182,196,-14,-1,67,66,-14,116,9.3766099948,10.097887687,-0.721277692,-0.051519835,3.4518289541,3.400309119
2016,New Mexico,Los Alamos County,18147,451,172,106,66,69,319,388,-3,94,9.597410931,5.9146834807,3.6827274503,3.8501241526,17.799849343,21.649973496
2016,New Mexico,Luna County,24450,-26,402,286,116,-9,-122,-131,-11,551,16.432980419,11.691125373,4.7418550464,-0.367902547,-4.987123411,-5.355025958
2016,New Mexico,McKinley County,74923,-1877,1091,580,511,112,-2512,-2400,12,774,14.381471497,7.6455118868,6.7359596106,1.4763747092,-33.11297562,-31.63660091
2016,New Mexico,Mora County,4504,-73,39,33,6,-1,-85,-86,7,8,8.589362405,7.267922035,1.32144037,-0.220240062,-18.72040524,-18.9406453
2016,New Mexico,Otero County,65410,980,892,602,290,458,264,722,-32,2272,13.739987677,9.2729513247,4.4670363524,7.0548367221,4.0665434381,11.12138016
2016,New Mexico,Quay County,8365,-87,84,100,-16,-1,-86,-87,16,22,9.9898911815,11.892727597,-1.902836416,-0.118927276,-10.22774573,-10.34667301
2016,New Mexico,Rio Arriba County,40040,514,506,443,63,49,382,431,20,425,12.719000578,11.135409597,1.5835909811,1.2316818742,9.6020913455,10.83377322
2016,New Mexico,Roosevelt County,19082,8,285,145,140,28,-156,-128,-4,1078,14.938672817,7.6003773981,7.3382954188,1.4676590838,-8.176957752,-6.709298669
2016,New Mexico,Sandoval County,142025,2868,1469,1051,418,21,2263,2284,166,761,10.448748497,7.4755852082,2.9731632893,0.1493694475,16.096336181,16.245705628
2016,New Mexico,San Juan County,115079,-3622,1703,1026,677,42,-4341,-4299,0,1748,14.569253144,8.7774831038,5.7917700402,0.3593121738,-37.13747968,-36.77816751
2016,New Mexico,San Miguel County,27760,-191,275,278,-3,70,-266,-196,8,1299,9.8723770889,9.9800757481,-0.107698659,2.5129687135,-9.549281111,-7.036312398
2016,New Mexico,Santa Fe County,148651,943,1280,1138,142,219,490,709,92,2631,8.6381719469,7.6798747465,0.9582972004,1.4779372315,3.3068001984,4.7847374299
2016,New Mexico,Sierra County,11191,-70,107,229,-122,-1,47,46,6,265,9.5314448601,20.399073579,-10.86762872,-0.089078924,4.1867094246,4.0976305006
2016,New Mexico,Socorro County,17027,-195,200,156,44,32,-263,-231,-8,580,11.679173115,9.1097550293,2.5694180852,1.8686676983,-15.35811265,-13.48944495
2016,New Mexico,Taos County,33065,178,290,309,-19,34,198,232,-35,470,8.794274624,9.3704512373,-0.576176613,1.0310528869,6.0043668122,7.0354196992
2016,New Mexico,Torrance County,15302,-120,140,138,2,22,-158,-136,14,614,9.1133966931,8.9832053118,0.1301913813,1.4321051946,-10.28511913,-8.85301393
2016,New Mexico,Union County,4183,-18,39,41,-2,0,-17,-17,1,665,9.3034351145,9.7805343511,-0.477099237,0.0,-4.055343511,-4.055343511
2016,New Mexico,Valencia County,75626,-10,825,658,167,35,-194,-159,-18,1551,10.908225463,8.7001361875,2.2080892756,0.4627732015,-2.565085745,-2.102312544
2016,New York,New York,19745289,-1894,236507,160713,75794,118478,-191367,-72889,-4799,575964,11.97732064,8.1389182222,3.8384024176,6.0000295753,-9.691315347,-3.691285772
2016,New York,Albany County,308846,414,3107,2760,347,1327,-1057,270,-203,17415,10.066777044,8.9424862056,1.1242908382,4.2995214474,-3.424713014,0.8748084332
2016,New York,Allegany County,47077,-330,495,456,39,70,-442,-372,3,4292,10.477964523,9.6524279243,0.8255365988,1.4817323568,-9.356081453,-7.874349096
2016,New York,Bronx County,1455720,6524,21403,10618,10785,17198,-20956,-3758,-503,44245,14.735710086,7.3103662894,7.4253437965,11.840617767,-14.42795592,-2.587338154
2016,New York,Broome County,195334,-1284,2084,2152,-68,597,-1727,-1130,-86,10784,10.633955178,10.980936441,-0.346981263,3.0462913826,-8.812303547,-5.766012165
2016,New York,Cattaraugus County,77677,-232,898,836,62,56,-323,-267,-27,2608,11.543455067,10.746468191,0.7969868754,0.7198591133,-4.152044528,-3.432185415
2016,New York,Cayuga County,77861,-455,764,697,67,84,-634,-550,28,4109,9.7837709778,8.9257701198,0.858000858,1.0757025682,-8.118993194,-7.043290625
2016,New York,Chautauqua County,129504,-1307,1421,1392,29,258,-1561,-1303,-33,5995,10.917542208,10.694735225,0.2228069838,1.9822138563,-11.99316213,-10.01094827
2016,New York,Chemung County,86322,-798,955,950,5,98,-846,-748,-55,4616,11.012326887,10.954670726,0.0576561617,1.1300607696,-9.755422562,-8.625361792
2016,New York,Chenango County,48579,-400,545,558,-13,20,-372,-352,-35,789,11.172840772,11.4393489,-0.266508128,0.4100125054,-7.6262326,-7.216220095
2016,New York,Clinton County,81073,-81,744,724,20,142,-184,-42,-59,6782,9.1723325957,8.9257645152,0.2465680805,1.7506333718,-2.268426341,-0.517792969
2016,New York,Columbia County,60989,-502,465,656,-191,68,-340,-272,-39,2139,7.5930764206,10.711952972,-3.118876551,1.110385369,-5.551926845,-4.441541476
2016,New York,Cortland County,48070,-359,465,422,43,20,-405,-385,-17,3798,9.637405569,8.7462046239,0.8912009451,0.4145120675,-8.393869367,-7.979357299
2016,New York,Delaware County,45523,-551,382,570,-188,29,-388,-359,-4,2406,8.3408845268,12.445822461,-4.104937935,0.6332085112,-8.471893184,-7.838684673
2016,New York,Dutchess County,294473,-755,2665,2616,49,844,-1469,-625,-179,19656,9.0384788223,8.8722929078,0.1661859146,2.8624675895,-4.982185887,-2.119718298
2016,New York,Erie County,921046,-1911,10118,9803,315,3477,-5232,-1755,-471,28380,10.973951778,10.632303744,0.3416480342,3.7711435394,-5.674611158,-1.903467619
2016,New York,Essex County,38102,-269,289,420,-131,71,-174,-103,-35,2387,7.5582231637,10.984268958,-3.426045794,1.8568645143,-4.550625711,-2.693761197
2016,New York,Franklin County,50409,-93,434,500,-66,55,-78,-23,-4,6070,8.6016390681,9.9097224287,-1.308083361,1.0900694672,-1.545916699,-0.455847232
2016,New York,Fulton County,53828,-132,515,580,-65,32,-54,-22,-45,1402,9.5557947081,10.761865885,-1.206071177,0.5937581178,-1.001966824,-0.408208706
2016,New York,Genesee County,58482,-328,622,641,-19,68,-338,-270,-39,1967,10.606008935,10.9299867,-0.323977765,1.1594993691,-5.763393923,-4.603894554
2016,New York,Greene County,47508,-187,409,530,-121,74,-143,-69,3,3206,8.5921662132,11.134102917,-2.541936704,1.5545728601,-3.004107013,-1.449534153
2016,New York,Hamilton County,4542,-156,34,67,-33,0,-137,-137,14,80,7.3593073593,14.502164502,-7.142857143,0.0,-29.65367965,-29.65367965
2016,New York,Herkimer County,62613,-311,631,672,-41,32,-330,-298,28,1410,10.052813115,10.706006994,-0.653193879,0.5098098569,-5.257414149,-4.747604292
2016,New York,Jefferson County,114006,-3254,2000,945,1055,345,-4674,-4329,20,6199,17.296100594,8.1724075307,9.1236930634,2.9835773525,-40.42098709,-37.43740974
2016,New York,Kings County,2629150,4209,41434,17443,23991,22955,-43264,-20309,527,36031,15.772090738,6.6397784127,9.1323123258,8.7379529589,-16.46869078,-7.730737819
2016,New York,Lewis County,26865,-157,342,279,63,24,-234,-210,-10,313,12.693228422,10.355002134,2.3382262883,0.8907528718,-8.6848405,-7.794087628
2016,New York,Livingston County,64257,-326,513,534,-21,91,-380,-289,-16,6123,7.9633654145,8.2893511332,-0.325985719,1.4126047811,-5.898789196,-4.486184415
2016,New York,Madison County,71329,-442,641,594,47,42,-543,-501,12,4590,8.9587700908,8.3018867925,0.6568832984,0.5870020964,-7.589098532,-7.002096436
2016,New York,Monroe County,747727,-1321,8301,6717,1584,2801,-5376,-2575,-330,26560,11.091847472,8.9752968883,2.1165505838,3.7427135007,-7.183444405,-3.440730905
2016,New York,Montgomery County,49276,-397,608,556,52,118,-560,-442,-7,893,12.289159062,11.238112563,1.0510464987,2.3850670547,-11.31896229,-8.933895239
2016,New York,Nassau County,1361500,1798,14324,11354,2970,4377,-5090,-713,-459,20784,10.527700626,8.344841728,2.1828588984,3.2169607401,-3.74099387,-0.524033129
2016,New York,New York County,1643734,2566,18348,11403,6945,17217,-21557,-4340,-39,66726,11.171109519,6.9426728712,4.2284366474,10.482504501,-13.12489688,-2.642392376
2016,New York,Niagara County,211758,-764,2123,2364,-241,207,-557,-350,-173,4081,10.007542189,11.143584425,-1.136042236,0.9757707175,-2.625624588,-1.64985387
2016,New York,Oneida County,231190,-835,2446,2514,-68,791,-1429,-638,-129,12879,10.560970608,10.854570772,-0.293600164,3.4152607321,-6.169921095,-2.754660363
2016,New York,Onondaga County,466194,-2081,5214,4246,968,1936,-4775,-2839,-210,17057,11.159278692,9.0875138715,2.0717648204,4.1435296409,-10.21970766,-6.076178022
2016,New York,Ontario County,109828,174,1083,1072,11,171,28,199,-36,3381,9.8686908266,9.7684548163,0.1002360102,1.558214341,0.2551462079,1.8133605489
2016,New York,Orange County,379210,2080,4911,2784,2127,678,-520,158,-205,11407,12.986223127,7.3617685168,5.6244546104,1.7928444879,-1.37504297,0.4178015178
2016,New York,Orleans County,41346,-258,409,417,-8,50,-289,-239,-11,2743,9.8613622664,10.054249548,-0.192887281,1.2055455093,-6.968053044,-5.762507535
2016,New York,Oswego County,118987,-975,1236,1072,164,83,-1194,-1111,-28,4943,10.34530381,8.9726259578,1.3726778518,0.6947089128,-9.99376436,-9.299055447
2016,New York,Otsego County,60097,-433,527,627,-100,44,-343,-299,-34,5357,8.7376789608,10.395682559,-1.658003598,0.7295215831,-5.686952341,-4.957430758
2016,New York,Putnam County,98900,-365,832,713,119,161,-624,-463,-21,2569,8.3970428683,7.1960235158,1.2010193526,1.6249085358,-6.297782151,-4.672873615
2016,New York,Queens County,2333054,5826,30127,15658,14469,26295,-35335,-9040,397,27682,12.929260504,6.7197650271,6.2094954769,11.28472483,-15.16431838,-3.879593552
2016,New York,Rensselaer County,160070,-31,1683,1588,95,429,-467,-38,-88,5868,10.513132045,9.9196991608,0.5934328843,2.6798179723,-2.917191126,-0.237373154
2016,New York,Richmond County,476015,2046,5281,3977,1304,1356,-299,1057,-315,7042,11.118081989,8.3727725941,2.7453093947,2.8547849227,-0.629484286,2.2253006366
2016,New York,Rockland County,326780,1289,5296,2408,2888,1492,-3009,-1517,-82,6998,16.238649273,7.3834341861,8.855215087,4.5747856336,-9.226226522,-4.651440889
2016,New York,St. Lawrence County,110038,-897,1084,1068,16,226,-1084,-858,-55,11335,9.8111533988,9.6663393265,0.1448140723,2.0454987713,-9.811153399,-7.765654627
2016,New York,Saratoga County,227053,913,2251,1931,320,397,283,680,-87,3416,9.9339574971,8.5217556317,1.4122018654,1.7520129393,1.2489160247,3.000928964
2016,New York,Schenectady County,154553,-205,1853,1491,362,408,-877,-469,-98,4532,11.98146849,9.6407822548,2.3406862349,2.6381215023,-5.670668033,-3.032546531
2016,New York,Schoharie County,31317,-55,264,288,-24,34,-79,-45,14,1420,8.4225302685,9.1882148383,-0.76568457,1.0847198073,-2.520378376,-1.435658568
2016,New York,Schuyler County,18099,-100,153,186,-33,15,-85,-70,3,216,8.4302165409,10.24849854,-1.818281999,0.8264918177,-4.683453634,-3.856961816
2016,New York,Seneca County,34777,-71,386,326,60,27,-150,-123,-8,2806,11.087971275,9.3644524237,1.723518851,0.7755834829,-4.308797127,-3.533213645
2016,New York,Steuben County,96940,-606,1064,1017,47,67,-652,-585,-68,1751,10.941661611,10.458336333,0.4833252779,0.6889956089,-6.704852791,-6.015857183
2016,New York,Suffolk County,1492583,-5320,15446,12793,2653,4327,-11278,-6951,-1022,28655,10.330093503,8.5557999603,1.7742935429,2.8938440106,-7.542586723,-4.648742713
2016,New York,Sullivan County,74801,50,754,760,-6,203,-149,54,2,3822,10.083449235,10.163688884,-0.080239649,2.7147747941,-1.992617952,0.7221568418
2016,New York,Tioga County,48760,-501,516,454,62,-5,-532,-537,-26,502,10.528356169,9.2633211251,1.2650350435,-0.102018955,-10.85481682,-10.95683578
2016,New York,Tompkins County,104871,307,854,631,223,1153,-1039,114,-30,13242,8.1552749063,6.0257359085,2.1295389978,11.010576074,-9.921932819,1.0886432545
2016,New York,Ulster County,179225,-599,1491,1723,-232,407,-639,-232,-135,11612,8.3052730964,9.5975758183,-1.292302722,2.2671000337,-3.559402756,-1.292302722
2016,New York,Warren County,64567,23,563,657,-94,33,87,120,-3,645,8.7211779012,10.177289309,-1.456111408,0.5111880475,1.3476775798,1.8588656273
2016,New York,Washington County,61800,-438,560,664,-104,26,-368,-342,8,3113,9.0294909624,10.706396427,-1.676905464,0.4192263661,-5.93366549,-5.514439123
2016,New York,Wayne County,90798,-542,968,843,125,79,-756,-677,10,1114,10.629303056,9.256717434,1.3725856219,0.867474113,-8.301397841,-7.433923728
2016,New York,Westchester County,974542,1642,10517,7395,3122,4743,-5930,-1187,-293,27930,10.800835147,7.594577913,3.2062572338,4.8710051442,-6.090040166,-1.219035021
2016,New York,Wyoming County,40791,-213,378,335,43,27,-262,-235,-21,3830,9.242618742,8.1912097316,1.0514090103,0.660187053,-6.406259551,-5.746072498
2016,New York,Yates County,24923,-128,281,266,15,28,-176,-148,5,1261,11.245847841,10.645535679,0.6003121623,1.120582703,-7.043662705,-5.923080002
2016,North Carolina,North Carolina,10146788,111602,120778,89721,31057,20494,59584,80078,467,255962,11.968898582,8.8912016238,3.0776969587,2.0309212568,5.9046751324,7.9355963891
2016,North Carolina,Alamance County,159688,1831,1788,1638,150,193,1455,1648,33,4620,11.261396023,10.316648034,0.9447479885,1.2155757452,9.1640554882,10.379631233
2016,North Carolina,Alexander County,37428,124,340,413,-73,14,181,195,2,1327,9.0991810737,11.052828775,-1.953647701,0.3746721619,4.8439758069,5.2186479687
2016,North Carolina,Alleghany County,10848,36,104,140,-36,8,67,75,-3,110,9.6029547553,12.927054478,-3.324099723,0.7386888273,6.1865189289,6.9252077562
2016,North Carolina,Anson County,25448,-184,226,321,-95,14,-100,-86,-3,2651,8.8488645262,12.568519969,-3.719655442,0.5481597494,-3.915426782,-3.367267032
2016,North Carolina,Ashe County,26924,24,212,358,-146,31,121,152,18,328,7.8775267539,13.302615933,-5.42508918,1.151902497,4.4961355529,5.6480380499
2016,North Carolina,Avery County,17516,-76,130,216,-86,20,-3,17,-7,2419,7.4057194941,12.304887775,-4.899168281,1.1393414606,-0.170901219,0.9684402415
2016,North Carolina,Beaufort County,47526,-17,462,622,-160,26,156,182,-39,523,9.71925654,13.085232831,-3.365976291,0.5469711473,3.2818268836,3.8287980309
2016,North Carolina,Bertie County,19854,-436,160,262,-102,16,-344,-328,-6,1674,7.9713033081,13.053009167,-5.081705859,0.7971303308,-17.13830211,-16.34117178
2016,North Carolina,Bladen County,33741,-525,347,463,-116,39,-446,-407,-2,353,10.204831856,13.616245387,-3.411413531,1.1469407561,-13.11629685,-11.9693561
2016,North Carolina,Brunswick County,126953,4331,1081,1400,-319,40,4011,4051,599,857,8.6627266353,11.219072423,-2.556345788,0.3205449264,32.142642492,32.463187419
2016,North Carolina,Buncombe County,256088,3280,2614,2643,-29,162,3009,3171,138,7884,10.27321889,10.387191096,-0.113972207,0.636672326,11.825598944,12.46227127
2016,North Carolina,Burke County,88851,147,889,1018,-129,103,252,355,-79,2527,10.013798541,11.466869421,-1.453070879,1.1602038805,2.8385570668,3.9987609473
2016,North Carolina,Cabarrus County,201590,5082,2439,1632,807,181,4018,4199,76,1416,12.253264272,8.1989861793,4.0542780923,0.9093238348,20.185984356,21.09530819
2016,North Carolina,Caldwell County,81449,167,812,916,-104,32,299,331,-60,977,9.9796596838,11.257842697,-1.278183014,0.3932870811,3.6747761643,4.0680632455
2016,North Carolina,Camden County,10418,139,97,63,34,12,93,105,0,17,9.3733391313,6.0878388172,3.2855003141,1.1595883461,8.9868096826,10.146398029
2016,North Carolina,Carteret County,68890,27,582,831,-249,86,216,302,-26,986,8.4499067171,12.065072993,-3.615166276,1.2486116455,3.1360478538,4.3846594992
2016,North Carolina,Caswell County,22910,-102,197,246,-49,29,-65,-36,-17,1288,8.5797656896,10.713819085,-2.134053395,1.2630111929,-2.830887156,-1.567875964
2016,North Carolina,Catawba County,156459,866,1776,1695,81,231,531,762,23,2386,11.382718265,10.86357402,0.5191442452,1.480522477,3.4032789407,4.8838014177
2016,North Carolina,Chatham County,72243,1473,633,735,-102,51,1369,1420,155,786,8.8523420948,10.278785845,-1.42644375,0.7132218749,19.145112682,19.858334557
2016,North Carolina,Cherokee County,27905,768,212,311,-99,8,850,858,9,442,7.703208459,11.300461466,-3.597253007,0.2906871117,30.885505614,31.176192726
2016,North Carolina,Chowan County,14383,11,139,207,-68,26,40,66,13,251,9.6678838463,14.397496088,-4.729612241,1.8083811511,2.7821248479,4.590505999
2016,North Carolina,Clay County,10915,160,80,135,-55,14,185,199,16,110,7.3834794647,12.459621597,-5.076142132,1.2921089063,17.074296262,18.366405168
2016,North Carolina,Cleveland County,97144,220,1068,1242,-174,73,367,440,-46,2094,11.006451347,12.799637241,-1.793185894,0.752313622,3.7821794423,4.5344930643
2016,North Carolina,Columbus County,56505,-422,599,700,-101,17,-294,-277,-44,3185,10.56139361,12.342196206,-1.780802595,0.2997390507,-5.183722406,-4.883983356
2016,North Carolina,Craven County,103445,18,1438,1041,397,292,-666,-374,-5,5006,13.902316408,10.064194284,3.8381221238,2.8230016629,-6.438764067,-3.615762404
2016,North Carolina,Cumberland County,327127,1546,5395,2562,2833,1337,-2541,-1204,-83,9059,16.531128774,7.8503710695,8.6807577048,4.096778345,-7.786023766,-3.689245421
2016,North Carolina,Currituck County,25809,578,264,195,69,7,517,524,-15,189,10.344827586,7.6410658307,2.7037617555,0.2742946708,20.25862069,20.532915361
2016,North Carolina,Dare County,35964,378,351,302,49,7,326,333,-4,145,9.8113207547,8.4416491964,1.3696715584,0.1956673655,9.1125087352,9.3081761006
2016,North Carolina,Davidson County,164926,730,1748,1841,-93,86,761,847,-24,1664,10.622200886,11.187340864,-0.565139978,0.5226025608,4.6244249853,5.147027546
2016,North Carolina,Davie County,42013,317,379,429,-50,25,348,373,-6,370,9.0551792519,10.249793929,-1.194614677,0.5973073385,8.3145181522,8.9118254907
2016,North Carolina,Duplin County,58969,299,745,561,184,88,69,157,-42,373,12.665867612,9.5376533293,3.1282142827,1.496102483,1.173080356,2.669182839
2016,North Carolina,Durham County,306212,5639,4395,2041,2354,1566,1606,3172,113,12904,14.486185387,6.7272592434,7.7589261435,5.1616305611,5.2934729764,10.455103537
2016,North Carolina,Edgecombe County,53318,-513,601,638,-37,20,-471,-451,-25,878,11.2180235,11.908650571,-0.690627071,0.3733119301,-8.791495954,-8.418184024
2016,North Carolina,Forsyth County,371511,3492,4434,3244,1190,582,1907,2489,-187,10569,11.991399943,8.7731396968,3.2182602464,1.5739726583,5.1573296553,6.7313023136
2016,North Carolina,Franklin County,64705,1031,692,597,95,35,828,863,73,1639,10.780579378,9.3005865445,1.4799928337,0.5452605177,12.899305961,13.444566479
2016,North Carolina,Gaston County,216965,3599,2556,2298,258,202,3215,3417,-76,3329,11.87922785,10.680150861,1.1990769896,0.9388122166,14.941986517,15.880798734
2016,North Carolina,Gates County,11478,30,103,110,-7,4,38,42,-5,61,8.9854313879,9.5960917735,-0.610660386,0.3489487918,3.3150135218,3.6639623135
2016,North Carolina,Graham County,8558,-52,84,97,-13,3,-43,-40,1,96,9.7856477167,11.300093197,-1.51444548,0.3494874185,-5.009319664,-4.659832246
2016,North Carolina,Granville County,59031,482,563,567,-4,25,451,476,10,4173,9.5764585814,9.6444973635,-0.068038782,0.4252423882,7.6713726824,8.0966150706
2016,North Carolina,Greene County,21168,-22,209,214,-5,11,-44,-33,16,2527,9.8682657349,10.104348647,-0.236082912,0.5193824071,-2.077529628,-1.558147221
2016,North Carolina,Guilford County,521330,3782,6055,4384,1671,1665,775,2440,-329,17126,11.65680667,8.439874557,3.2169321133,3.2053811901,1.4919942476,4.6973754377
2016,North Carolina,Halifax County,51766,-557,566,694,-128,21,-415,-394,-35,1286,10.87530863,13.334742384,-2.459433754,0.4035008502,-7.973945374,-7.570444523
2016,North Carolina,Harnett County,130881,2757,1901,1023,878,253,1561,1814,65,3478,14.679253296,7.8994614004,6.7797918959,1.9536302388,12.053821355,14.007451594
2016,North Carolina,Haywood County,60682,783,583,757,-174,2,941,943,14,726,9.6698484836,12.555875304,-2.88602682,0.0331727221,15.607765734,15.640938456
2016,North Carolina,Henderson County,114209,1882,1103,1448,-345,50,2090,2140,87,1306,9.7379665925,12.783840096,-3.045873504,0.4414309425,18.451813398,18.893244341
2016,North Carolina,Hertford County,24136,28,221,387,-166,37,114,151,43,2591,9.161761048,16.043445817,-6.881684769,1.5338694967,4.7259762872,6.2598457839
2016,North Carolina,Hoke County,53262,421,959,334,625,175,-369,-194,-10,833,18.076774455,6.2957692054,11.78100525,3.2986814699,-6.955505499,-3.656824029
2016,North Carolina,Hyde County,5517,14,41,48,-7,8,15,23,-2,747,7.4410163339,8.7114337568,-1.270417423,1.4519056261,2.722323049,4.1742286751
2016,North Carolina,Iredell County,172916,2924,1876,1557,319,295,2289,2584,21,1270,10.941710313,9.0811529623,1.8605573507,1.7205781142,13.350519673,15.071097787
2016,North Carolina,Jackson County,42241,914,402,362,40,102,787,889,-15,3679,9.6209075244,8.6636032931,0.9573042313,2.4411257898,18.834960751,21.27608654
2016,North Carolina,Johnston County,191450,5717,2317,1466,851,74,4641,4715,151,1816,12.285813518,7.7734150267,4.5123984909,0.3923824775,24.608744297,25.001126774
2016,North Carolina,Jones County,9845,-155,95,138,-43,8,-136,-128,16,87,9.5742000504,13.907785336,-4.333585286,0.8062484253,-13.70622323,-12.8999748
2016,North Carolina,Lee County,59616,178,749,573,176,31,-26,5,-3,1008,12.582525577,9.6258840526,2.956641524,0.5207720866,-0.436776589,0.0839954978
2016,North Carolina,Lenoir County,57307,-734,652,757,-105,30,-614,-584,-45,1229,11.304920762,13.125498492,-1.82057773,0.5201650657,-10.64604501,-10.12587995
2016,North Carolina,Lincoln County,81168,594,814,830,-16,27,590,617,-7,682,10.065412818,10.26325877,-0.197845952,0.3338650443,7.2955694872,7.6294345315
2016,North Carolina,McDowell County,45075,112,463,490,-27,41,122,163,-24,1539,10.284546525,10.884293298,-0.599746774,0.9107265821,2.7099669029,3.620693485
2016,North Carolina,Macon County,34376,226,344,415,-71,30,301,331,-34,450,10.039984823,12.112190993,-2.07220617,0.8755800718,8.7849867204,9.6605667922
2016,North Carolina,Madison County,21340,236,210,229,-19,12,259,271,-16,1235,9.8953915748,10.790688908,-0.895297333,0.5654509471,12.204316276,12.769767223
2016,North Carolina,Martin County,23172,-162,242,315,-73,1,-77,-76,-13,152,10.407259278,13.546639143,-3.139379865,0.0430052036,-3.311400679,-3.268395476
2016,North Carolina,Mecklenburg County,1054835,21369,14797,6228,8569,4534,8601,13135,-335,17097,14.17132875,5.9646573937,8.2066713563,4.3422859061,8.2373182793,12.579604185
2016,North Carolina,Mitchell County,15126,-57,141,232,-91,12,17,29,5,214,9.3041670791,15.30898413,-6.004817051,0.7918440067,1.1217790095,1.9136230163
2016,North Carolina,Montgomery County,27418,-90,316,271,45,3,-146,-143,8,1006,11.506390416,9.8678221607,1.6385682555,0.1092378837,-5.316243673,-5.20700579
2016,North Carolina,Moore County,95776,1340,1062,1143,-81,101,1284,1385,36,838,11.166487919,12.018169201,-0.851681282,1.0619729565,13.500725506,14.562698463
2016,North Carolina,Nash County,94005,86,1031,1024,7,49,61,110,-31,1949,10.972520806,10.898022605,0.0744982014,0.5214874098,0.6491986122,1.170686022
2016,North Carolina,New Hanover County,223483,3615,2324,1914,410,225,2837,3062,143,6714,10.483792751,8.6342423949,1.8495503563,1.0149971467,12.797986246,13.812983392
2016,North Carolina,Northampton County,20000,-433,171,284,-113,6,-318,-312,-8,720,8.458437415,14.047931145,-5.58949373,0.2967872777,-15.72972572,-15.43293844
2016,North Carolina,Onslow County,187136,103,4194,1050,3144,598,-3790,-3192,151,14297,22.417677574,5.6124371607,16.805240413,3.1964165925,-20.25822556,-17.06180897
2016,North Carolina,Orange County,141796,1100,1205,777,428,808,-69,739,-67,8969,8.5312150433,5.5010407374,3.0301743058,5.7205159792,-0.488509409,5.2320065701
2016,North Carolina,Pamlico County,12821,37,81,158,-77,9,108,117,-3,713,6.3268892794,12.341339582,-6.014450303,0.7029876977,8.4358523726,9.1388400703
2016,North Carolina,Pasquotank County,39864,191,515,364,151,89,-35,54,-14,2119,12.949947823,9.1529728303,3.7969749928,2.2379521481,-0.880093541,1.3578586067
2016,North Carolina,Pender County,59090,1410,640,557,83,45,1272,1317,10,1094,10.96171962,9.5401216066,1.4215980132,0.7707459108,21.786417744,22.557163655
2016,North Carolina,Perquimans County,13335,-75,111,161,-50,5,-36,-31,6,80,8.3006169377,12.039633576,-3.739016639,0.3739016639,-2.69209198,-2.318190316
2016,North Carolina,Person County,39284,86,417,426,-9,0,100,100,-5,446,10.626640504,10.855992457,-0.229351953,0.0,2.5483550368,2.5483550368
2016,North Carolina,Pitt County,177220,1038,2121,1318,803,282,-25,257,-22,6820,12.003327655,7.4589277933,4.5443998619,1.5959162653,-0.141481938,1.4544343269
2016,North Carolina,Polk County,20334,-10,152,254,-102,0,81,81,11,353,7.4733271056,12.488322926,-5.014995821,0.0,3.9824966813,3.9824966813
2016,North Carolina,Randolph County,143416,863,1562,1489,73,45,580,625,165,1294,10.924261021,10.413716172,0.5105448493,0.3147194276,4.0563837339,4.3711031615
2016,North Carolina,Richmond County,44939,-497,518,568,-50,2,-422,-420,-27,1133,11.463347165,12.569847856,-1.106500692,0.0442600277,-9.338865837,-9.294605809
2016,North Carolina,Robeson County,133235,-1057,1749,1338,411,91,-1511,-1420,-48,4258,13.075315763,10.002728697,3.072587066,0.6803051655,-11.2960561,-10.61575093
2016,North Carolina,Rockingham County,91393,-282,941,1158,-217,52,-93,-41,-24,1056,10.280332991,12.651036773,-2.370703782,0.5680949156,-1.016015907,-0.447920991
2016,North Carolina,Rowan County,139933,912,1559,1571,-12,67,858,925,-1,4503,11.177470121,11.263505811,-0.08603569,0.4803659385,6.1515518688,6.6319178072
2016,North Carolina,Rutherford County,66421,-41,669,845,-176,46,109,155,-20,1259,10.069008075,12.717954893,-2.648946818,0.6923383729,1.640540927,2.3328792998
2016,North Carolina,Sampson County,63124,-444,825,673,152,88,-640,-552,-44,1058,13.023711047,10.624190951,2.399520096,1.389195845,-10.10324251,-8.714046664
2016,North Carolina,Scotland County,35244,-174,435,393,42,23,-212,-189,-27,2449,12.31213382,11.123376072,1.1887577482,0.6509863859,-6.000396253,-5.349409867
2016,North Carolina,Stanly County,60791,205,695,704,-9,30,181,211,3,1998,11.451922522,11.6002208,-0.148298277,0.4943275909,2.9824431317,3.4767707226
2016,North Carolina,Stokes County,46097,-275,405,538,-133,9,-135,-126,-16,456,8.7596924375,11.636332176,-2.876639739,0.1946598319,-2.919897479,-2.725237647
2016,North Carolina,Surry County,72113,-435,745,884,-139,26,-439,-413,117,944,10.299942624,12.221676886,-1.921734261,0.3594610849,-6.069362164,-5.709901079
2016,North Carolina,Swain County,14346,-82,214,209,5,3,-102,-99,12,247,14.874539515,14.527003545,0.34753597,0.208521582,-7.089733787,-6.881212205
2016,North Carolina,Transylvania County,33482,280,285,383,-98,6,397,403,-25,1079,8.5477775778,11.487013377,-2.939235799,0.1799532122,11.906904205,12.086857417
2016,North Carolina,Tyrrell County,4141,1,40,37,3,0,-1,-1,-1,595,9.6606690013,8.9361188262,0.7245501751,0.0,-0.241516725,-0.241516725
2016,North Carolina,Union County,226606,4222,2409,1351,1058,169,3018,3187,-23,2216,10.730751242,6.017951402,4.7127998396,0.7528007305,13.443506537,14.196307267
2016,North Carolina,Vance County,44244,-107,544,515,29,-5,-108,-113,-23,627,12.280602743,11.625938258,0.6546644845,-0.112873187,-2.438060839,-2.550934026
2016,North Carolina,Wake County,1046791,24817,12884,5416,7468,3988,13041,17029,320,20843,12.455740502,5.2359741198,7.2197663824,3.8554403231,12.607521879,16.462962202
2016,North Carolina,Warren County,19907,-306,190,255,-65,18,-297,-279,38,975,9.4715852443,12.711864407,-3.240279163,0.8973080758,-14.80558325,-13.90827517
2016,North Carolina,Washington County,12195,-152,116,155,-39,21,-128,-107,-6,147,9.4531822997,12.631407383,-3.178225084,1.7113519681,-10.43109771,-8.719745742
2016,North Carolina,Watauga County,53922,898,367,355,12,32,847,879,7,5818,6.8632767939,6.6388644737,0.2244123202,0.598432854,15.839769603,16.438202457
2016,North Carolina,Wayne County,124150,-169,1633,1275,358,322,-773,-451,-76,3034,13.144496899,10.262849692,2.8816472075,2.591872628,-6.222104166,-3.630231538
2016,North Carolina,Wilkes County,68740,221,696,803,-107,10,354,364,-36,1051,10.141411492,11.700507799,-1.559096307,0.1457099352,5.1581317072,5.3038416424
2016,North Carolina,Wilson County,81661,-25,949,876,73,97,-185,-88,-10,1593,11.619435925,10.725633161,0.8938027634,1.1876557268,-2.265116592,-1.077460866
2016,North Carolina,Yadkin County,37532,-31,351,419,-68,7,49,56,-19,303,9.3481589986,11.159198349,-1.81103935,0.1864305213,1.3050136494,1.4914441707
2016,North Carolina,Yancey County,17678,114,182,199,-17,3,137,140,-9,164,10.328585211,11.29334317,-0.964757959,0.1702514046,7.7748141422,7.9450655468
2016,North Dakota,North Dakota,757952,1117,11824,6172,5652,1575,-6259,-4684,149,26100,15.611435799,8.1490004865,7.4624353127,2.0795002862,-8.263868121,-6.184367835
2016,North Dakota,Adams County,2305,-68,21,23,-2,3,-84,-81,15,51,8.9781958102,9.8332620778,-0.855066268,1.2825994015,-35.91278324,-34.63018384
2016,North Dakota,Barnes County,10926,-93,108,132,-24,6,-71,-65,-4,514,9.8427887902,12.030075188,-2.187286398,0.5468215995,-6.47072226,-5.923900661
2016,North Dakota,Benson County,6739,-25,156,77,79,1,-120,-119,15,16,23.10597645,11.404872991,11.701103458,0.1481152337,-17.77382804,-17.6257128
2016,North Dakota,Billings County,934,14,19,5,14,3,-6,-3,3,9,20.49622438,5.3937432578,15.102481122,3.2362459547,-6.472491909,-3.236245955
2016,North Dakota,Bottineau County,6579,-133,76,76,0,6,-137,-131,-2,241,11.436310285,11.436310285,0.0,0.9028666015,-20.61545407,-19.71258747
2016,North Dakota,Bowman County,3241,-40,46,30,16,0,-54,-54,-2,62,14.106102423,9.1996320147,4.9064704079,0.0,-16.55933763,-16.55933763
2016,North Dakota,Burke County,2198,-114,41,21,20,-1,-139,-140,6,2,18.181818182,9.3126385809,8.8691796009,-0.44345898,-61.64079823,-62.08425721
2016,North Dakota,Burleigh County,94487,1383,1422,744,678,34,651,685,20,3487,15.160642035,7.9321502631,7.228491772,0.3624907378,6.9406314802,7.303122218
2016,North Dakota,Cass County,175249,3725,2646,1051,1595,799,1317,2116,14,5465,15.260703688,6.0616022585,9.1991014295,4.6082019073,7.5957470737,12.203948981
2016,North Dakota,Cavalier County,3827,-3,47,41,6,0,-11,-11,2,74,12.276348439,10.709155022,1.5671934178,0.0,-2.873187933,-2.873187933
2016,North Dakota,Dickey County,5064,-44,70,67,3,1,-52,-51,4,205,13.763271726,13.173417224,0.5898545026,0.1966181675,-10.22414471,-10.02752654
2016,North Dakota,Divide County,2413,-33,31,19,12,4,-57,-53,8,115,12.759827125,7.8205392056,4.9392879193,1.6464293064,-23.46161762,-21.81518831
2016,North Dakota,Dunn County,4366,-208,80,23,57,4,-287,-283,18,130,17.897091723,5.1454138702,12.751677852,0.8948545861,-64.20581655,-63.31096197
2016,North Dakota,Eddy County,2358,-9,29,44,-15,1,3,4,2,83,12.275132275,18.624338624,-6.349206349,0.4232804233,1.2698412698,1.6931216931
2016,North Dakota,Emmons County,3346,-47,31,53,-22,1,-24,-23,-2,53,9.200178068,15.729336697,-6.529158629,0.2967799377,-7.122718504,-6.825938567
2016,North Dakota,Foster County,3303,-25,35,49,-14,1,-10,-9,-2,55,10.556477153,14.779068014,-4.222590861,0.3016136329,-3.016136329,-2.714522696
2016,North Dakota,Golden Valley County,1817,-29,25,7,18,0,-53,-53,6,52,13.65001365,3.822003822,9.828009828,0.0,-28.93802894,-28.93802894
2016,North Dakota,Grand Forks County,71083,337,1097,480,617,271,-518,-247,-33,4021,15.469332788,6.7687144378,8.7006183503,3.8215033597,-7.304570997,-3.483067638
2016,North Dakota,Grant County,2377,-14,26,28,-2,3,-10,-7,-5,18,10.906040268,11.744966443,-0.838926174,1.2583892617,-4.194630872,-2.936241611
2016,North Dakota,Griggs County,2277,-32,17,39,-22,0,-7,-7,-3,45,7.4138682948,17.008286088,-9.594417793,0.0,-3.052769298,-3.052769298
2016,North Dakota,Hettinger County,2629,-64,31,21,10,0,-74,-74,0,171,11.649755731,7.8917700113,3.7579857197,0.0,-27.80909433,-27.80909433
2016,North Dakota,Kidder County,2414,5,25,18,7,-1,-7,-8,6,0,10.366991499,7.4642338793,2.9027576197,-0.41467966,-2.90275762,-3.31743728
2016,North Dakota,LaMoure County,4111,-17,49,42,7,0,-23,-23,-1,65,11.894647409,10.195412065,1.6992353441,0.0,-5.583201845,-5.583201845
2016,North Dakota,Logan County,1941,8,20,22,-2,1,9,10,0,64,10.325245225,11.357769747,-1.032524522,0.5162622612,4.6463603511,5.1626226123
2016,North Dakota,McHenry County,5963,-2,73,58,15,1,-17,-16,-1,50,12.240107311,9.7250167673,2.5150905433,0.1676727029,-2.850435949,-2.682763246
2016,North Dakota,McIntosh County,2656,-101,28,45,-17,5,-90,-85,1,93,10.345464622,16.626639571,-6.281174949,1.8474043968,-33.25327914,-31.40587475
2016,North Dakota,McKenzie County,12621,-171,294,68,226,7,-423,-416,19,154,23.137764136,5.351591705,17.786172431,0.5508991461,-33.2900484,-32.73914925
2016,North Dakota,McLean County,9729,0,130,98,32,5,-26,-21,-11,150,13.36211327,10.072977696,3.2891355741,0.5139274334,-2.672422654,-2.15849522
2016,North Dakota,Mercer County,8694,-137,111,78,33,10,-177,-167,-3,125,12.667617689,8.9015691869,3.7660485021,1.1412268188,-20.19971469,-19.05848787
2016,North Dakota,Morton County,30809,441,494,252,242,3,184,187,12,679,16.149860242,8.2383902447,7.9114699969,0.0980760743,6.0153325596,6.113408634
2016,North Dakota,Mountrail County,10242,-65,182,89,93,-1,-157,-158,0,556,17.71375736,8.6622220059,9.0515353545,-0.097328337,-15.28054893,-15.37787727
2016,North Dakota,Nelson County,2960,-15,32,48,-16,5,-6,-1,2,80,10.783487784,16.175231676,-5.391743892,1.6849199663,-2.02190396,-0.336983993
2016,North Dakota,Oliver County,1870,21,23,7,16,0,-5,-5,10,2,12.368916375,3.7644528099,8.6044635655,0.0,-2.688894864,-2.688894864
2016,North Dakota,Pembina County,7069,-3,86,83,3,7,-12,-5,-1,152,12.163213351,11.738915211,0.4242981402,0.9900289937,-1.697192561,-0.707163567
2016,North Dakota,Pierce County,4267,-34,45,58,-13,1,-30,-29,8,239,10.504201681,13.538748833,-3.034547152,0.233426704,-7.00280112,-6.769374416
2016,North Dakota,Ramsey County,11547,-85,170,132,38,4,-129,-125,2,461,14.66844989,11.389619915,3.2788299754,0.3451399974,-11.13076492,-10.78562492
2016,North Dakota,Ransom County,5404,-56,70,76,-6,1,-51,-50,0,181,12.886597938,13.991163476,-1.104565538,0.1840942563,-9.388807069,-9.204712813
2016,North Dakota,Renville County,2550,-17,31,19,12,1,-31,-30,1,54,12.116474497,7.4262263045,4.6902481923,0.390854016,-12.1164745,-11.72562048
2016,North Dakota,Richland County,16353,-37,192,131,61,2,-107,-105,7,1014,11.727697523,8.0017102892,3.7259872339,0.1221635159,-6.535748099,-6.413584583
2016,North Dakota,Rolette County,14659,-3,284,181,103,0,-113,-113,7,122,19.371781317,12.346100065,7.0256812523,0.0,-7.707786228,-7.707786228
2016,North Dakota,Sargent County,3890,24,48,37,11,4,11,15,-2,39,12.377514183,9.5410005157,2.8365136668,1.0314595152,2.8365136668,3.8679731821
2016,North Dakota,Sheridan County,1322,20,8,8,0,0,15,15,5,3,6.0975609756,6.0975609756,0.0,0.0,11.432926829,11.432926829
2016,North Dakota,Sioux County,4469,73,100,76,24,2,46,48,1,59,22.560631698,17.14608009,5.4145516074,0.451212634,10.377890581,10.829103215
2016,North Dakota,Slope County,763,-1,6,3,3,0,-6,-6,2,0,7.858546169,3.9292730845,3.9292730845,0.0,-7.858546169,-7.858546169
2016,North Dakota,Stark County,31199,-940,593,243,350,115,-1417,-1302,12,577,18.724936057,7.6731188228,11.051817235,3.6313113771,-44.74407149,-41.11276011
2016,North Dakota,Steele County,1962,1,25,11,14,0,-12,-12,-1,1,12.745347948,5.6079530971,7.1373948509,0.0,-6.117767015,-6.117767015
2016,North Dakota,Stutsman County,21128,20,237,224,13,17,5,22,-15,1645,11.22265366,10.607065063,0.6155885974,0.8050004735,0.2367648452,1.0417653187
2016,North Dakota,Towner County,2263,-5,24,26,-2,1,-2,-1,-2,33,10.593687928,11.476495255,-0.882807327,0.4414036637,-0.882807327,-0.441403664
2016,North Dakota,Traill County,8030,19,95,104,-9,4,30,34,-6,347,11.844648089,12.966772645,-1.122124556,0.4987220248,3.7404151861,4.2391372109
2016,North Dakota,Walsh County,10904,-23,150,138,12,21,-48,-27,-8,327,13.741926618,12.642572489,1.0993541294,1.9238697265,-4.397416518,-2.473546791
2016,North Dakota,Ward County,70210,-1169,1323,491,832,205,-2212,-2007,6,3313,18.687892421,6.9355670285,11.752325393,2.8957051748,-31.24536511,-28.34965993
2016,North Dakota,Wells County,4098,-62,41,54,-13,5,-61,-56,7,100,9.9297650763,13.078227174,-3.148462097,1.2109469605,-14.77355292,-13.56260596
2016,North Dakota,Williams County,34337,-1050,781,222,559,13,-1654,-1641,32,546,22.402616029,6.3679651196,16.034650909,0.3728988584,-47.44420859,-47.07130974
2016,Ohio,Ohio,11614373,9283,138012,115938,22074,19591,-27558,-7967,-4824,313225,11.887613422,9.9862774604,1.9013359611,1.6874636593,-2.373698306,-0.686234647
2016,Ohio,Adams County,27907,-109,310,333,-23,6,-73,-67,-19,338,11.086672746,11.909232337,-0.822559591,0.2145807628,-2.610732614,-2.396151852
2016,Ohio,Allen County,103742,-468,1252,1085,167,33,-600,-567,-68,5977,12.041240286,10.435100408,1.6061398784,0.3173809341,-5.770562437,-5.453181503
2016,Ohio,Ashland County,53652,272,606,579,27,132,118,250,-5,2331,11.323716272,10.81919426,0.5045220121,2.4665520592,2.2049480529,4.6715001121
2016,Ohio,Ashtabula County,98231,-313,1035,1118,-83,90,-254,-164,-66,3452,10.519629018,11.363232118,-0.8436031,0.9147503494,-2.581628764,-1.666878414
2016,Ohio,Athens County,66186,487,554,491,63,306,123,429,-5,10338,8.4012586723,7.4458808811,0.9553777913,4.6404064147,1.865261402,6.5056678167
2016,Ohio,Auglaize County,45894,47,532,500,32,28,-14,14,1,526,11.597867911,10.900251796,0.6976161149,0.6104141006,-0.30520705,0.3052070503
2016,Ohio,Belmont County,68673,-366,688,853,-165,4,-153,-149,-52,3817,9.9918670849,12.388172418,-2.396305333,0.0580922505,-2.222028581,-2.163936331
2016,Ohio,Brown County,43759,-66,458,484,-26,-2,-3,-5,-35,575,10.458531239,11.052246986,-0.593715747,-0.045670442,-0.068505663,-0.114176105
2016,Ohio,Butler County,377537,2078,4434,3405,1029,742,409,1151,-102,11711,11.77695499,9.043872743,2.7330822474,1.9707940016,1.0863271518,3.0571211534
2016,Ohio,Carroll County,27669,-121,265,289,-24,3,-76,-73,-24,405,9.5566093871,10.422113633,-0.865504246,0.1081880308,-2.740763447,-2.632575416
2016,Ohio,Champaign County,38747,-251,372,399,-27,36,-266,-230,6,702,9.5697472506,10.26432568,-0.694578429,0.9261045726,-6.842883787,-5.916779214
2016,Ohio,Clark County,134786,-1029,1566,1676,-110,44,-867,-823,-96,2785,11.574236607,12.387241732,-0.813005126,0.3252020503,-6.407958581,-6.082756531
2016,Ohio,Clermont County,203022,1231,2285,1717,568,136,542,678,-15,1718,11.289163144,8.4829291549,2.8062339895,0.6719151806,2.6777796168,3.3496947974
2016,Ohio,Clinton County,41902,50,519,449,70,21,-46,-25,5,1113,12.393437925,10.72187597,1.6715619552,0.5014685866,-1.098454999,-0.596986413
2016,Ohio,Columbiana County,103685,-998,1014,1166,-152,18,-846,-828,-18,3951,9.7327804653,11.191737695,-1.45895723,0.1727712509,-8.120248791,-7.94747754
2016,Ohio,Coshocton County,36602,15,458,379,79,15,-63,-48,-16,428,12.515541953,10.356747599,2.1587943543,0.4098976622,-1.721570181,-1.311672519
2016,Ohio,Crawford County,42083,-247,491,471,20,3,-280,-277,10,579,11.633279234,11.159418573,0.4738606613,0.0710790992,-6.634049258,-6.562970159
2016,Ohio,Cuyahoga County,1249352,-5673,14941,13563,1378,3402,-10122,-6720,-331,30191,11.931909613,10.831436321,1.1004732914,2.7168433507,-8.0834475,-5.366604149
2016,Ohio,Darke County,51778,-322,655,600,55,8,-346,-338,-39,607,12.610947458,11.552012938,1.0589345193,0.1540268392,-6.661660794,-6.507633955
2016,Ohio,Defiance County,38158,-191,423,409,14,27,-220,-193,-12,723,11.057811704,10.69183212,0.3659795836,0.7058177683,-5.751107742,-5.045289973
2016,Ohio,Delaware County,196463,3579,2230,1154,1076,321,2078,2399,104,2285,11.455077347,5.9278741072,5.5272032403,1.6489147213,10.674282838,12.323197559
2016,Ohio,Erie County,75107,-364,775,912,-137,46,-204,-158,-69,1679,10.293668398,12.113323327,-1.81965493,0.6109790275,-2.709559165,-2.098580138
2016,Ohio,Fairfield County,152597,1271,1593,1346,247,153,926,1079,-55,3338,10.482918371,8.8575066711,1.6254116997,1.0068339678,6.0936487202,7.100482688
2016,Ohio,Fayette County,28676,30,315,310,5,9,35,44,-19,593,10.990544643,10.816091553,0.1744530896,0.3140155612,1.2211716269,1.5351871882
2016,Ohio,Franklin County,1264518,14249,18942,9784,9158,5476,226,5702,-611,27636,15.064496516,7.7811759008,7.2833206152,4.3550408046,0.1797368922,4.5347776969
2016,Ohio,Fulton County,42514,37,511,424,87,8,-55,-47,-3,391,12.024802626,9.9775270323,2.0472755939,0.188255227,-1.294254686,-1.105999459
2016,Ohio,Gallia County,30015,-95,377,349,28,20,-147,-127,4,799,12.540540541,11.609147609,0.9313929314,0.6652806653,-4.88981289,-4.224532225
2016,Ohio,Geauga County,94060,-35,911,809,102,55,-115,-60,-77,864,9.6835056204,8.599293136,1.0842124844,0.5846243788,-1.222396428,-0.63777205
2016,Ohio,Greene County,164765,729,1784,1449,335,451,8,459,-65,8064,10.851548505,8.8138418071,2.037706698,2.7433006591,0.0486616525,2.7919623116
2016,Ohio,Guernsey County,39063,-206,456,447,9,15,-214,-199,-16,510,11.642751366,11.412960221,0.2297911454,0.3829852423,-5.46392279,-5.080937548
2016,Ohio,Hamilton County,809099,1351,10989,7955,3034,2022,-3341,-1319,-364,21046,13.593122911,9.8401394813,3.7529834301,2.5011643031,-4.132734885,-1.631570582
2016,Ohio,Hancock County,75872,138,959,684,275,110,-221,-111,-26,1641,12.651214332,9.0233895756,3.6278247563,1.4511299025,-2.915451895,-1.464321993
2016,Ohio,Hardin County,31474,-158,370,323,47,21,-225,-204,-1,1940,11.726301778,10.236744525,1.4895572529,0.6655468577,-7.130859189,-6.465312332
2016,Ohio,Harrison County,15307,-117,172,204,-32,2,-86,-84,-1,232,11.193908431,13.276496046,-2.082587615,0.1301617259,-5.596954216,-5.46679249
2016,Ohio,Henry County,27629,-154,293,249,44,9,-196,-187,-11,346,10.575326644,8.9872229842,1.5881036599,0.324839385,-7.074279939,-6.749440554
2016,Ohio,Highland County,43029,11,513,485,28,14,2,16,-33,484,11.923716109,11.272908992,0.650807117,0.3254035585,0.0464862226,0.3718897812
2016,Ohio,Hocking County,28340,-134,294,302,-8,5,-108,-103,-23,310,10.349561728,10.631182455,-0.281620727,0.1760129546,-3.801879818,-3.625866864
2016,Ohio,Holmes County,43936,-3,759,333,426,1,-423,-422,-7,765,17.274537696,7.5789473684,9.6955903272,0.0227596017,-9.627311522,-9.60455192
2016,Ohio,Huron County,58439,73,728,564,164,14,-109,-95,4,578,12.465219811,9.6571208424,2.8080989684,0.2397157656,-1.866358461,-1.626642695
2016,Ohio,Jackson County,32505,-41,399,365,34,0,-52,-52,-23,325,12.267297966,11.221964305,1.0453336613,0.0,-1.5987456,-1.5987456
2016,Ohio,Jefferson County,66704,-623,665,964,-299,2,-298,-296,-28,2290,9.923077497,14.38473189,-4.461654393,0.0298438421,-4.446732472,-4.41688863
2016,Ohio,Knox County,60814,-159,697,628,69,14,-218,-204,-24,3448,11.446213471,10.313087604,1.1331258673,0.2299095963,-3.580020856,-3.35011126
2016,Ohio,Lake County,228614,-648,2182,2473,-291,218,-388,-170,-187,2802,9.5309647153,10.80205121,-1.271086495,0.9522228726,-1.694781993,-0.742559121
2016,Ohio,Lawrence County,60872,-170,689,718,-29,-13,-80,-93,-48,669,11.303049691,11.778794888,-0.475745197,-0.213265089,-1.312400545,-1.525665633
2016,Ohio,Licking County,172198,1439,2092,1595,497,117,880,997,-55,3436,12.199780147,9.3014576171,2.8983225302,0.6823012798,5.1318386853,5.8141399651
2016,Ohio,Logan County,45165,-183,515,508,7,15,-189,-174,-16,450,11.379580834,11.224906919,0.1546739142,0.331444102,-4.176195685,-3.844751583
2016,Ohio,Lorain County,306365,1152,3429,2930,499,541,257,798,-145,9008,11.213614617,9.5817704365,1.6318441801,1.7691937905,0.8404488062,2.6096425967
2016,Ohio,Lucas County,432488,-1008,5579,4515,1064,467,-2314,-1847,-225,10362,12.884764615,10.427444387,2.4573202276,1.0785418668,-5.344209593,-4.265667726
2016,Ohio,Madison County,43419,-684,426,392,34,48,-757,-709,-9,4510,9.7346952766,8.9577477663,0.7769475103,1.0968670734,-17.2985078,-16.20164073
2016,Ohio,Mahoning County,230008,-1759,2377,2991,-614,289,-1229,-940,-205,7962,10.295057117,12.95436089,-2.659303773,1.2516918413,-5.322938661,-4.071246819
2016,Ohio,Marion County,65096,-136,693,710,-17,10,-104,-94,-25,6274,10.63470628,10.89558652,-0.260880241,0.1534589651,-1.595973237,-1.442514272
2016,Ohio,Medina County,177221,887,1868,1441,427,84,361,445,15,1199,10.566955636,8.1514898672,2.4154657691,0.4751735939,2.0421150882,2.5172886821
2016,Ohio,Meigs County,23125,-78,203,267,-64,-1,-14,-15,1,212,8.7635986876,11.526506648,-2.762907961,-0.043170437,-0.604386116,-0.647556553
2016,Ohio,Mercer County,40909,-38,553,387,166,19,-207,-188,-16,439,13.511532447,9.455629398,4.0559030493,0.4642298671,-5.057662236,-4.593432369
2016,Ohio,Miami County,104679,482,1216,1010,206,80,269,349,-73,1056,11.643271606,9.6708094755,1.9724621306,0.7660047109,2.5756908405,3.3416955514
2016,Ohio,Monroe County,14210,-181,146,214,-68,1,-105,-104,-9,165,10.209433237,14.96451173,-4.755078494,0.0699276249,-7.342400615,-7.27247299
2016,Ohio,Montgomery County,531239,-328,6488,5845,643,1026,-1617,-591,-380,15240,12.209189636,10.999185176,1.2100044599,1.9307380651,-3.042888354,-1.112150289
2016,Ohio,Morgan County,14804,19,151,148,3,0,25,25,-9,188,10.206495657,10.003717598,0.2027780594,0.0,1.6898171618,1.6898171618
2016,Ohio,Morrow County,35036,-55,373,319,54,5,-117,-112,3,366,10.637842771,9.0977797425,1.5400630285,0.1425984286,-3.336803228,-3.1942048
2016,Ohio,Muskingum County,86068,-237,1038,962,76,64,-327,-263,-50,1762,12.043649527,11.161840892,0.8818086359,0.7425756934,-3.794097684,-3.05152199
2016,Ohio,Noble County,14294,-31,137,131,6,6,-47,-41,4,2678,9.5740591914,9.154757329,0.4193018624,0.4193018624,-3.284531255,-2.865229393
2016,Ohio,Ottawa County,40636,-223,358,520,-162,5,-55,-50,-11,495,8.7858150807,12.761519112,-3.975704031,0.1227069145,-1.34977606,-1.227069145
2016,Ohio,Paulding County,18865,-108,219,193,26,6,-134,-128,-6,85,11.575664676,10.201384851,1.3742798245,0.317141498,-7.082826788,-6.76568529
2016,Ohio,Perry County,35927,-25,428,382,46,7,-57,-50,-21,307,11.908902461,10.628973692,1.2799287692,0.1947717692,-1.585998692,-1.391226923
2016,Ohio,Pickaway County,57565,594,614,567,47,16,547,563,-16,4894,10.721519871,9.9008172103,0.8207026612,0.27938814,9.5515820353,9.8309701753
2016,Ohio,Pike County,28160,-46,355,369,-14,14,-29,-15,-17,496,12.596245964,13.092999326,-0.496753362,0.496753362,-1.028989107,-0.532235745
2016,Ohio,Portage County,161921,-121,1506,1404,102,384,-501,-117,-106,7891,9.2973580316,8.6676564916,0.62970154,2.3706410917,-3.092945799,-0.722304708
2016,Ohio,Preble County,41247,-120,428,434,-6,28,-109,-81,-33,386,10.36143995,10.506693781,-0.145253831,0.6778512117,-2.638777931,-1.960926719
2016,Ohio,Putnam County,34056,18,465,327,138,10,-116,-106,-14,303,13.657590977,9.6043704291,4.0532205481,0.2937116339,-3.407054953,-3.11334332
2016,Ohio,Richland County,121107,-474,1319,1348,-29,36,-402,-366,-79,7386,10.869923523,11.108913502,-0.238989979,0.2966772152,-3.31289557,-3.016218354
2016,Ohio,Ross County,77000,-162,893,818,75,24,-213,-189,-48,5710,11.585215552,10.612213126,0.973002426,0.3113607763,-2.76332689,-2.451966114
2016,Ohio,Sandusky County,59330,-188,616,608,8,11,-170,-159,-37,902,10.366182014,10.231556274,0.1346257404,0.1851103931,-2.860796984,-2.675686591
2016,Ohio,Scioto County,76088,-664,816,912,-96,39,-609,-570,2,3291,10.677833028,11.934048678,-1.25621565,0.510337608,-7.969118032,-7.458780424
2016,Ohio,Seneca County,55353,-226,567,568,-1,51,-238,-187,-38,2547,10.222478636,10.240507698,-0.018029063,0.9194822053,-4.290916958,-3.371434753
2016,Ohio,Shelby County,48623,-294,619,427,192,61,-550,-489,3,589,12.692228829,8.7553824072,3.936846422,1.2507689153,-11.27742465,-10.02665573
2016,Ohio,Stark County,373612,-1253,4175,4035,140,168,-1256,-1088,-305,9007,11.155987425,10.781894434,0.3740929915,0.4489115898,-3.356148552,-2.907236963
2016,Ohio,Summit County,540300,-1016,6135,5789,346,980,-1969,-989,-373,10357,11.344136921,10.704353486,0.6397834352,1.8121033713,-3.640848508,-1.828745137
2016,Ohio,Trumbull County,201825,-1806,2035,2487,-452,22,-1286,-1264,-90,3974,10.038080581,12.267668995,-2.229588414,0.1085197901,-6.343475001,-6.234955211
2016,Ohio,Tuscarawas County,92420,-282,1123,1010,113,63,-395,-332,-63,1251,12.132539623,10.91172308,1.2208165426,0.6806322317,-4.267456056,-3.586823824
2016,Ohio,Union County,55457,1142,633,346,287,53,810,863,-8,2959,11.532995664,6.3039755129,5.2290201509,0.9656378676,14.75786175,15.723499617
2016,Ohio,Van Wert County,28362,-167,341,305,36,10,-205,-195,-8,396,11.987836389,10.722258354,1.2655780352,0.3515494542,-7.206763811,-6.855214357
2016,Ohio,Vinton County,12921,-99,128,155,-27,0,-76,-76,4,68,9.8685478586,11.950194673,-2.081646814,0.0,-5.859450291,-5.859450291
2016,Ohio,Warren County,227063,2624,2358,1806,552,466,1415,1881,191,5825,10.445136456,7.9999645627,2.4451718929,2.0642211995,6.2679678052,8.3321890047
2016,Ohio,Washington County,60610,-461,562,724,-162,29,-289,-260,-39,1562,9.2372679383,11.899967949,-2.662700011,0.4766561748,-4.750125328,-4.273469153
2016,Ohio,Wayne County,116470,362,1523,1127,396,121,-115,6,-40,3839,13.096681543,9.6913723568,3.4053091866,1.0405111403,-0.988915547,0.0515955937
2016,Ohio,Williams County,37017,-60,413,393,20,0,-80,-80,0,990,11.148001188,10.608146409,0.5398547791,0.0,-2.159419116,-2.159419116
2016,Ohio,Wood County,130219,613,1388,1074,314,191,120,311,-12,6855,10.684114308,8.2671028577,2.41701145,1.4702203406,0.9236986433,2.3939189839
2016,Ohio,Wyandot County,22118,-123,250,248,2,0,-119,-119,-6,251,11.271669785,11.181496427,0.0901733583,0.0,-5.365314818,-5.365314818
2016,Oklahoma,Oklahoma,3923561,16147,53175,39588,13587,6716,-3822,2894,-334,109868,13.580684398,10.11061841,3.470065988,1.7152398009,-0.976123663,0.7391161382
2016,Oklahoma,Adair County,22098,48,329,274,55,5,4,9,-16,92,14.904412431,12.412793332,2.4916190994,0.2265108272,0.1812086618,0.407719489
2016,Oklahoma,Alfalfa County,5827,-13,59,48,11,-1,-33,-34,10,1054,10.113996743,8.2283363332,1.8856604097,-0.171423674,-5.656981229,-5.828404903
2016,Oklahoma,Atoka County,13810,24,166,119,47,6,-51,-45,22,750,12.030729091,8.6244383244,3.4062907668,0.4348456298,-3.696187853,-3.261342224
2016,Oklahoma,Beaver County,5382,-33,67,51,16,3,-52,-49,0,43,12.410854867,9.4470686302,2.9637862369,0.5557099194,-9.63230527,-9.076595351
2016,Oklahoma,Beckham County,22519,-1109,348,270,78,-3,-1205,-1208,21,1925,15.082237199,11.701735757,3.380501441,-0.130019286,-52.22441329,-52.35443257
2016,Oklahoma,Blaine County,9643,-145,160,109,51,14,-202,-188,-8,107,16.468529669,11.219185837,5.249343832,1.440996346,-20.79151871,-19.35052236
2016,Oklahoma,Bryan County,45573,586,600,525,75,42,456,498,13,1134,13.250883392,11.594522968,1.656360424,0.9275618375,10.070671378,10.998233216
2016,Oklahoma,Caddo County,29557,159,404,382,22,24,114,138,-1,1933,13.705368501,12.959036553,0.7463319481,0.814180307,3.8673564583,4.6815367653
2016,Oklahoma,Canadian County,136532,3249,1805,974,831,90,2243,2333,85,2486,13.379537831,7.2197616886,6.1597761429,0.66712377,16.626206845,17.293330615
2016,Oklahoma,Carter County,48556,-110,685,667,18,30,-192,-162,34,913,14.09146078,13.72117422,0.3702865607,0.6171442678,-3.949723314,-3.332579046
2016,Oklahoma,Cherokee County,48700,331,567,499,68,25,229,254,9,2009,11.68241148,10.281346259,1.4010652216,0.515097508,4.7182931729,5.2333906809
2016,Oklahoma,Choctaw County,14885,-120,185,210,-25,1,-88,-87,-8,172,12.378721981,14.051522248,-1.672800268,0.0669120107,-5.888256942,-5.821344931
2016,Oklahoma,Cimarron County,2162,-38,23,15,8,1,-58,-57,11,7,10.545621275,6.8775790922,3.6680421825,0.4585052728,-26.59330582,-26.13480055
2016,Oklahoma,Cleveland County,278655,4442,3098,2008,1090,684,2555,3239,113,10545,11.207015056,7.2639400363,3.9430750197,2.4743700124,9.2427125462,11.717082559
2016,Oklahoma,Coal County,5651,6,55,79,-24,0,27,27,3,61,9.7379603399,13.987252125,-4.249291785,0.0,4.7804532578,4.7804532578
2016,Oklahoma,Comanche County,122136,-2060,1838,1072,766,344,-3123,-2779,-47,10328,14.922949515,8.7037006966,6.2192488187,2.7929785818,-25.35602358,-22.563045
2016,Oklahoma,Cotton County,5941,-31,70,83,-13,0,-20,-20,2,48,11.751867708,13.934357425,-2.182489717,0.0,-3.357676488,-3.357676488
2016,Oklahoma,Craig County,14625,-205,186,232,-46,5,-158,-153,-6,1050,12.629434731,15.75284332,-3.123408589,0.3395009336,-10.7282295,-10.38872857
2016,Oklahoma,Creek County,71312,337,879,917,-38,34,365,399,-24,1062,12.355310042,12.889441762,-0.53413172,0.4779073281,5.1304757286,5.6083830568
2016,Oklahoma,Custer County,29293,-321,462,283,179,50,-562,-512,12,1519,15.685741932,9.608365729,6.0773762032,1.6975911182,-19.08092417,-17.38333305
2016,Oklahoma,Delaware County,41598,214,398,547,-149,21,357,378,-15,356,9.5924417344,13.183581982,-3.591140247,0.5061338604,8.604275626,9.1104094864
2016,Oklahoma,Dewey County,4819,-125,57,79,-22,2,-106,-104,1,93,11.676738707,16.183550138,-4.506811431,0.4097101301,-21.71463689,-21.30492676
2016,Oklahoma,Ellis County,4080,-147,57,54,3,4,-158,-154,4,46,13.723365836,13.001083424,0.7222824124,0.9630432166,-38.04020705,-37.07716384
2016,Oklahoma,Garfield County,62603,-757,988,661,327,171,-1216,-1045,-39,1797,15.687146225,10.4951454,5.1920008256,2.7150830006,-19.30725689,-16.59217389
2016,Oklahoma,Garvin County,27838,43,390,335,55,28,-22,6,-18,317,14.020455485,12.043211763,1.9772437223,1.0065968041,-0.790897489,0.2156993152
2016,Oklahoma,Grady County,54655,99,594,504,90,60,-50,10,-1,1079,10.878025107,9.229839485,1.6481856223,1.0987904149,-0.915658679,0.1831317358
2016,Oklahoma,Grant County,4465,-39,51,53,-2,0,-35,-35,-2,73,11.372505296,11.818485896,-0.4459806,0.0,-7.804660497,-7.804660497
2016,Oklahoma,Greer County,5998,-57,76,60,16,-1,-74,-75,2,1142,12.610968224,9.956027545,2.6549406787,-0.165933792,-12.27910064,-12.44503443
2016,Oklahoma,Harmon County,2704,-68,29,38,-9,4,-63,-59,0,100,10.591672754,13.878743608,-3.287070855,1.4609203798,-23.00949598,-21.5485756
2016,Oklahoma,Harper County,3717,-54,42,69,-27,33,-68,-35,8,41,11.217948718,18.429487179,-7.211538462,8.8141025641,-18.16239316,-9.348290598
2016,Oklahoma,Haskell County,12747,-49,173,144,29,9,-85,-76,-2,78,13.545785538,11.275104725,2.2706808127,0.7046940453,-6.655443762,-5.950749716
2016,Oklahoma,Hughes County,13566,-162,147,178,-31,7,-139,-132,1,1561,10.771598153,13.043159669,-2.271561515,0.5129332454,-10.18538873,-9.672455485
2016,Oklahoma,Jackson County,25497,-23,396,206,190,66,-285,-219,6,686,15.524237019,8.0757394594,7.4484975596,2.5873728365,-11.17274634,-8.585373503
2016,Oklahoma,Jefferson County,6230,-20,69,83,-14,3,-10,-7,1,144,11.057692308,13.301282051,-2.243589744,0.4807692308,-1.602564103,-1.121794872
2016,Oklahoma,Johnston County,11087,115,138,169,-31,6,142,148,-2,292,12.511899905,15.322544086,-2.810644182,0.543995648,12.87456367,13.418559318
2016,Oklahoma,Kay County,44943,-366,591,559,32,15,-388,-373,-25,1273,13.096662678,12.387537118,0.7091255595,0.332402606,-8.598147409,-8.265744803
2016,Oklahoma,Kingfisher County,15638,67,231,129,102,2,-44,-42,7,155,14.80342209,8.2668461021,6.5365759877,0.1281681566,-2.819699446,-2.691531289
2016,Oklahoma,Kiowa County,9077,-71,120,116,4,3,-80,-77,2,171,13.16872428,12.729766804,0.438957476,0.329218107,-8.77914952,-8.449931413
2016,Oklahoma,Latimer County,10414,-98,120,104,16,3,-125,-122,8,574,11.46898595,9.9397878238,1.5291981267,0.2867246488,-11.94686037,-11.66013572
2016,Oklahoma,Le Flore County,49873,152,640,681,-41,77,142,219,-26,1614,12.85217985,13.675522622,-0.823342772,1.5462778882,2.8515774043,4.3978552925
2016,Oklahoma,Lincoln County,35129,144,428,343,85,2,25,27,32,386,12.208688707,9.7840659497,2.4246227572,0.0570499472,0.7131243404,0.7701742876
2016,Oklahoma,Logan County,46588,632,507,389,118,6,510,516,-2,2184,10.956950207,8.4068118949,2.5501383126,0.1296680498,11.021784232,11.151452282
2016,Oklahoma,Love County,9997,171,119,120,-1,3,176,179,-7,88,12.00625536,12.107148262,-0.100892902,0.3026787066,17.757150784,18.059829491
2016,Oklahoma,McClain County,38682,659,428,334,94,12,545,557,8,194,11.159637573,8.7086891337,2.4509484388,0.3128870347,14.210286161,14.523173196
2016,Oklahoma,McCurtain County,32822,-217,465,439,26,13,-255,-242,-1,454,14.120648031,13.331106421,0.7895416104,0.3947708052,-7.743581179,-7.348810373
2016,Oklahoma,McIntosh County,19815,-90,190,321,-131,1,58,59,-18,345,9.5669687815,16.163141994,-6.596173212,0.0503524673,2.9204431017,2.970795569
2016,Oklahoma,Major County,7772,32,112,74,38,8,-14,-6,0,77,14.440433213,9.5410005157,4.8994326973,1.0314595152,-1.805054152,-0.773594636
2016,Oklahoma,Marshall County,16191,-37,180,149,31,21,-100,-79,11,329,11.104599155,9.1921404115,1.9124587433,1.2955365681,-6.169221753,-4.873685185
2016,Oklahoma,Mayes County,40920,110,489,544,-55,4,163,167,-2,566,11.96623027,13.312125291,-1.34589502,0.0978832742,3.9887434235,4.0866266977
2016,Oklahoma,Murray County,13918,10,159,201,-42,1,55,56,-4,313,11.428160713,14.446920147,-3.018759434,0.0718752246,3.9531373536,4.0250125782
2016,Oklahoma,Muskogee County,69477,-114,896,905,-9,39,-111,-72,-33,3518,12.885782495,13.015215578,-0.129433083,0.5608766934,-1.596341358,-1.035464665
2016,Oklahoma,Noble County,11384,-146,123,127,-4,0,-135,-135,-7,273,10.735794711,11.084926246,-0.349131535,0.0,-11.78318932,-11.78318932
2016,Oklahoma,Nowata County,10419,-99,110,136,-26,1,-73,-72,-1,157,10.507713617,12.991355017,-2.4836414,0.0955246692,-6.973300855,-6.877776186
2016,Oklahoma,Okfuskee County,12167,10,152,157,-5,6,8,14,1,1228,12.497944417,12.90906101,-0.411116593,0.4933399112,0.6577865483,1.1511264595
2016,Oklahoma,Oklahoma County,782970,7021,12351,7006,5345,2459,-396,2063,-387,14742,15.84559557,8.9882796989,6.8573158708,3.1547501827,-0.508044356,2.6467058263
2016,Oklahoma,Okmulgee County,39213,39,502,525,-23,11,75,86,-24,1375,12.808246265,13.395078266,-0.586832,0.2806587827,1.9135826094,2.1942413921
2016,Oklahoma,Osage County,47806,-10,434,559,-125,9,113,122,-7,1504,9.0774089645,11.691870072,-2.614461107,0.1882411997,2.363472841,2.5517140407
2016,Oklahoma,Ottawa County,31691,-237,453,499,-46,15,-212,-197,6,968,14.241028624,15.68713749,-1.446108867,0.4715572392,-6.664675647,-6.193118408
2016,Oklahoma,Pawnee County,16485,30,202,190,12,4,7,11,7,194,12.26472374,11.53612629,0.7285974499,0.2428658166,0.4250151791,0.6678809957
2016,Oklahoma,Payne County,81131,498,895,582,313,421,-266,155,30,7778,11.065502831,7.1956677629,3.8698350684,5.2051136223,-3.288741624,1.9163719987
2016,Oklahoma,Pittsburg County,44173,-355,528,574,-46,2,-316,-314,5,2424,11.905164542,12.942356907,-1.037192365,0.0450953202,-7.125060597,-7.079965277
2016,Oklahoma,Pontotoc County,38330,62,515,510,5,44,32,76,-19,1700,13.446826288,13.316274576,0.1305517115,1.1488550615,0.8355309538,1.9843860153
2016,Oklahoma,Pottawatomie County,72290,458,918,823,95,28,356,384,-21,3050,12.739207061,11.420879533,1.3183275281,0.3885596925,4.9402589473,5.3288186398
2016,Oklahoma,Pushmataha County,11057,-97,132,164,-32,5,-73,-68,3,110,11.886002431,14.767457566,-2.881455135,0.4502273648,-6.573319526,-6.123092162
2016,Oklahoma,Roger Mills County,3640,-115,42,24,18,1,-140,-139,6,11,11.359026369,6.490872211,4.8681541582,0.2704530088,-37.86342123,-37.59296822
2016,Oklahoma,Rogers County,91766,1039,1040,828,212,45,698,743,84,1216,11.397697446,9.0743206589,2.3233767871,0.493169601,7.6496084781,8.1427780792
2016,Oklahoma,Seminole County,25207,-279,325,341,-16,5,-249,-244,-19,581,12.822283155,13.453534019,-0.631250863,0.1972658947,-9.823841556,-9.626575661
2016,Oklahoma,Sequoyah County,41294,54,533,537,-4,24,62,86,-28,464,12.915889209,13.012818959,-0.09692975,0.581578501,1.5024111275,2.0839896285
2016,Oklahoma,Stephens County,44090,-558,563,546,17,25,-597,-572,-3,540,12.689039645,12.305889247,0.3831503978,0.5634564674,-13.45534044,-12.89188397
2016,Oklahoma,Texas County,21098,-267,390,142,248,74,-608,-534,19,572,18.368932953,6.6881755882,11.680757365,3.4853872783,-28.63669548,-25.1513082
2016,Oklahoma,Tillman County,7465,-54,104,73,31,5,-111,-106,21,267,13.881473572,9.7437266418,4.1377469301,0.6673785371,-14.81580352,-14.14842499
2016,Oklahoma,Tulsa County,642940,4382,9429,6003,3426,1383,-291,1092,-136,9869,14.71559066,9.3687231662,5.3468674941,2.1584114841,-0.454155996,1.7042554885
2016,Oklahoma,Wagoner County,77679,925,923,673,250,23,656,679,-4,319,11.953403741,8.7157537573,3.2376499841,0.2978637985,8.4955935584,8.7934573569
2016,Oklahoma,Washington County,52087,-58,645,654,-9,128,-183,-55,6,798,12.376237624,12.548929312,-0.172691688,2.4560595594,-3.511397651,-1.055338092
2016,Oklahoma,Washita County,11447,-257,177,153,24,1,-277,-276,-5,206,15.290916159,13.217571595,2.0733445639,0.0863893568,-23.92985184,-23.84346249
2016,Oklahoma,Woods County,9201,-116,121,101,20,4,-145,-141,5,1001,13.068365914,10.908305433,2.1600604817,0.4320120963,-15.66043849,-15.2284264
2016,Oklahoma,Woodward County,20814,-674,302,256,46,16,-751,-735,15,1237,14.278284715,12.103446646,2.1748380691,0.7564654153,-35.50659543,-34.75013002
2016,Oregon,Oregon,4093465,68831,46198,35371,10827,6934,50038,56972,1032,88778,11.38148229,8.7141090543,2.667373236,1.7082817049,12.327516577,14.035798282
2016,Oregon,Baker County,16059,96,165,213,-48,11,149,160,-16,373,10.305415027,13.303353944,-2.997938917,0.6870276685,9.3061020548,9.9931297233
2016,Oregon,Benton County,89385,1114,757,581,176,500,453,953,-15,5097,8.52208763,6.5407304003,1.9813572297,5.6288557662,5.0997433242,10.72859909
2016,Oregon,Clackamas County,408062,6912,4221,3462,759,315,5763,6078,75,2961,10.432371245,8.5564722224,1.8758990228,0.7785351675,14.243486256,15.022021423
2016,Oregon,Clatsop County,38632,837,410,398,12,29,785,814,11,870,10.729192563,10.415167415,0.3140251482,0.7588941081,20.542478443,21.301372552
2016,Oregon,Columbia County,50785,1220,484,477,7,15,1196,1211,2,455,9.6462381664,9.5067264574,0.139511709,0.2989536622,23.836571998,24.13552566
2016,Oregon,Coos County,63761,718,627,903,-276,82,891,973,21,1145,9.8892779408,14.242452919,-4.353174979,1.2933345951,14.053184442,15.346519037
2016,Oregon,Crook County,22570,923,240,236,4,7,886,893,26,239,10.855553294,10.674627406,0.1809258882,0.3166203044,40.075084244,40.391704548
2016,Oregon,Curry County,22713,317,151,355,-204,-13,522,509,12,304,6.6948945887,15.739652841,-9.044758252,-0.576381653,23.143940234,22.56755858
2016,Oregon,Deschutes County,181307,6365,1853,1455,398,3,5695,5698,269,1083,10.402836218,8.1684439816,2.2343922369,0.0168421525,31.972019571,31.988861723
2016,Oregon,Douglas County,108457,932,1103,1371,-268,34,1141,1175,25,1715,10.213814114,12.695502403,-2.481688289,0.3148410516,10.565695289,10.880536341
2016,Oregon,Gilliam County,1854,-9,14,29,-15,1,4,5,1,21,7.5329566855,15.603981706,-8.07102502,0.5380683347,2.1522733387,2.6903416734
2016,Oregon,Grant County,7158,-34,61,74,-13,0,-34,-34,13,95,8.5017421603,10.31358885,-1.81184669,0.0,-4.738675958,-4.738675958
2016,Oregon,Harney County,7292,96,91,72,19,5,63,68,9,141,12.562120375,9.9392600773,2.6228602982,0.6902263943,8.6968525676,9.3870789619
2016,Oregon,Hood River County,23232,195,308,172,136,-8,53,45,14,789,13.31344961,7.4347835484,5.8786660615,-0.345803886,2.2909507446,1.9451468586
2016,Oregon,Jackson County,216527,2993,2314,2258,56,37,2833,2870,67,4781,10.7612641,10.500835928,0.2604281718,0.1720686135,13.174875192,13.346943806
2016,Oregon,Jefferson County,23080,471,280,250,30,22,393,415,26,899,12.256779531,10.943553153,1.3132263783,0.9630326774,17.203265556,18.166298234
2016,Oregon,Josephine County,85904,1162,885,1147,-262,13,1364,1377,47,1537,10.372349777,13.443034117,-3.070684341,0.1523622001,15.986310842,16.138673042
2016,Oregon,Klamath County,66443,535,791,787,4,34,495,529,2,1030,11.9530642,11.89261887,0.060445331,0.5137853133,7.4801097083,7.9938950216
2016,Oregon,Lake County,7837,56,80,92,-12,1,72,73,-5,466,10.244589576,11.781278013,-1.536688436,0.1280573697,9.2201306185,9.3481879882
2016,Oregon,Lane County,369519,6919,3752,3422,330,624,5706,6330,259,8142,10.249699844,9.3482070538,0.9014927901,1.7046409122,15.58762988,17.292270792
2016,Oregon,Lincoln County,47806,870,432,576,-144,41,942,983,31,761,9.1195034937,12.159337992,-3.039834498,0.8655084334,19.885584007,20.751092441
2016,Oregon,Linn County,122849,2405,1436,1290,146,12,2126,2138,121,1212,11.804696395,10.604497458,1.2001989371,0.098646488,17.476869454,17.575515942
2016,Oregon,Malheur County,30439,116,388,249,139,6,-35,-29,6,3346,12.771139857,8.1959119186,4.5752279385,0.1974918535,-1.152035812,-0.954543958
2016,Oregon,Marion County,336316,6369,4451,2848,1603,316,4299,4615,151,10598,13.36109014,8.5491765264,4.8119136137,0.9485743618,12.904813865,13.853388227
2016,Oregon,Morrow County,11274,110,172,98,74,23,19,42,-6,23,15.331134682,8.7351813887,6.5959532935,2.0500935912,1.6935555754,3.7436491666
2016,Oregon,Multnomah County,799766,10641,9547,5998,3549,2810,4566,7376,-284,19766,12.01718683,7.5499200386,4.4672667917,3.5370582375,5.747404951,9.2844631885
2016,Oregon,Polk County,81823,2393,881,704,177,105,2026,2131,85,1799,10.926928491,8.731620497,2.1953079943,1.3023013525,25.128214669,26.430516021
2016,Oregon,Sherman County,1710,32,20,14,6,0,27,27,-1,0,11.806375443,8.2644628099,3.5419126328,0.0,15.938606848,15.938606848
2016,Oregon,Tillamook County,26143,530,270,288,-18,19,530,549,-1,468,10.433572919,11.129144447,-0.695571528,0.7342143906,20.480717212,21.214931602
2016,Oregon,Umatilla County,76456,166,1016,648,368,-20,-138,-158,-44,4080,13.303130688,8.4846739031,4.8184567845,-0.261872651,-1.806921294,-2.068793946
2016,Oregon,Union County,26087,358,289,290,-1,17,343,360,-1,733,11.154855643,11.193453759,-0.038598116,0.656167979,13.239153929,13.895321908
2016,Oregon,Wallowa County,6946,116,55,60,-5,1,121,122,-1,108,7.9849012776,8.7108013937,-0.725900116,0.1451800232,17.566782811,17.711962834
2016,Oregon,Wasco County,26115,362,312,276,36,15,311,326,0,741,12.030539061,10.642399938,1.3881391224,0.578391301,11.991979641,12.570370942
2016,Oregon,Washington County,582779,10020,7181,3405,3776,1773,4445,6218,26,7003,12.428842669,5.8933587645,6.5354839045,3.0687004668,7.6933861111,10.762086578
2016,Oregon,Wheeler County,1344,-5,9,17,-8,0,3,3,0,24,6.683995544,12.625324916,-5.941329372,0.0,2.2279985147,2.2279985147
2016,Oregon,Yamhill County,105035,2530,1152,856,296,104,2023,2127,107,5973,11.101474415,8.2490122386,2.852462176,1.0022164402,19.495037101,20.497253541
2016,Pennsylvania,Pennsylvania,12784227,-7677,140897,133053,7844,34678,-45565,-10887,-4634,427424,11.01785098,10.404466571,0.6133844091,2.7117471364,-3.563087787,-0.85134065
2016,Pennsylvania,Adams County,102180,117,997,992,5,49,68,117,-5,4069,9.7628804904,9.7139192041,0.0489612863,0.4798206058,0.6658734938,1.1456940997
2016,Pennsylvania,Allegheny County,1225365,-3933,13193,13995,-802,3479,-5821,-2342,-789,36519,10.749337078,11.402787267,-0.653450188,2.8346049947,-4.742809909,-1.908204914
2016,Pennsylvania,Armstrong County,66486,-467,592,898,-306,5,-163,-158,-3,650,8.8729681727,13.459333478,-4.586365305,0.0749406096,-2.443063872,-2.368123262
2016,Pennsylvania,Beaver County,167429,-1479,1764,2129,-365,45,-1058,-1013,-101,3244,10.489479302,12.659921448,-2.170442146,0.2675887577,-6.291309014,-6.023720257
2016,Pennsylvania,Bedford County,48325,-197,441,531,-90,5,-78,-73,-34,551,9.1071483887,10.965750101,-1.858601712,0.1032556507,-1.61078815,-1.5075325
2016,Pennsylvania,Berks County,414812,177,4879,3821,1058,1448,-2146,-698,-183,11795,11.764464758,9.2133674605,2.5510972974,3.4914828796,-5.174531947,-1.683049068
2016,Pennsylvania,Blair County,124650,-856,1287,1673,-386,36,-473,-437,-33,3754,10.289579303,13.375653592,-3.08607429,0.2878204001,-3.781640256,-3.493819856
2016,Pennsylvania,Bradford County,60770,-559,715,716,-1,30,-540,-510,-48,577,11.711807632,11.728187782,-0.016380151,0.491404516,-8.845281288,-8.353876772
2016,Pennsylvania,Bucks County,626399,-422,5999,6027,-28,910,-986,-76,-318,8178,9.5737380508,9.6184229425,-0.044684892,1.4522589809,-1.573546544,-0.121287563
2016,Pennsylvania,Butler County,186847,406,1777,1967,-190,118,367,485,111,5501,9.5207989542,10.538779709,-1.017980755,0.6322196267,1.9663101948,2.5985298215
2016,Pennsylvania,Cambria County,134732,-1462,1259,1794,-535,56,-890,-834,-93,6281,9.294050774,13.243468696,-3.949417922,0.4133970162,-6.570059721,-6.156662705
2016,Pennsylvania,Cameron County,4677,-65,55,70,-15,2,-51,-49,-1,92,11.678522136,14.863573628,-3.185051492,0.4246735322,-10.82917507,-10.40450154
2016,Pennsylvania,Carbon County,63594,-342,572,785,-213,9,-99,-90,-39,700,8.9704383282,12.310828825,-3.340390496,0.1411432604,-1.552575865,-1.411432604
2016,Pennsylvania,Centre County,161464,973,1335,1039,296,1195,-430,765,-88,19306,8.2930844373,6.4543181501,1.8387662872,7.4233976798,-2.671180755,4.7522169247
2016,Pennsylvania,Chester County,516312,1059,5536,4092,1444,1415,-1459,-44,-341,13417,10.733206342,7.9335766529,2.7996296889,2.7434044389,-2.828711715,-0.085307276
2016,Pennsylvania,Clarion County,38513,-318,372,436,-64,38,-270,-232,-22,1376,9.6193628465,11.274306992,-1.654944146,0.9826230865,-6.981795614,-5.999172528
2016,Pennsylvania,Clearfield County,80596,-371,737,952,-215,95,-232,-137,-19,5576,9.1233760205,11.784876488,-2.661500467,1.1760118344,-2.87194469,-1.695932856
2016,Pennsylvania,Clinton County,39233,-126,407,395,12,20,-128,-108,-30,2437,10.357288274,10.051913681,0.3053745928,0.5089576547,-3.25732899,-2.748371336
2016,Pennsylvania,Columbia County,66420,-166,602,711,-109,38,-54,-16,-41,4280,9.052223208,10.691247011,-1.639023803,0.5714027939,-0.811993444,-0.24059065
2016,Pennsylvania,Crawford County,86257,-381,989,957,32,25,-381,-356,-57,3825,11.440469649,11.070302785,0.3701668643,0.2891928627,-4.407299228,-4.118106365
2016,Pennsylvania,Cumberland County,248506,1993,2661,2282,379,684,950,1634,-20,12631,10.751102483,9.219848127,1.5312543559,2.7635302887,3.8382365121,6.6017668009
2016,Pennsylvania,Dauphin County,273707,803,3509,2537,972,1062,-1127,-65,-104,6787,12.839112275,9.2826525628,3.5564597127,3.8857615379,-4.123590634,-0.237829096
2016,Pennsylvania,Delaware County,563402,81,6755,5534,1221,1803,-2597,-794,-346,22516,11.990524734,9.8231774802,2.1673472539,3.2004316944,-4.60982868,-1.409396986
2016,Pennsylvania,Elk County,30480,-399,281,376,-95,2,-291,-289,-15,355,9.1592105478,12.255740804,-3.096530256,0.0651901107,-9.485161101,-9.41997099
2016,Pennsylvania,Erie County,276207,-1845,3107,2808,299,779,-2784,-2005,-139,12787,11.211365084,10.132447105,1.0789179788,2.810960219,-10.04584499,-7.234884774
2016,Pennsylvania,Fayette County,132733,-971,1371,1872,-501,89,-462,-373,-97,4245,10.291363437,14.052102373,-3.760738936,0.6680753799,-3.467986804,-2.799911424
2016,Pennsylvania,Forest County,7321,-99,26,87,-61,4,-42,-38,0,2558,3.5275761482,11.803812496,-8.276236348,0.5427040228,-5.698392239,-5.155688217
2016,Pennsylvania,Franklin County,153851,556,1755,1602,153,275,167,442,-39,2544,11.427790041,10.431521166,0.9962688754,1.7906793512,1.0874307333,2.8781100845
2016,Pennsylvania,Fulton County,14640,35,152,139,13,7,25,32,-10,122,10.394939306,9.5058984442,0.8890408617,0.4787143101,1.7096939648,2.1884082749
2016,Pennsylvania,Greene County,37197,-241,378,441,-63,2,-163,-161,-17,2958,10.129295907,11.817511891,-1.688215984,0.0535941582,-4.367923896,-4.314329738
2016,Pennsylvania,Huntingdon County,45634,-87,451,519,-68,32,-9,23,-42,4814,9.8735701385,11.362268075,-1.488697937,0.7005637349,-0.19703355,0.5035301844
2016,Pennsylvania,Indiana County,86364,-613,852,898,-46,97,-653,-556,-11,5537,9.8303344275,10.361080183,-0.530745755,1.119181267,-7.534282138,-6.415100871
2016,Pennsylvania,Jefferson County,44073,-337,488,530,-42,10,-296,-286,-9,775,11.030367415,11.979702316,-0.9493349,0.2260321192,-6.690550727,-6.464518608
2016,Pennsylvania,Juniata County,24863,131,265,262,3,37,98,135,-7,292,10.686561145,10.565581208,0.1209799375,1.4920858958,3.9520112915,5.4440971872
2016,Pennsylvania,Lackawanna County,211321,-854,2164,2607,-443,711,-1025,-314,-97,7900,10.219695109,12.311804598,-2.092109489,3.3577648903,-4.840659652,-1.482894762
2016,Pennsylvania,Lancaster County,538500,2151,7185,5035,2150,1475,-1410,65,-64,12803,13.369319784,9.3687578441,4.0005619394,2.7445715631,-2.623624342,0.1209472214
2016,Pennsylvania,Lawrence County,87294,-742,912,1102,-190,31,-530,-499,-53,2089,10.403239605,12.57058119,-2.167341584,0.3536188901,-6.045742314,-5.692123424
2016,Pennsylvania,Lebanon County,138863,1134,1623,1478,145,663,279,942,47,3666,11.735697345,10.687221612,1.0484757332,4.7940649043,2.017411928,6.8114768323
2016,Pennsylvania,Lehigh County,363147,2295,4182,3373,809,2046,-424,1622,-136,9024,11.552502144,9.3176924278,2.2348097166,5.6519415082,-1.171272336,4.4806691722
2016,Pennsylvania,Luzerne County,316383,-1429,3138,4046,-908,713,-1028,-315,-206,11832,9.8960099023,12.759482494,-2.863472591,2.248519777,-3.241905092,-0.993385315
2016,Pennsylvania,Lycoming County,115248,-581,1298,1336,-38,71,-612,-541,-2,5311,11.234350455,11.563245152,-0.328894697,0.6145137768,-5.296935653,-4.682421877
2016,Pennsylvania,McKean County,41883,-533,403,519,-116,20,-410,-390,-27,3379,9.5612047592,12.313313325,-2.752108566,0.4745014769,-9.727280276,-9.252778799
2016,Pennsylvania,Mercer County,112913,-1079,1166,1476,-310,49,-722,-673,-96,6591,10.27742888,13.009849937,-2.732421057,0.4318988123,-6.363896785,-5.931997973
2016,Pennsylvania,Mifflin County,46342,-139,543,525,18,21,-149,-128,-29,560,11.6996865,11.311851589,0.3878349116,0.4524740635,-3.210411213,-2.757937149
2016,Pennsylvania,Monroe County,166098,-401,1421,1521,-100,355,-621,-266,-35,4452,8.5448756303,9.1462039646,-0.601328334,2.1347155867,-3.734248956,-1.599533369
2016,Pennsylvania,Montgomery County,821725,3362,8792,7797,995,2580,-446,2134,233,21566,10.721375926,9.5080263986,1.2133495276,3.1461726444,-0.543873256,2.6022993888
2016,Pennsylvania,Montour County,18343,-15,218,220,-2,43,-58,-15,2,841,11.879785292,11.988774148,-0.108988856,2.3432604016,-3.160676821,-0.817416419
2016,Pennsylvania,Northampton County,302294,1104,2818,2946,-128,823,573,1396,-164,11042,9.3391042679,9.7633077265,-0.424203459,2.7274956751,1.8989732951,4.6264689702
2016,Pennsylvania,Northumberland County,92541,-603,956,1111,-155,52,-479,-427,-21,3687,10.297008374,11.96650241,-1.669494036,0.5600883216,-5.159275116,-4.599186795
2016,Pennsylvania,Perry County,45820,141,564,430,134,12,23,35,-28,659,12.328003585,9.3990098252,2.9289937595,0.2622979486,0.5027377348,0.7650356835
2016,Pennsylvania,Philadelphia County,1567872,2908,22169,15245,6924,9689,-13622,-3933,-83,56675,14.152671892,9.7323958228,4.4202760694,6.1854498608,-8.696273919,-2.510824058
2016,Pennsylvania,Pike County,55562,-365,389,497,-108,90,-347,-257,0,478,6.9782669142,8.9156777799,-1.937410866,1.6145090547,-6.224829355,-4.610320301
2016,Pennsylvania,Potter County,16885,-156,179,215,-36,2,-124,-122,2,217,10.552378707,12.674644815,-2.122266109,0.1179036727,-7.310027707,-7.192124035
2016,Pennsylvania,Schuylkill County,143573,-748,1326,1849,-523,86,-187,-101,-124,6602,9.2117237594,12.845005453,-3.633281694,0.5974421141,-1.299089248,-0.701647134
2016,Pennsylvania,Snyder County,40468,-131,455,356,99,48,-263,-215,-15,2591,11.225282791,8.7828586231,2.4424241677,1.184205657,-6.488460163,-5.304254506
2016,Pennsylvania,Somerset County,75061,-588,693,960,-267,39,-304,-265,-56,4958,9.1964700418,12.739698759,-3.543228717,0.5175502621,-4.03423794,-3.516687678
2016,Pennsylvania,Sullivan County,6137,-155,43,102,-59,5,-108,-103,7,439,6.9193016333,16.41322713,-9.493925497,0.8045699574,-17.37871108,-16.57414112
2016,Pennsylvania,Susquehanna County,40862,-586,359,433,-74,5,-529,-524,12,282,8.7231199125,10.52120034,-1.798080428,0.1214919208,-12.85384522,-12.7323533
2016,Pennsylvania,Tioga County,41467,-166,447,461,-14,9,-151,-142,-10,1578,10.758122744,11.095066185,-0.336943442,0.2166064982,-3.634175692,-3.417569194
2016,Pennsylvania,Union County,45565,71,386,408,-22,67,19,86,7,9370,8.4780197454,8.9612229434,-0.483203198,1.4715733755,0.4173118528,1.8888852283
2016,Pennsylvania,Venango County,52582,-519,533,680,-147,4,-339,-335,-37,1301,10.086768922,12.868673297,-2.781904374,0.0756980782,-6.415412129,-6.339714051
2016,Pennsylvania,Warren County,40025,-319,394,519,-125,21,-184,-163,-31,760,9.8047754731,12.91542759,-3.110652117,0.5225895557,-4.578879916,-4.056290361
2016,Pennsylvania,Washington County,207981,-287,2001,2541,-540,179,170,349,-96,5516,9.6144375122,12.20903834,-2.594600828,0.8600621263,0.8168187791,1.6768809054
2016,Pennsylvania,Wayne County,50710,-381,399,560,-161,10,-202,-192,-28,3881,7.8388228013,11.001856563,-3.163033762,0.1964617243,-3.968526832,-3.772065107
2016,Pennsylvania,Westmoreland County,355458,-2241,3040,4523,-1483,108,-685,-577,-181,6973,8.5254719508,12.684443958,-4.158972008,0.3028786088,-1.92103562,-1.618157012
2016,Pennsylvania,Wyoming County,27521,-235,270,318,-48,17,-194,-177,-10,607,9.7689816741,11.505689527,-1.736707853,0.6150840313,-7.01919424,-6.404110209
2016,Pennsylvania,York County,443744,1815,4872,3997,875,733,532,1265,-325,8745,11.001803149,9.0259045946,1.975898554,1.6552384458,1.2013463208,2.8565847666
2016,Rhode Island,Rhode Island,1056426,819,10770,9849,921,4203,-3784,419,-521,42752,10.198704282,9.326558818,0.8721454636,3.9800514481,-3.583277345,0.3967741034
2016,Rhode Island,Bristol County,49067,-198,334,536,-202,91,-51,40,-36,2709,6.7933124517,10.901842737,-4.108530285,1.8508725542,-1.037302201,0.8135703535
2016,Rhode Island,Kent County,164614,-4,1566,1716,-150,92,115,207,-61,1565,9.5130485494,10.424260096,-0.911211547,0.5588764154,0.6985955193,1.2574719347
2016,Rhode Island,Newport County,82784,-132,672,729,-57,227,-253,-26,-49,3973,8.1110440555,8.7990343995,-0.687990344,2.7398913699,-3.053711527,-0.313820157
2016,Rhode Island,Providence County,633673,1185,7312,5674,1638,3689,-3763,-74,-379,27473,11.549873989,8.9625253029,2.5873486863,5.827063067,-5.943951836,-0.116888768
2016,Rhode Island,Washington County,126288,-32,886,1194,-308,104,168,272,4,7032,7.0148213833,9.4533823157,-2.438560932,0.823410185,1.3301241449,2.1535343299
2016,South Carolina,South Carolina,4961119,66285,57926,47514,10412,5760,47084,52844,3029,136582,11.754520339,9.6416855884,2.1128347507,1.1688367426,9.5544286788,10.723265421
2016,South Carolina,Abbeville County,24872,-99,245,261,-16,23,-101,-78,-5,963,9.8308689284,10.472884858,-0.64201593,0.9228978994,-4.052725558,-3.129827659
2016,South Carolina,Aiken County,167458,1347,1927,1766,161,178,978,1156,30,2268,11.553831441,10.588513921,0.9653175205,1.0672454575,5.863854255,6.9310997125
2016,South Carolina,Allendale County,9045,-375,82,103,-21,1,-358,-357,3,1185,8.8816680206,11.156241538,-2.274573517,0.1083130246,-38.77606282,-38.6677498
2016,South Carolina,Anderson County,196569,2037,2273,2130,143,196,1735,1931,-37,2907,11.623595951,10.892327046,0.731268905,1.002298639,8.8723884623,9.8746871013
2016,South Carolina,Bamberg County,14434,-197,132,179,-47,5,-166,-161,11,995,9.0830896267,12.317220024,-3.234130397,0.3440564253,-11.42267332,-11.07861689
2016,South Carolina,Barnwell County,21483,-223,251,277,-26,-2,-196,-198,1,285,11.623330015,12.827340295,-1.20401028,-0.092616175,-9.076385191,-9.169001366
2016,South Carolina,Beaufort County,183149,3367,2058,1557,501,338,2260,2598,268,5234,11.340998702,8.580143333,2.7608553692,1.8626130036,12.454157953,14.316770956
2016,South Carolina,Berkeley County,210898,8122,2695,1454,1241,363,6319,6682,199,3611,13.029583682,7.0296900458,5.9998936361,1.755005149,30.550626822,32.305631971
2016,South Carolina,Calhoun County,14796,-6,134,186,-52,6,28,34,12,155,9.0546658558,12.568416785,-3.513750929,0.4054327995,1.8920197311,2.2974525306
2016,South Carolina,Charleston County,396484,7193,5051,3412,1639,387,4959,5346,208,10617,12.856097483,8.6844198403,4.1716776431,0.9850147943,12.62193376,13.606948554
2016,South Carolina,Cherokee County,56646,153,680,591,89,-4,107,103,-39,1181,12.020611814,10.447325856,1.573285958,-0.070709481,1.8914786236,1.8207691424
2016,South Carolina,Chester County,32181,-104,378,402,-24,-1,-59,-60,-20,218,11.727111966,12.471690504,-0.744578538,-0.031024106,-1.830422238,-1.861446344
2016,South Carolina,Chesterfield County,46013,-23,512,549,-37,37,4,41,-27,874,11.124509772,11.928429423,-0.803919651,0.8039196515,0.0869102326,0.8908298841
2016,South Carolina,Clarendon County,33951,148,334,375,-41,1,187,188,1,1598,9.859196505,11.069457154,-1.210260649,0.0295185524,5.5199693007,5.5494878531
2016,South Carolina,Colleton County,37923,183,456,569,-113,-9,232,223,73,388,12.053447524,15.040376406,-2.986928882,-0.237896991,6.1324557578,5.8945587672
2016,South Carolina,Darlington County,67234,-300,807,824,-17,22,-290,-268,-15,1378,11.976136768,12.228422177,-0.252285409,0.3264869999,-4.303692271,-3.977205271
2016,South Carolina,Dillon County,30858,-377,404,375,29,60,-456,-396,-10,482,13.012738956,12.078656209,0.9340827468,1.9325849935,-14.68764595,-12.75506096
2016,South Carolina,Dorchester County,153773,1237,1916,1086,830,156,193,349,58,1879,12.510242925,7.0908788184,5.4193641062,1.0185792778,1.2601653885,2.2787446663
2016,South Carolina,Edgefield County,26358,-145,202,260,-58,7,-81,-74,-13,2806,7.6426855338,9.8371199939,-2.19443446,0.2648455383,-3.064641229,-2.799795691
2016,South Carolina,Fairfield County,22653,-227,194,282,-88,31,-150,-119,-20,397,8.5212922496,12.386620693,-3.865328443,1.3616497925,-6.588628028,-5.226978236
2016,South Carolina,Florence County,138742,-65,1705,1516,189,67,-335,-268,14,3314,12.286118847,10.924197169,1.3619216787,0.4827976321,-2.413988161,-1.931190529
2016,South Carolina,Georgetown County,61399,156,558,813,-255,40,308,348,63,553,9.0996559091,13.258100814,-4.158444905,0.6523050831,5.0227491398,5.6750542229
2016,South Carolina,Greenville County,498766,8105,6441,4224,2217,903,4757,5660,228,11155,13.019656832,8.5382751835,4.4813816482,1.8252988851,9.6156664413,11.440965326
2016,South Carolina,Greenwood County,70133,231,844,777,67,129,48,177,-13,2431,12.054129325,11.097225694,0.9569036312,1.8423965437,0.6855429,2.5279394437
2016,South Carolina,Hampton County,19922,-134,209,237,-28,-1,-117,-118,12,1533,10.455750663,11.856521087,-1.400770424,-0.050027515,-5.853219271,-5.903246786
2016,South Carolina,Horry County,322342,12471,3133,3302,-169,387,10870,11257,1383,3725,9.9112166311,10.445846574,-0.534629943,1.224270934,34.387144839,35.611415773
2016,South Carolina,Jasper County,28465,576,366,261,105,34,309,343,128,1488,12.989317528,9.2628739752,3.7264435533,1.2066579125,10.966391028,12.173048941
2016,South Carolina,Kershaw County,64097,576,739,740,-1,33,553,586,-9,402,11.581438355,11.597110126,-0.01567177,0.5171684245,8.6664890533,9.1836574778
2016,South Carolina,Lancaster County,89594,3568,1043,886,157,60,2989,3049,362,1962,11.877918233,10.089966974,1.7879512584,0.6832934745,34.039403257,34.722696732
2016,South Carolina,Laurens County,66777,232,746,831,-85,22,262,284,33,2402,11.190951231,12.466059615,-1.275108384,0.3300280524,3.9303340784,4.2603621308
2016,South Carolina,Lee County,17635,-230,161,284,-123,1,-118,-117,10,1651,9.0704225352,16.0,-6.929577465,0.0563380282,-6.647887324,-6.591549296
2016,South Carolina,Lexington County,286196,4641,3220,2384,836,356,3402,3758,47,2336,11.343000717,8.3980477357,2.9449529811,1.2540708867,11.984126844,13.238197731
2016,South Carolina,McCormick County,9643,-59,67,144,-77,-3,13,10,8,1119,6.9268544844,14.887567847,-7.960713363,-0.310157663,1.3440165417,1.0338588783
2016,South Carolina,Marion County,31726,-3,386,443,-57,26,33,59,-5,204,12.166101962,13.962650697,-1.796548735,0.8194783705,1.0401071626,1.8595855331
2016,South Carolina,Marlboro County,26945,-596,310,305,5,19,-629,-610,9,2909,11.379069853,11.195536468,0.1835333847,0.6974268619,-23.0884998,-22.39107294
2016,South Carolina,Newberry County,38079,183,451,441,10,28,158,186,-13,1191,11.872326423,11.609081935,0.2632444883,0.7370845673,4.1592629154,4.8963474827
2016,South Carolina,Oconee County,76355,611,782,904,-122,58,685,743,-10,792,10.28277635,11.886994655,-1.604218305,0.7626611615,9.0072913037,9.7699524652
2016,South Carolina,Orangeburg County,87903,-966,954,1118,-164,22,-785,-763,-39,2932,10.793564592,12.649062069,-1.855497477,0.2489081981,-8.88149707,-8.632588872
2016,South Carolina,Pickens County,122863,1370,1284,1141,143,242,972,1214,13,6829,10.509256986,9.3388335052,1.1704234805,1.9807166593,7.9556057555,9.9363224148
2016,South Carolina,Richland County,409549,2707,4888,3108,1780,902,132,1034,-107,31335,11.974654302,7.6139986845,4.3606556172,2.2097254869,0.3233744615,2.5330999484
2016,South Carolina,Saluda County,20197,26,254,192,62,44,-65,-21,-15,265,12.584225129,9.5124851367,3.0717399921,2.1799445105,-3.220372572,-1.040428062
2016,South Carolina,Spartanburg County,301463,4375,3604,2986,618,234,3434,3668,89,8228,12.042415767,9.9774288239,2.0649869435,0.7818882601,11.474377288,12.256265548
2016,South Carolina,Sumter County,107396,14,1446,1055,391,133,-497,-364,-13,2666,13.465066254,9.8240974401,3.6409688143,1.2384881133,-4.628034529,-3.389546415
2016,South Carolina,Union County,27673,-102,313,377,-64,0,-40,-40,2,499,11.289857163,13.59832636,-2.308469196,0.0,-1.442793248,-1.442793248
2016,South Carolina,Williamsburg County,31955,-618,347,395,-48,15,-562,-547,-23,1284,10.755021076,12.242747334,-1.487726258,0.4649144557,-17.41879494,-16.95388049
2016,South Carolina,York County,258526,7505,2944,2012,932,214,6162,6376,197,3956,11.55536192,7.8972106597,3.6581512598,0.83996177,24.186188909,25.026150679
2016,South Dakota,South Dakota,865454,7535,12114,7296,4818,1632,941,2573,144,34010,14.058477184,8.4671165209,5.5913606631,1.8939602744,1.0920444965,2.9860047709
2016,South Dakota,Aurora County,2736,10,37,20,17,4,-15,-11,4,95,13.54815086,7.3233247895,6.224826071,1.4646649579,-5.492493592,-4.027828634
2016,South Dakota,Beadle County,18101,-105,327,198,129,148,-376,-228,-6,621,18.013055334,10.906987633,7.1060677004,8.1526978269,-20.71225934,-12.55956152
2016,South Dakota,Bennett County,3460,29,66,30,36,0,-8,-8,1,37,19.155420113,8.7070091424,10.448410971,0.0,-2.321869105,-2.321869105
2016,South Dakota,Bon Homme County,6984,9,66,67,-1,2,3,5,5,1544,9.4562647754,9.5995415144,-0.143276739,0.286553478,0.4298302171,0.7163836951
2016,South Dakota,Brookings County,34135,238,434,195,239,140,-140,0,-1,3599,12.758701787,5.7325964252,7.0261053622,4.115710254,-4.115710254,0.0
2016,South Dakota,Brown County,39128,429,481,354,127,148,184,332,-30,1366,12.36074884,9.0970999782,3.2636488622,3.8033073355,4.7284361468,8.5317434823
2016,South Dakota,Brule County,5238,-44,70,47,23,0,-76,-76,9,132,13.307984791,8.9353612167,4.3726235741,0.0,-14.4486692,-14.4486692
2016,South Dakota,Buffalo County,2043,-56,48,33,15,0,-72,-72,1,3,23.177209078,15.934331241,7.2428778368,0.0,-34.76581362,-34.76581362
2016,South Dakota,Butte County,10205,-58,121,107,14,-1,-65,-66,-6,111,11.823333985,10.455344929,1.3679890561,-0.097713504,-6.35137776,-6.449091264
2016,South Dakota,Campbell County,1378,-26,12,7,5,3,-42,-39,8,0,8.6268871316,5.0323508267,3.5945363048,2.1567217829,-30.19410496,-28.03738318
2016,South Dakota,Charles Mix County,9396,22,173,116,57,2,-29,-27,-8,589,18.433670751,12.360149174,6.073521577,0.2131060202,-3.090037294,-2.876931273
2016,South Dakota,Clark County,3656,-9,62,37,25,16,-54,-38,4,489,16.937576834,10.107908756,6.8296680781,4.37098757,-14.75208305,-10.38109548
2016,South Dakota,Clay County,14086,135,135,90,45,39,52,91,-1,2247,9.6301316118,6.4200877412,3.2100438706,2.7820380212,3.7093840282,6.4914220494
2016,South Dakota,Codington County,28063,150,371,223,148,29,-30,-1,3,381,13.255681006,7.967700443,5.2879805631,1.0361583536,-1.071887952,-0.035729598
2016,South Dakota,Corson County,4132,-81,82,49,33,2,-125,-123,9,1,19.652486519,11.743559017,7.9089275015,0.4793289395,-29.95805872,-29.47872978
2016,South Dakota,Custer County,8596,146,70,81,-11,1,153,154,3,252,8.2130705151,9.5036958817,-1.290625367,0.1173295788,17.951425554,18.068755133
2016,South Dakota,Davison County,19903,112,254,184,70,13,42,55,-13,769,12.797903965,9.2709225576,3.5269814078,0.6550108329,2.1161888447,2.7711996775
2016,South Dakota,Day County,5571,7,63,76,-13,7,19,26,-6,139,11.315671307,13.6506511,-2.334979793,1.2572968119,3.412662775,4.6699595869
2016,South Dakota,Deuel County,4231,-88,47,38,9,3,-109,-106,9,50,10.994152047,8.8888888889,2.1052631579,0.701754386,-25.49707602,-24.79532164
2016,South Dakota,Dewey County,5742,41,145,92,53,0,-13,-13,1,19,25.343004457,16.07969938,9.2633050773,0.0,-2.272131434,-2.272131434
2016,South Dakota,Douglas County,2932,-44,39,34,5,0,-46,-46,-3,178,13.202437373,11.509817197,1.692620176,0.0,-15.57210562,-15.57210562
2016,South Dakota,Edmunds County,3952,-57,51,36,15,4,-83,-79,7,420,12.812460746,9.0440899384,3.7683708077,1.004898882,-20.8516518,-19.84675292
2016,South Dakota,Fall River County,6849,11,61,100,-39,1,55,56,-6,211,8.9135676189,14.612405933,-5.698838314,0.1461240593,8.036823263,8.1829473223
2016,South Dakota,Faulk County,2354,20,37,21,16,0,2,2,2,497,15.784982935,8.9590443686,6.8259385666,0.0,0.8532423208,0.8532423208
2016,South Dakota,Grant County,7148,37,87,79,8,7,25,32,-3,104,12.202819272,11.080720948,1.1220983239,0.9818360334,3.5065572621,4.4883932955
2016,South Dakota,Gregory County,4171,-27,55,49,6,0,-36,-36,3,44,13.143744772,11.709881706,1.4338630661,0.0,-8.603178396,-8.603178396
2016,South Dakota,Haakon County,1892,33,19,14,5,0,28,28,0,36,10.130631832,7.4646760864,2.6659557451,0.0,14.929352173,14.929352173
2016,South Dakota,Hamlin County,6028,-18,119,60,59,4,-90,-86,9,245,19.711777373,9.9387112804,9.7730660924,0.662580752,-14.90806692,-14.24548617
2016,South Dakota,Hand County,3319,-12,33,29,4,0,-14,-14,-2,61,9.9248120301,8.7218045113,1.2030075188,0.0,-4.210526316,-4.210526316
2016,South Dakota,Hanson County,3374,-14,39,10,29,1,-62,-61,18,520,11.535048802,2.9577048211,8.5773439811,0.2957704821,-18.33776989,-18.04199941
2016,South Dakota,Harding County,1278,7,19,4,15,5,-15,-10,2,29,14.907806983,3.1384856807,11.769321302,3.9231071008,-11.7693213,-7.846214202
2016,South Dakota,Hughes County,17600,79,231,166,65,-4,-6,-10,24,771,13.154522935,9.4530337974,3.7014891376,-0.227783947,-0.34167592,-0.569459867
2016,South Dakota,Hutchinson County,7368,52,115,107,8,7,33,40,4,832,15.663307001,14.573685644,1.0896213566,0.953418687,4.4946880959,5.4481067829
2016,South Dakota,Hyde County,1352,-45,12,10,2,2,-50,-48,1,38,8.7304474354,7.2753728629,1.4550745726,1.4550745726,-36.37686431,-34.92178974
2016,South Dakota,Jackson County,3326,13,69,29,40,12,-43,-31,4,42,20.786262991,8.7362554602,12.050007531,3.6150022594,-12.9537581,-9.338755837
2016,South Dakota,Jerauld County,2004,-11,23,19,4,6,-25,-19,4,176,11.445633242,9.4550883304,1.9905449117,2.9858173675,-12.4409057,-9.45508833
2016,South Dakota,Jones County,927,7,8,7,1,1,-2,-1,7,0,8.6626962642,7.5798592312,1.082837033,1.082837033,-2.165674066,-1.082837033
2016,South Dakota,Kingsbury County,5001,21,61,64,-3,2,20,22,2,203,12.223224126,12.824366296,-0.60114217,0.4007614467,4.0076144675,4.4083759142
2016,South Dakota,Lake County,12909,320,129,116,13,19,244,263,44,875,10.118440662,9.0987528434,1.0196878187,1.4903129657,19.138755981,20.629068947
2016,South Dakota,Lawrence County,25281,395,235,217,18,24,373,397,-20,1072,9.3687085136,8.6511053083,0.7176032053,0.9568042737,14.870333087,15.827137361
2016,South Dakota,Lincoln County,54469,1643,758,220,538,16,990,1006,99,284,14.12926977,4.1008434689,10.028426301,0.2982431614,18.45379561,18.752038772
2016,South Dakota,Lyman County,3894,14,74,25,49,0,-46,-46,11,36,19.037818369,6.4316953949,12.606122974,0.0,-11.83431953,-11.83431953
2016,South Dakota,McCook County,5625,50,81,77,4,6,29,35,11,312,14.464285714,13.75,0.7142857143,1.0714285714,5.1785714286,6.25
2016,South Dakota,McPherson County,2438,34,29,23,6,0,32,32,-4,347,11.978521272,9.5002065262,2.478314746,0.0,13.217678645,13.217678645
2016,South Dakota,Marshall County,4801,14,74,41,33,19,-34,-15,-4,373,15.435961619,8.5523571131,6.8836045056,3.9632874426,-7.092198582,-3.128911139
2016,South Dakota,Meade County,27693,645,303,190,113,62,446,508,24,798,11.070312928,6.941780384,4.1285325442,2.2652125464,16.294916059,18.560128606
2016,South Dakota,Mellette County,2102,52,36,17,19,2,29,31,2,49,17.341040462,8.1888246628,9.1522157996,0.9633911368,13.969171484,14.93256262
2016,South Dakota,Miner County,2281,35,24,23,1,4,27,31,3,80,10.603048376,10.161254694,0.4417936824,1.7671747294,11.928429423,13.695604153
2016,South Dakota,Minnehaha County,187318,2033,2974,1396,1578,735,-167,568,-113,6275,15.963371202,7.4932300599,8.4701411422,3.9452178324,-0.896396433,3.0488213997
2016,South Dakota,Moody County,6505,79,96,46,50,30,-5,25,4,164,14.848039595,7.1146856392,7.7333539556,4.6400123734,-0.773335396,3.8666769778
2016,South Dakota,Oglala Lakota County,14415,32,313,174,139,1,-115,-114,7,91,21.737620668,12.084172512,9.6534481561,0.0694492673,-7.986665741,-7.917216473
2016,South Dakota,Pennington County,109372,811,1493,892,601,65,121,186,24,2568,13.701458705,8.1860021199,5.5154565853,0.5965136074,1.110433023,1.7069466304
2016,South Dakota,Perkins County,2983,-19,33,24,9,0,-27,-27,-1,65,11.027568922,8.0200501253,3.007518797,0.0,-9.022556391,-9.022556391
2016,South Dakota,Potter County,2299,-14,23,33,-10,0,-11,-11,7,63,9.9739809193,14.310494363,-4.336513443,0.0,-4.770164788,-4.770164788
2016,South Dakota,Roberts County,10255,-20,175,96,79,9,-109,-100,1,281,17.048222114,9.3521675597,7.6960545543,0.8767657087,-10.61860692,-9.741841208
2016,South Dakota,Sanborn County,2396,32,37,15,22,4,2,6,4,174,15.546218487,6.3025210084,9.243697479,1.6806722689,0.8403361345,2.5210084034
2016,South Dakota,Spink County,6420,-58,67,74,-7,0,-51,-51,0,405,10.389207629,11.474647232,-1.085439603,0.0,-7.908202822,-7.908202822
2016,South Dakota,Stanley County,2993,42,40,9,31,0,12,12,-1,0,13.458950202,3.0282637954,10.430686406,0.0,4.0376850606,4.0376850606
2016,South Dakota,Sully County,1421,4,14,6,8,3,-11,-8,4,0,9.8661028894,4.2283298097,5.6377730796,2.1141649049,-7.751937984,-5.63777308
2016,South Dakota,Todd County,10155,150,271,118,153,0,-17,-17,14,28,26.884920635,11.706349206,15.178571429,0.0,-1.686507937,-1.686507937
2016,South Dakota,Tripp County,5492,79,69,66,3,-1,83,82,-6,131,12.65474553,12.104539202,0.5502063274,-0.183402109,15.222375057,15.038972948
2016,South Dakota,Turner County,8317,114,86,97,-11,0,124,124,1,152,10.411622276,11.743341404,-1.331719128,0.0,15.012106538,15.012106538
2016,South Dakota,Union County,14934,103,152,107,45,-3,66,63,-5,89,10.213337813,7.1896522762,3.0236855367,-0.201579036,4.4347387872,4.2331597514
2016,South Dakota,Walworth County,5610,90,87,74,13,31,51,82,-5,152,15.633423181,13.297394429,2.3360287511,5.5705300988,9.1644204852,14.734950584
2016,South Dakota,Yankton County,22616,-50,267,213,54,2,-88,-86,-18,2295,11.792765337,9.4077116735,2.3850536637,0.0883353209,-3.886754119,-3.798418798
2016,South Dakota,Ziebach County,2801,12,32,25,7,0,3,3,2,0,11.4490161,8.9445438283,2.5044722719,0.0,1.0733452594,1.0733452594
2016,Tennessee,Tennessee,6651194,56138,81443,65454,15989,9440,30519,39959,190,152979,12.296763235,9.8826460319,2.414117203,1.4253090497,4.607945645,6.0332546947
2016,Tennessee,Anderson County,75936,238,802,892,-90,65,257,322,6,1184,10.578102536,11.7651714,-1.187068863,0.8573275123,3.3897410871,4.2470685994
2016,Tennessee,Bedford County,47484,544,628,444,184,30,339,369,-9,545,13.301702957,9.4043887147,3.8973142421,0.6354316699,7.18037787,7.8158095399
2016,Tennessee,Benton County,16014,-93,156,246,-90,1,-19,-18,15,162,9.7132716914,15.317082283,-5.603810591,0.0622645621,-1.18302668,-1.120762118
2016,Tennessee,Bledsoe County,14675,95,132,150,-18,0,123,123,-10,2522,9.0240984447,10.254657324,-1.230558879,0.0,8.4088190053,8.4088190053
2016,Tennessee,Blount County,128670,1528,1284,1294,-10,71,1436,1507,31,2033,10.038622113,10.116804528,-0.078182415,0.555095148,11.226994824,11.782089972
2016,Tennessee,Bradley County,104490,583,1181,1029,152,151,275,426,5,2685,11.334136288,9.8753820832,1.4587542047,1.4491571376,2.6391934625,4.0883506001
2016,Tennessee,Campbell County,39714,-14,426,575,-149,-6,170,164,-29,519,10.724805518,14.47596989,-3.751164371,-0.151053599,4.2798519675,4.1287983686
2016,Tennessee,Cannon County,14027,173,154,156,-2,13,164,177,-2,164,11.046949536,11.190416413,-0.143466877,0.9325347011,11.764283921,12.696818622
2016,Tennessee,Carroll County,28092,-39,308,429,-121,10,75,85,-3,1271,10.956370169,15.260658449,-4.304288281,0.3557263042,2.6679472814,3.0236735855
2016,Tennessee,Carter County,56502,72,521,711,-190,22,266,288,-26,915,9.2267913435,12.591648071,-3.364856728,0.3896149896,4.7107994191,5.1004144087
2016,Tennessee,Cheatham County,39880,190,456,409,47,3,144,147,-4,283,11.461606133,10.280256378,1.1813497549,0.0754053035,3.6194545683,3.6948598718
2016,Tennessee,Chester County,17453,40,189,151,38,2,3,5,-3,1293,10.841507486,8.6617334939,2.1797739919,0.1147249469,0.1720874204,0.2868123673
2016,Tennessee,Claiborne County,31757,70,304,427,-123,20,189,209,-16,1258,9.5832545237,13.460689742,-3.877435218,0.6304772713,5.9580102137,6.588487485
2016,Tennessee,Clay County,7752,-21,76,116,-40,4,8,12,7,96,9.7906602254,14.943639291,-5.152979066,0.5152979066,1.0305958132,1.5458937198
2016,Tennessee,Cocke County,35219,123,385,489,-104,6,227,233,-6,294,10.950721752,13.908838797,-2.958117045,0.1706605987,6.4566593188,6.6273199175
2016,Tennessee,Coffee County,54682,403,702,655,47,15,345,360,-4,557,12.885344298,12.022650306,0.8626939914,0.2753278696,6.3325410009,6.6078688705
2016,Tennessee,Crockett County,14411,-155,167,180,-13,4,-144,-140,-2,194,11.526382993,12.42364634,-0.897263347,0.2760810298,-9.938917072,-9.662836042
2016,Tennessee,Cumberland County,58655,377,560,819,-259,44,604,648,-12,636,9.5781344873,14.008021688,-4.4298872,0.7525677097,10.330702197,11.083269907
2016,Tennessee,Davidson County,684410,6087,10438,5461,4977,3091,-2039,1052,58,26549,15.319215136,8.0147761887,7.3044389473,4.5364719281,-2.992515775,1.5439561528
2016,Tennessee,Decatur County,11769,112,127,170,-43,10,144,154,1,213,10.842653462,14.513788099,-3.671134637,0.8537522411,12.294032272,13.147784513
2016,Tennessee,DeKalb County,19361,156,237,218,19,28,123,151,-14,298,12.29061868,11.305294819,0.9853238604,1.4520562153,6.3786755173,7.8307317326
2016,Tennessee,Dickson County,52170,709,646,508,138,-6,572,566,5,617,12.467311905,9.8040161728,2.663295732,-0.115795467,11.039167817,10.92337235
2016,Tennessee,Dyer County,37708,-170,466,439,27,24,-207,-183,-14,516,12.330325722,11.615907708,0.7144180139,0.6350382346,-5.477204773,-4.842166539
2016,Tennessee,Fayette County,39590,370,429,427,2,14,344,358,10,424,10.886943281,10.836188301,0.0507549803,0.3552848623,8.7298566172,9.0851414795
2016,Tennessee,Fentress County,18033,116,185,255,-70,-1,159,158,28,132,10.292072323,14.186369958,-3.894297636,-0.055632823,8.8456189152,8.7899860918
2016,Tennessee,Franklin County,41700,186,389,464,-75,49,234,283,-22,2086,9.3493883241,11.15196962,-1.802581296,1.177686447,5.6240536448,6.8017400918
2016,Tennessee,Gibson County,49401,-41,618,664,-46,7,26,33,-28,991,12.504679138,13.435448135,-0.930768997,0.1416387605,0.5260868246,0.667725585
2016,Tennessee,Giles County,29307,228,319,350,-31,51,206,257,2,702,10.927277087,11.989175487,-1.0618984,1.7469941424,7.0564861439,8.8034802864
2016,Tennessee,Grainger County,23072,237,226,289,-63,2,308,310,-10,151,9.8459929858,12.590672446,-2.744679461,0.0871326813,13.418432919,13.5055656
2016,Tennessee,Greene County,68615,64,649,872,-223,26,276,302,-15,1753,9.4629864544,12.714521091,-3.251534637,0.3791026931,4.0243208958,4.4034235889
2016,Tennessee,Grundy County,13389,-67,150,188,-38,0,-21,-21,-8,180,11.175265413,14.00633265,-2.831067238,0.0,-1.564537158,-1.564537158
2016,Tennessee,Hamblen County,63785,371,766,711,55,121,220,341,-25,918,12.044119844,11.179333171,0.8647866729,1.9025306803,3.4591466914,5.3616773717
2016,Tennessee,Hamilton County,357738,4134,4227,3529,698,527,2958,3485,-49,9599,11.884578726,9.9220909211,1.9624878047,1.4817064085,8.3166746797,9.7983810881
2016,Tennessee,Hancock County,6577,23,64,99,-35,0,49,49,9,149,9.7479247582,15.07882111,-5.330896352,0.0,7.463254893,7.463254893
2016,Tennessee,Hardeman County,25435,-297,263,284,-21,0,-270,-270,-6,3799,10.280063322,11.10090488,-0.820841558,0.0,-10.55367717,-10.55367717
2016,Tennessee,Hardin County,25679,-39,271,344,-73,2,53,55,-21,371,10.54536257,13.385995292,-2.840632722,0.077825554,2.0623771815,2.1402027356
2016,Tennessee,Hawkins County,56563,120,551,725,-174,2,327,329,-35,456,9.7516946003,12.831177106,-3.079482505,0.0353963506,5.787303329,5.8226996797
2016,Tennessee,Haywood County,17853,-175,194,220,-26,7,-154,-147,-2,174,10.813522477,12.262757448,-1.449234971,0.3901786461,-8.583930214,-8.193751568
2016,Tennessee,Henderson County,27822,-162,317,329,-12,0,-143,-143,-7,218,11.360785579,11.790846862,-0.430061284,0.0,-5.124896964,-5.124896964
2016,Tennessee,Henry County,32310,105,314,469,-155,22,260,282,-22,491,9.734170348,14.539254437,-4.805084089,0.6820119352,8.0601410525,8.7421529877
2016,Tennessee,Hickman County,24295,-20,279,256,23,2,-42,-40,-3,1188,11.479119523,10.532812179,0.9463073442,0.0822875951,-1.728039498,-1.645751903
2016,Tennessee,Houston County,8134,3,85,92,-7,2,13,15,-5,177,10.451890563,11.312634491,-0.860743929,0.2459268368,1.598524439,1.8444512757
2016,Tennessee,Humphreys County,18347,225,196,242,-46,4,278,282,-11,205,10.748855192,13.271545696,-2.522690504,0.2193643917,15.245825221,15.465189613
2016,Tennessee,Jackson County,11566,49,94,168,-74,0,129,129,-6,177,8.1445219426,14.556166876,-6.411644934,0.0,11.177056708,11.177056708
2016,Tennessee,Jefferson County,53535,247,542,652,-110,42,276,318,39,1640,10.147627384,12.207108956,-2.059481572,0.7863475094,5.1674264905,5.953774
2016,Tennessee,Johnson County,17754,-67,155,202,-47,1,-27,-26,6,1792,8.7139845397,11.356289529,-2.642304989,0.0562192551,-1.517919888,-1.461700632
2016,Tennessee,Knox County,456132,4688,5285,4321,964,598,3020,3618,106,12125,11.646407574,9.5220675734,2.1243400002,1.3177959752,6.655090042,7.9728860173
2016,Tennessee,Lake County,7560,-12,63,95,-32,0,17,17,3,2501,8.3267248216,12.55617235,-4.229447528,0.0,2.2468939995,2.2468939995
2016,Tennessee,Lauderdale County,26773,-186,286,277,9,24,-224,-200,5,2505,10.645425445,10.310429539,0.3349959056,0.8933224149,-8.337675873,-7.444353458
2016,Tennessee,Lawrence County,43081,550,574,502,72,18,473,491,-13,407,13.40933514,11.727327945,1.6820071953,0.4205017988,11.049852824,11.470354623
2016,Tennessee,Lewis County,11904,38,136,137,-1,0,49,49,-10,217,11.442995372,11.527135044,-0.084139672,0.0,4.1228439209,4.1228439209
2016,Tennessee,Lincoln County,33645,-50,313,386,-73,23,15,38,-15,283,9.2961092961,11.464211464,-2.168102168,0.6831006831,0.4455004455,1.1286011286
2016,Tennessee,Loudon County,51454,476,511,588,-77,8,547,555,-2,480,9.9773508279,11.480787254,-1.503436426,0.1562011871,10.68025617,10.836457357
2016,Tennessee,McMinn County,52850,214,556,637,-81,96,228,324,-29,965,10.541683257,12.077432076,-1.53574882,1.8201467493,4.3228485297,6.142995279
2016,Tennessee,McNairy County,25935,-62,254,338,-84,0,15,15,7,313,9.782022645,13.01702226,-3.234999615,0.0,0.5776785027,0.5776785027
2016,Tennessee,Macon County,23450,342,356,276,80,39,233,272,-10,269,15.292753125,11.856179389,3.436573736,1.6753296963,10.009021006,11.684350702
2016,Tennessee,Madison County,97663,54,1219,990,229,76,-283,-207,32,4431,12.48514892,10.139702569,2.3454463518,0.7784014093,-2.898521037,-2.120119628
2016,Tennessee,Marion County,28446,-16,322,354,-32,6,18,24,-8,250,11.31651086,12.441133057,-1.124622197,0.210866662,0.6325999859,0.8434666479
2016,Tennessee,Marshall County,31915,397,384,332,52,20,345,365,-20,359,12.107262781,10.467737613,1.6395251683,0.6305866032,10.877618905,11.508205508
2016,Tennessee,Maury County,89981,2246,1157,912,245,121,1819,1940,61,1009,13.020774719,10.263566589,2.7572081298,1.3617231988,20.470863625,21.832586824
2016,Tennessee,Meigs County,12005,133,121,153,-32,-1,151,150,15,128,10.135276626,12.815680362,-2.680403736,-0.083762617,12.648155128,12.564392512
2016,Tennessee,Monroe County,45970,293,505,547,-42,28,308,336,-1,520,11.020546226,11.937106506,-0.91656028,0.6110401868,6.7214420548,7.3324822416
2016,Tennessee,Montgomery County,195734,2440,3452,1243,2209,594,-429,165,66,3476,17.746794575,6.3902855321,11.356509043,3.0537647676,-2.205496777,0.848267991
2016,Tennessee,Moore County,6323,33,49,48,1,0,30,30,2,104,7.7697613573,7.611194799,0.1585665583,0.0,4.7569967494,4.7569967494
2016,Tennessee,Morgan County,21554,62,217,238,-21,0,89,89,-6,2232,10.082237606,11.05793802,-0.975700414,0.0,4.1351112763,4.1351112763
2016,Tennessee,Obion County,30578,-55,332,379,-47,0,-16,-16,8,461,10.847723448,12.383395141,-1.535671693,0.0,-0.522781853,-0.522781853
2016,Tennessee,Overton County,22051,-105,227,307,-80,1,-7,-6,-19,286,10.269866763,13.889203067,-3.619336304,0.0452417038,-0.316691927,-0.271450223
2016,Tennessee,Perry County,7964,50,103,104,-1,0,53,53,-2,123,12.973926187,13.099886636,-0.125960448,0.0,6.6759037662,6.6759037662
2016,Tennessee,Pickett County,5142,0,54,56,-2,-2,-12,-14,16,74,10.501750292,10.890704006,-0.388953715,-0.388953715,-2.333722287,-2.722676002
2016,Tennessee,Polk County,16772,28,157,220,-63,-2,88,86,5,244,9.3686597446,13.128058241,-3.759398496,-0.119345984,5.2512232963,5.1318773123
2016,Tennessee,Putnam County,75931,957,891,789,102,257,597,854,1,2582,11.808753852,10.456909976,1.3518438753,3.4061164309,7.9122626818,11.318379113
2016,Tennessee,Rhea County,32442,50,379,395,-16,24,69,93,-27,799,11.691396489,12.184964679,-0.49356819,0.7403522843,2.1285128173,2.8688651016
2016,Tennessee,Roane County,52874,148,437,714,-277,22,434,456,-31,646,8.2765151515,13.522727273,-5.246212121,0.4166666667,8.2196969697,8.6363636364
2016,Tennessee,Robertson County,69165,713,871,638,233,22,465,487,-7,703,12.65831983,9.2721102771,3.3862095526,0.3197279406,6.757886017,7.0776139576
2016,Tennessee,Rutherford County,308251,9828,4117,1881,2236,606,6750,7356,236,4823,13.572363411,6.2010239437,7.3713394673,1.9977780488,22.252478267,24.250256316
2016,Tennessee,Scott County,21947,-27,277,265,12,4,-26,-22,-17,264,12.613556158,12.067120512,0.5464356458,0.1821452153,-1.183943899,-1.001798684
2016,Tennessee,Sequatchie County,14897,108,150,174,-24,-1,131,130,2,188,10.105773765,11.722697568,-1.616923802,-0.067371825,8.8257090885,8.7583372634
2016,Tennessee,Sevier County,96673,1012,1066,988,78,179,733,912,22,980,11.084883588,10.273794545,0.811089043,1.861345368,7.6221572889,9.4835026568
2016,Tennessee,Shelby County,934603,-1528,13448,8326,5122,1258,-7554,-6296,-354,18227,14.37724444,8.9013189475,5.4759254923,1.3449266438,-8.075974457,-6.731047813
2016,Tennessee,Smith County,19447,194,223,201,22,-1,165,164,8,159,11.524547804,10.387596899,1.1369509044,-0.051679587,8.5271317829,8.4754521964
2016,Tennessee,Stewart County,13182,-58,127,160,-33,0,-14,-14,-11,92,9.6132011203,12.111119522,-2.497918401,0.0,-1.059722958,-1.059722958
2016,Tennessee,Sullivan County,156667,6,1533,1957,-424,34,520,554,-124,2633,9.7852729408,12.491701986,-2.706429046,0.2170249706,3.3192054333,3.5362304039
2016,Tennessee,Sumner County,180063,4197,2135,1567,568,151,3290,3441,188,1252,11.996774638,8.8051268652,3.1916477724,0.8484838268,18.486833048,19.335316875
2016,Tennessee,Tipton County,61303,-302,718,615,103,28,-435,-407,2,962,11.683535653,10.007485274,1.6760503791,0.4556253458,-7.078465193,-6.622839848
2016,Tennessee,Trousdale County,8271,236,101,80,21,1,211,212,3,130,12.388078008,9.8123390163,2.5757389918,0.1226542377,25.880044156,26.002698393
2016,Tennessee,Unicoi County,17719,-101,148,264,-116,13,1,14,1,405,8.3288781339,14.856917752,-6.528039618,0.7315906469,0.0562762036,0.7878668505
2016,Tennessee,Union County,19140,14,193,218,-25,-2,48,46,-7,152,10.087283751,11.393926723,-1.306642973,-0.104531438,2.5087545079,2.4042230701
2016,Tennessee,Van Buren County,5689,3,66,45,21,0,-25,-25,7,94,11.604395604,7.9120879121,3.6923076923,0.0,-4.395604396,-4.395604396
2016,Tennessee,Warren County,40516,178,469,467,2,35,160,195,-19,580,11.601157642,11.551685755,0.0494718876,0.865758033,3.957751008,4.823509041
2016,Tennessee,Washington County,127440,1083,1321,1324,-3,106,983,1089,-3,4199,10.409894522,10.433535463,-0.023640941,0.8353132622,7.7463484596,8.5816617218
2016,Tennessee,Wayne County,16713,-25,129,195,-66,0,52,52,-11,2163,7.7127739081,11.65884428,-3.946070372,0.0,3.1090251413,3.1090251413
2016,Tennessee,Weakley County,33507,-324,346,363,-17,11,-307,-296,-11,1786,10.276515489,10.78143099,-0.504915501,0.32671003,-9.118179928,-8.791469898
2016,Tennessee,White County,26653,158,291,356,-65,17,193,210,13,382,10.950553172,13.396553022,-2.445999849,0.6397230376,7.2627380146,7.9024610522
2016,Tennessee,Williamson County,219107,7433,2237,1173,1064,436,5688,6124,245,1154,10.385787674,5.4459226382,4.9398650358,2.0242304094,26.407849928,28.432080338
2016,Tennessee,Wilson County,132781,4009,1509,1060,449,111,3349,3460,100,1285,11.538770345,8.1054317863,3.4333385585,0.8487763474,25.608576464,26.457352812
2016,Texas,Texas,27862596,432957,404533,192814,211719,91839,125703,217542,3696,608204,14.632542888,6.9743608664,7.6581820214,3.3219492755,4.5468590662,7.8688083417
2016,Texas,Anderson County,57734,247,580,655,-75,16,313,329,-7,14268,10.067609203,11.369455221,-1.301846018,0.2777271504,5.4330373803,5.7107645308
2016,Texas,Andrews County,17760,-266,348,119,229,11,-500,-489,-6,78,19.448946515,6.6506455038,12.798301012,0.6147655508,-27.94388867,-27.32912312
2016,Texas,Angelina County,87791,-147,1176,920,256,12,-420,-408,5,2938,13.384245059,10.470667903,2.9135771557,0.1365739292,-4.780087521,-4.643513592
2016,Texas,Aransas County,25721,460,279,354,-75,12,482,494,41,445,10.945039426,13.887254325,-2.942214899,0.4707543839,18.90863442,19.379388804
2016,Texas,Archer County,8703,-8,78,75,3,3,-33,-30,19,55,8.9583094062,8.6137590444,0.3445503618,0.3445503618,-3.79005398,-3.445503618
2016,Texas,Armstrong County,1876,-49,17,27,-10,5,-52,-47,8,54,8.9450144699,14.206787687,-5.261773218,2.6308866088,-27.36122073,-24.73033412
2016,Texas,Atascosa County,48797,362,710,428,282,10,64,74,6,352,14.604245516,8.8036860293,5.8005594866,0.2056935988,1.3164390324,1.5221326312
2016,Texas,Austin County,29758,210,363,272,91,38,97,135,-16,212,12.241594442,9.1727649816,3.0688294608,1.2814892254,3.2711698648,4.5526590901
2016,Texas,Bailey County,7181,-51,125,41,84,33,-182,-149,14,106,17.345452022,5.6893082634,11.656143759,4.5791993339,-25.25497814,-20.67577881
2016,Texas,Bandera County,21776,560,160,209,-49,11,577,588,21,300,7.4432452549,9.7227391143,-2.279493859,0.5117231113,26.842203201,27.353926312
2016,Texas,Bastrop County,82733,2525,1082,685,397,18,2093,2111,17,2348,13.28088081,8.4079513444,4.8729294653,0.2209388674,25.690280531,25.911219398
2016,Texas,Baylor County,3697,26,40,49,-9,0,38,38,-3,105,10.857763301,13.300760043,-2.442996743,0.0,10.314875136,10.314875136
2016,Texas,Bee County,32750,77,406,230,176,34,-129,-95,-4,7470,12.411537227,7.0311664094,5.3803708176,1.039389817,-3.943567247,-2.90417743
2016,Texas,Bell County,340411,5599,6308,2230,4078,957,339,1296,225,8525,18.684197665,6.6052252367,12.078972428,2.8346190814,1.0041127154,3.8387317968
2016,Texas,Bexar County,1928680,33198,28283,13458,14825,5361,13077,18438,-65,43247,14.791737379,7.0384047538,7.7533326256,2.8037515147,6.8391454128,9.6428969275
2016,Texas,Blanco County,11392,325,99,117,-18,24,304,328,15,105,8.8160648292,10.418985707,-1.602920878,2.1372278374,27.071552607,29.208780444
2016,Texas,Borden County,633,-8,6,6,0,0,-10,-10,2,0,9.4191522763,9.4191522763,0.0,0.0,-15.69858713,-15.69858713
2016,Texas,Bosque County,18097,187,181,221,-40,1,210,211,16,329,10.053600689,12.275390896,-2.221790207,0.0555447552,11.664398589,11.719943344
2016,Texas,Bowie County,93860,357,1229,1039,190,82,155,237,-70,6313,13.11891889,11.090770323,2.0281485672,0.8753062237,1.6545422522,2.529848476
2016,Texas,Brazoria County,354195,8534,4932,2337,2595,542,5283,5825,114,10510,14.094327976,6.6785167234,7.4158112526,1.5488900574,15.097391463,16.646281521
2016,Texas,Brazos County,220417,4550,2954,1084,1870,1480,1196,2676,4,15208,13.541638016,4.9692402197,8.5723977959,6.7845715176,5.4826672534,12.267238771
2016,Texas,Brewster County,9200,101,100,68,32,-1,65,64,5,44,10.929558992,7.4321001148,3.4974588775,-0.10929559,7.104213345,6.9949177551
2016,Texas,Briscoe County,1474,-30,10,9,1,0,-34,-34,3,0,6.7159167226,6.0443250504,0.6715916723,0.0,-22.83411686,-22.83411686
2016,Texas,Brooks County,7214,2,113,81,32,42,-66,-24,-6,59,15.666158325,11.229724109,4.436434216,5.8228199085,-9.15014557,-3.327325662
2016,Texas,Brown County,38271,290,421,477,-56,31,346,377,-31,1831,11.042333316,12.511147249,-1.468813933,0.8130934271,9.0751717988,9.8882652258
2016,Texas,Burleson County,17760,235,216,206,10,27,206,233,-8,177,12.243162817,11.676349724,0.5668130934,1.5303953521,11.676349724,13.206745076
2016,Texas,Burnet County,46243,1062,499,497,2,24,986,1010,50,1196,10.916170809,10.872418621,0.0437521876,0.5250262513,21.569828491,22.094854743
2016,Texas,Caldwell County,41161,716,535,314,221,15,482,497,-2,3349,13.111780996,7.6955125849,5.4162684116,0.3676200279,11.812856898,12.180476926
2016,Texas,Calhoun County,21965,43,302,219,83,37,-72,-35,-5,251,13.762617632,9.980176362,3.7824412696,1.6861485178,-3.281153872,-1.595005355
2016,Texas,Callahan County,13820,224,155,177,-22,8,249,257,-11,77,11.30726583,12.912168077,-1.604902247,0.583600817,18.16457543,18.748176247
2016,Texas,Cameron County,422135,2242,7147,2712,4435,703,-2943,-2240,47,3381,16.975682519,6.441591016,10.534091503,1.6697782022,-6.990266357,-5.320488155
2016,Texas,Camp County,12867,146,197,119,78,60,10,70,-2,67,15.397842739,9.3012349539,6.0966077849,4.6896982961,0.7816163827,5.4713146788
2016,Texas,Carson County,6057,85,61,53,8,2,75,77,0,25,10.142156455,8.8120375759,1.3301188794,0.3325297198,12.469864494,12.802394214
2016,Texas,Cass County,30375,-12,369,430,-61,26,5,31,18,365,12.145748988,14.153582831,-2.007833844,0.8557980317,0.1645765446,1.0203745762
2016,Texas,Castro County,7669,-9,115,46,69,40,-130,-90,12,64,14.986642341,5.9946569362,8.9919854043,5.2127451619,-16.94142178,-11.72867661
2016,Texas,Chambers County,39899,1131,503,259,244,19,845,864,23,221,12.788081406,6.5847178614,6.2033635451,0.4830488006,21.482959818,21.966008619
2016,Texas,Cherokee County,51668,237,782,527,255,20,-22,-2,-16,2904,15.169885256,10.223183542,4.9467017139,0.387976605,-0.426774266,-0.038797661
2016,Texas,Childress County,7052,2,73,58,15,1,-13,-12,-1,1424,10.353141398,8.2257835768,2.1273578216,0.1418238548,-1.843710112,-1.701886257
2016,Texas,Clay County,10193,-131,80,125,-45,6,-84,-78,-8,61,7.7984110737,12.185017303,-4.386606229,0.5848808305,-8.188331627,-7.603450797
2016,Texas,Cochran County,2882,-63,45,8,37,9,-123,-114,14,78,15.445340656,2.7458383388,12.699502317,3.0890681311,-42.21726446,-39.12819633
2016,Texas,Coke County,3264,34,31,48,-17,1,51,52,-1,36,9.5472744071,14.782876501,-5.235602094,0.3079765938,15.706806283,16.014782877
2016,Texas,Coleman County,8420,87,77,112,-35,6,115,121,1,40,9.1923834537,13.370739569,-4.178356115,0.7162896198,13.728884379,14.445173999
2016,Texas,Collin County,939585,26506,11045,4344,6701,4044,15270,19314,491,4800,11.923370886,4.6894633889,7.2339074975,4.3656054201,16.484370614,20.849976035
2016,Texas,Collingsworth County,3016,-3,26,32,-6,4,-1,3,0,50,8.6164043082,10.604805302,-1.988400994,1.3256006628,-0.331400166,0.9942004971
2016,Texas,Colorado County,21019,139,266,253,13,42,60,102,24,350,12.697200411,12.076660541,0.6205398697,2.0048211174,2.8640301678,4.8688512852
2016,Texas,Comal County,134788,5675,1597,1085,512,109,4760,4869,294,1243,12.103023482,8.2227805124,3.8802429699,0.826067351,36.074133861,36.900201212
2016,Texas,Comanche County,13484,119,147,185,-38,0,155,155,2,165,10.950128496,13.780773958,-2.830645462,0.0,11.546053857,11.546053857
2016,Texas,Concho County,4279,124,28,26,2,48,74,122,0,1629,6.6397913208,6.1655205122,0.4742708086,11.382499407,17.548019919,28.930519327
2016,Texas,Cooke County,39266,156,561,414,147,37,2,39,-30,649,14.315606818,10.564458508,3.7511483107,0.9441665816,0.0510360314,0.995202613
2016,Texas,Coryell County,74686,-785,1042,477,565,311,-1683,-1372,22,11512,13.878806849,6.3533501602,7.5254566887,4.1423310269,-22.41653736,-18.27420633
2016,Texas,Cottle County,1402,-29,16,18,-2,0,-30,-30,3,0,11.295446523,12.707377339,-1.411930815,0.0,-21.17896223,-21.17896223
2016,Texas,Crane County,4830,-209,77,23,54,6,-268,-262,-1,90,15.604417874,4.6610598845,10.94335799,1.2159286655,-54.31148039,-53.09555173
2016,Texas,Crockett County,3675,-67,53,18,35,7,-107,-100,-2,49,14.291492517,4.8537144398,9.4377780774,1.8875556155,-28.85263584,-26.96508022
2016,Texas,Crosby County,5992,7,92,68,24,2,-15,-13,-4,60,15.362778659,11.35509727,4.0076813893,0.3339734491,-2.504800868,-2.170827419
2016,Texas,Culberson County,2198,-35,28,13,15,1,-54,-53,3,12,12.638230648,5.8677499436,6.7704807041,0.4513653803,-24.37373053,-23.92236515
2016,Texas,Dallam County,7056,-51,144,27,117,31,-220,-189,21,40,20.334674857,3.8127515357,16.521923321,4.3776036151,-31.06686436,-26.68926075
2016,Texas,Dallas County,2574984,29209,40063,16407,23656,12133,-6193,5940,-387,33538,15.647289787,6.408034434,9.2392553526,4.7387506422,-2.418782059,2.3199685828
2016,Texas,Dawson County,13111,36,182,130,52,24,-44,-20,4,1357,13.90055755,9.9289696785,3.9715878714,1.833040556,-3.360574353,-1.527533797
2016,Texas,Deaf Smith County,18830,23,322,165,157,28,-156,-128,-6,343,17.110821798,8.7679676914,8.3428541063,1.4878975476,-8.289714908,-6.801817361
2016,Texas,Delta County,5215,0,65,59,6,0,-9,-9,3,62,12.464046021,11.313518696,1.150527325,0.0,-1.725790988,-1.725790988
2016,Texas,Denton County,806180,27689,10153,3692,6461,2439,18128,20567,661,11423,12.814016285,4.6596422854,8.1543739994,3.0782414773,22.879197007,25.957438484
2016,Texas,DeWitt County,20865,79,285,235,50,3,42,45,-16,1845,13.685145615,11.284242875,2.4009027394,0.1440541644,2.0167583011,2.1608124655
2016,Texas,Dickens County,2184,-13,18,19,-1,2,-17,-15,3,315,8.2173019858,8.6738187628,-0.456516777,0.913033554,-7.760785209,-6.847751655
2016,Texas,Dimmit County,10794,-201,179,100,79,30,-315,-285,5,100,16.430308871,9.1789435036,7.2513653678,2.7536830511,-28.91367204,-26.15998899
2016,Texas,Donley County,3405,-2,26,49,-23,2,16,18,3,207,7.6335877863,14.386376982,-6.752789196,0.5871990605,4.6975924839,5.2847915443
2016,Texas,Duval County,11428,29,182,148,34,6,-23,-17,12,524,15.946028826,12.967100364,2.9789284619,0.525693258,-2.015157489,-1.489464231
2016,Texas,Eastland County,18274,141,201,250,-49,22,181,203,-13,886,11.041832615,13.733622655,-2.69179004,1.2085587936,9.9431428022,11.151701596
2016,Texas,Ector County,157462,-2227,3145,1247,1898,206,-4331,-4125,0,2636,19.832824112,7.8637620566,11.969062056,1.2990657447,-27.31191136,-26.01284562
2016,Texas,Edwards County,1911,0,26,14,12,3,-27,-24,12,5,13.605442177,7.326007326,6.2794348509,1.5698587127,-14.12872841,-12.5588697
2016,Texas,Ellis County,168499,5025,2182,1236,946,125,3815,3940,139,1675,13.145647387,7.4463887123,5.6992586747,0.7530732921,22.983796875,23.736870167
2016,Texas,El Paso County,837918,4135,13320,5432,7888,2705,-6333,-3628,-125,16225,15.935864129,6.4987698159,9.4370943129,3.2362246598,-7.576713778,-4.340489119
2016,Texas,Erath County,41659,280,500,335,165,46,89,135,-20,3965,12.042679255,8.068595101,3.9740841542,1.1079264915,2.1435969074,3.2515233989
2016,Texas,Falls County,17273,115,213,162,51,12,53,65,-1,1977,12.372571229,9.410124597,2.9624466324,0.6970462664,3.0786210101,3.7756672766
2016,Texas,Fannin County,34031,391,327,439,-112,21,451,472,31,3061,9.6644057277,12.974538576,-3.310132849,0.6206499091,13.329195667,13.949845576
2016,Texas,Fayette County,25149,103,261,302,-41,12,124,136,8,421,10.399442176,12.033071023,-1.633628847,0.4781352724,4.9407311485,5.418866421
2016,Texas,Fisher County,3854,1,51,51,0,1,2,3,-2,22,13.234721682,13.234721682,0.0,0.2595043467,0.5190086934,0.7785130401
2016,Texas,Floyd County,5917,16,71,60,11,17,-20,-3,8,35,12.01556947,10.154002369,1.861567101,2.876967338,-3.384667456,-0.507700118
2016,Texas,Foard County,1183,-32,4,9,-5,1,-35,-34,7,29,3.3361134279,7.5062552127,-4.170141785,0.834028357,-29.19099249,-28.35696414
2016,Texas,Fort Bend County,741237,27388,9870,3317,6553,4184,15718,19902,933,5397,13.566208458,4.5591806945,9.0070277633,5.7508628356,21.604221331,27.355084167
2016,Texas,Franklin County,10607,54,102,130,-28,0,81,81,1,73,9.640831758,12.287334594,-2.646502836,0.0,7.6559546314,7.6559546314
2016,Texas,Freestone County,19624,-69,211,200,11,11,-84,-73,-7,1634,10.733270595,10.173716204,0.5595543912,0.5595543912,-4.272960806,-3.713406415
2016,Texas,Frio County,18956,26,261,145,116,95,-183,-88,-2,3377,13.778176635,7.6545425751,6.1236340601,5.0150451354,-9.660560629,-4.645515494
2016,Texas,Gaines County,20478,202,442,129,313,108,-218,-110,-1,82,21.691122344,6.3306669284,15.360455415,5.3000932424,-10.69833636,-5.398243117
2016,Texas,Galveston County,329431,7893,4259,2796,1463,661,5566,6227,203,5039,13.085108507,8.5902708117,4.4948376958,2.0308186719,17.100660707,19.131479379
2016,Texas,Garza County,6442,59,64,43,21,28,6,34,4,2151,9.9805068226,6.7056530214,3.2748538012,4.3664717349,0.9356725146,5.3021442495
2016,Texas,Gillespie County,26521,447,262,343,-81,47,410,457,71,365,9.9629242323,13.04306493,-3.080140698,1.7872421333,15.590835631,17.378077764
2016,Texas,Glasscock County,1314,-19,14,5,9,10,-40,-30,2,0,10.578012845,3.7778617303,6.8001511145,7.5557234605,-30.22289384,-22.66717038
2016,Texas,Goliad County,7517,-9,75,71,4,0,-14,-14,1,90,9.9714152762,9.4396064615,0.5318088147,0.0,-1.861330852,-1.861330852
2016,Texas,Gonzales County,20876,322,331,191,140,4,184,188,-6,311,15.978759353,9.2203717113,6.7583876418,0.1930967898,8.8824523292,9.075549119
2016,Texas,Gray County,22725,-511,336,259,77,25,-626,-601,13,2020,14.621091795,11.270424925,3.3506668697,1.0878788538,-27.2404865,-26.15260765
2016,Texas,Grayson County,128235,2698,1582,1402,180,187,2254,2441,77,2251,12.467884558,11.049288338,1.4185962202,1.473763851,17.763977113,19.237740964
2016,Texas,Gregg County,123745,-82,1908,1288,620,218,-976,-758,56,4136,15.413697833,10.405053883,5.00864395,1.7611038405,-7.884574992,-6.123471152
2016,Texas,Grimes County,27671,253,337,251,86,15,132,147,20,2919,12.234747409,9.1125270018,3.122220407,0.5445733268,4.7922452758,5.3368186026
2016,Texas,Guadalupe County,155265,4101,1847,1058,789,167,3020,3187,125,1943,12.054994795,6.9053516475,5.1496431474,1.0899751655,19.710928143,20.800903309
2016,Texas,Hale County,34263,62,461,309,152,45,-136,-91,1,2730,13.466931526,9.0266417387,4.4402897873,1.3145594765,-3.972890862,-2.658331386
2016,Texas,Hall County,3138,24,27,39,-12,-1,38,37,-1,43,8.6372360845,12.476007678,-3.838771593,-0.319897633,12.156110045,11.836212412
2016,Texas,Hamilton County,8304,177,87,131,-44,1,197,198,23,217,10.589738908,15.945468931,-5.355730023,0.1217211369,23.979063964,24.100785101
2016,Texas,Hansford County,5538,-69,87,39,48,14,-143,-129,12,73,15.612382234,6.998654105,8.6137281292,2.512337371,-25.66173172,-23.14939435
2016,Texas,Hardeman County,3906,55,44,37,7,2,40,42,6,21,11.344591981,9.5397705298,1.8048214516,0.5156632719,10.313265438,10.82892871
2016,Texas,Hardin County,56322,518,687,540,147,3,372,375,-4,402,12.254071313,9.6320211191,2.6220501935,0.0535112284,6.6353923265,6.6889035549
2016,Texas,Harris County,4589928,56587,73072,26660,46412,27922,-16225,11697,-1522,49246,16.01881957,5.8443963452,10.174423225,6.1210515661,-3.556839111,2.564212455
2016,Texas,Harrison County,66534,-72,844,685,159,92,-284,-192,-39,1241,12.678383656,10.289920385,2.3884632717,1.3820039057,-4.26618597,-2.884182064
2016,Texas,Hartley County,5747,-14,59,33,26,13,-55,-42,2,1059,10.253736531,5.7351407716,4.5185957595,2.2592978797,-9.558567953,-7.299270073
2016,Texas,Haskell County,5681,-93,56,54,2,38,-147,-109,14,524,9.7773897861,9.4281972938,0.3491924924,6.6346573549,-25.66564819,-19.03099083
2016,Texas,Hays County,204470,9896,2553,1011,1542,171,7932,8103,251,7890,12.79558144,5.0671103938,7.7284710458,0.8570483455,39.755014485,40.61206283
2016,Texas,Hemphill County,4129,-141,74,28,46,10,-200,-190,3,45,17.621145374,6.667460412,10.953684962,2.3812358614,-47.62471723,-45.24348137
2016,Texas,Henderson County,79901,485,882,1086,-204,19,688,707,-18,1298,11.07226473,13.633196708,-2.560931978,0.2385181745,8.636868633,8.8753868074
2016,Texas,Hidalgo County,849843,10529,16144,4395,11749,2061,-3457,-1396,176,7577,19.114860253,5.2037791632,13.91108109,2.4402705018,-4.093165999,-1.652895498
2016,Texas,Hill County,35077,231,401,416,-15,24,216,240,6,776,11.469759593,11.898802969,-0.429043376,0.6864694021,6.1782246185,6.8646940206
2016,Texas,Hockley County,23275,-186,316,212,104,33,-321,-288,-2,902,13.522766176,9.0722355358,4.4505306402,1.412187607,-13.736734,-12.32454639
2016,Texas,Hood County,56857,1513,636,681,-45,80,1388,1468,90,745,11.336797355,12.138929243,-0.802131888,1.4260122459,24.741312466,26.167324712
2016,Texas,Hopkins County,36400,223,470,389,81,2,141,143,-1,438,12.951761577,10.719649476,2.2321121016,0.0551138791,3.8855284732,3.9406423523
2016,Texas,Houston County,22754,79,214,283,-69,20,146,166,-18,2695,9.4212947677,12.459001959,-3.037707191,0.8804948381,6.4276123181,7.3081071562
2016,Texas,Howard County,36708,-494,513,367,146,81,-716,-635,-5,6081,13.881748072,9.9309971587,3.9507509133,2.1918549587,-19.37491544,-17.18306048
2016,Texas,Hudspeth County,4053,628,46,9,37,17,573,590,1,86,12.302754747,2.4070607114,9.8956940358,4.5466702327,153.24953196,157.79620219
2016,Texas,Hunt County,92073,2226,1121,950,171,142,1871,2013,42,2524,12.324098505,10.444151275,1.8799472296,1.5611257696,20.569481091,22.13060686
2016,Texas,Hutchinson County,21511,-244,294,234,60,19,-317,-298,-6,232,13.590348079,10.816807655,2.7735404244,0.878287801,-14.65353858,-13.77525077
2016,Texas,Irion County,1557,11,10,5,5,0,4,4,2,0,6.4453754431,3.2226877216,3.2226877216,0.0,2.5781501772,2.5781501772
2016,Texas,Jack County,8744,-79,101,71,30,2,-116,-114,5,1077,11.498833039,8.0833380771,3.4154949621,0.2276996641,-13.20658052,-12.97888086
2016,Texas,Jackson County,14869,23,204,129,75,8,-49,-41,-11,217,13.730439172,8.6824835941,5.047955578,0.538448595,-3.297997644,-2.759549049
2016,Texas,Jasper County,35648,188,427,432,-5,52,158,210,-17,945,12.009900433,12.150531586,-0.140631153,1.4625639872,4.4439444226,5.9065084097
2016,Texas,Jeff Davis County,2200,21,11,22,-11,3,30,33,-1,88,5.0239780772,10.047956154,-5.023978077,1.3701758392,13.701758392,15.071934232
2016,Texas,Jefferson County,254679,512,3684,2578,1106,591,-1102,-511,-83,16083,14.479822972,10.132731711,4.3470912614,2.3229031966,-4.331369412,-2.008466216
2016,Texas,Jim Hogg County,5146,-50,89,45,44,2,-98,-96,2,16,17.211371108,8.7023786502,8.5089924579,0.3867723845,-18.95184684,-18.56507445
2016,Texas,Jim Wells County,41149,-307,680,404,276,22,-595,-573,-10,341,16.463894437,9.7814902246,6.6824042128,0.5326554083,-14.40590763,-13.87325222
2016,Texas,Johnson County,163274,3600,2085,1336,749,68,2659,2727,124,2709,12.912295478,8.2737778218,4.6385176561,0.4211204281,16.467047327,16.888167755
2016,Texas,Jones County,20009,37,174,176,-2,16,34,50,-11,5290,8.7041344639,8.8041819864,-0.100047523,0.8003801806,1.7008078837,2.5011880643
2016,Texas,Karnes County,15254,-21,187,138,49,13,-82,-69,-1,2976,12.250646926,9.0405843624,3.2100625635,0.8516492515,-5.371941433,-4.520292181
2016,Texas,Kaufman County,118350,3878,1577,951,626,84,3087,3171,81,1333,13.546829767,8.169331077,5.37749869,0.7215812939,26.51811255,27.239693843
2016,Texas,Kendall County,42540,2088,391,389,2,77,1844,1921,165,509,9.4225949489,9.3743975323,0.0481974166,1.8556005398,44.438018122,46.293618662
2016,Texas,Kenedy County,404,-8,2,0,2,6,-18,-12,2,0,4.9019607843,0.0,4.9019607843,14.705882353,-44.11764706,-29.41176471
2016,Texas,Kent County,769,-1,8,10,-2,0,-3,-3,4,45,10.396361274,12.995451592,-2.599090318,0.0,-3.898635478,-3.898635478
2016,Texas,Kerr County,51504,493,551,750,-199,14,631,645,47,1985,10.749646393,14.632005072,-3.882358679,0.2731307614,12.310393601,12.583524362
2016,Texas,Kimble County,4423,29,40,45,-5,0,39,39,-5,43,9.0733809686,10.20755359,-1.134172621,0.0,8.8465464444,8.8465464444
2016,Texas,King County,289,4,0,0,0,0,0,0,4,0,0.0,0.0,0.0,0.0,0.0,0.0
2016,Texas,Kinney County,3590,34,36,35,1,20,12,32,1,335,10.075566751,9.7956898964,0.2798768542,5.5975370837,3.3585222502,8.9560593339
2016,Texas,Kleberg County,31690,120,459,236,223,122,-216,-94,-9,1797,14.511539678,7.4612709453,7.0502687322,3.8570976921,-6.828959848,-2.971862156
2016,Texas,Knox County,3806,-45,57,47,10,2,-59,-57,2,104,14.888337469,12.276348439,2.6119890296,0.5223978059,-15.41073527,-14.88833747
2016,Texas,Lamar County,49791,155,688,665,23,23,130,153,-21,719,13.839299184,13.376648194,0.4626509902,0.4626509902,2.6149838575,3.0776348477
2016,Texas,Lamb County,13275,-67,189,133,56,4,-122,-118,-5,185,14.201450201,9.9936131044,4.2078370966,0.3005597926,-9.167073675,-8.866513882
2016,Texas,Lampasas County,20760,255,232,183,49,46,163,209,-3,223,11.244395977,8.8695019993,2.3748939779,2.2294923058,7.9001575185,10.129649824
2016,Texas,La Salle County,7613,-25,110,45,65,18,-113,-95,5,1645,14.425283588,5.9012523769,8.5240312111,2.3605009508,-14.81870041,-12.45819946
2016,Texas,Lavaca County,19809,-12,242,250,-8,3,5,8,-12,420,12.212969972,12.616704517,-0.403734545,0.1514004542,0.2523340903,0.4037345445
2016,Texas,Lee County,17055,153,220,156,64,-6,105,99,-10,491,12.957563978,9.1880908207,3.7694731572,-0.353388108,6.1842918986,5.8309037901
2016,Texas,Leon County,17299,197,212,225,-13,8,197,205,5,107,12.325223104,13.081015087,-0.755791983,0.4651027586,11.453155432,11.91825819
2016,Texas,Liberty County,81704,2008,1118,771,347,64,1609,1673,-12,5103,13.85377943,9.5539033457,4.2998760843,0.7930607187,19.938042131,20.73110285
2016,Texas,Limestone County,23468,47,320,269,51,45,-30,15,-19,1592,13.649256755,11.47390646,2.1753502954,1.9194267312,-1.279617821,0.6398089104
2016,Texas,Lipscomb County,3487,-66,45,19,26,6,-104,-98,6,40,12.784090909,5.3977272727,7.3863636364,1.7045454545,-29.54545455,-27.84090909
2016,Texas,Live Oak County,12056,-163,143,121,22,9,-191,-182,-3,1126,11.781668383,9.9691040165,1.8125643666,0.7415036045,-15.73635427,-14.99485067
2016,Texas,Llano County,20362,524,175,310,-135,16,622,638,21,164,8.7064676617,15.422885572,-6.71641791,0.7960199005,30.945273632,31.741293532
2016,Texas,Loving County,113,-2,0,0,0,0,-3,-3,1,0,0.0,0.0,0.0,0.0,-26.31578947,-26.31578947
2016,Texas,Lubbock County,303137,4129,4252,2533,1719,443,1872,2315,95,12162,14.122844165,8.4132559433,5.7095882221,1.4714063888,6.217771467,7.6891778558
2016,Texas,Lynn County,5711,16,64,36,28,-1,-14,-15,3,43,11.222163773,6.3124671226,4.9096966509,-0.175346309,-2.454848325,-2.630194634
2016,Texas,McCulloch County,8172,-143,90,114,-24,-1,-111,-112,-7,102,10.917692728,13.829077455,-2.911384727,-0.121307697,-13.46515436,-13.58646206
2016,Texas,McLennan County,247934,2731,3588,2141,1447,284,968,1252,32,9189,14.551737144,8.6831854028,5.8685517412,1.1518097405,3.9258867211,5.0776964616
2016,Texas,McMullen County,804,-21,11,9,2,3,-27,-24,1,0,13.505217925,11.049723757,2.4554941682,3.6832412523,-33.14917127,-29.46593002
2016,Texas,Madison County,13987,71,158,112,46,24,-5,19,6,2518,11.324947138,8.0278106297,3.2971365086,1.7202451349,-0.358384403,1.3618607318
2016,Texas,Marion County,10147,5,94,141,-47,4,49,53,-1,164,9.2661047858,13.899157179,-4.633052393,0.3943023313,4.8302035586,5.2245058899
2016,Texas,Martin County,5723,0,113,43,70,29,-101,-72,2,43,19.744889044,7.5135418487,12.231347196,5.0672724096,-17.64808667,-12.58081426
2016,Texas,Mason County,4111,96,37,42,-5,10,92,102,-1,3,9.1065714989,10.337189269,-1.23061777,2.4612355402,22.64336697,25.10460251
2016,Texas,Matagorda County,37187,347,556,390,166,22,178,200,-19,380,15.021546193,10.53669607,4.4848501223,0.594377727,4.8090561552,5.4034338822
2016,Texas,Maverick County,57685,245,1159,393,766,144,-654,-510,-11,1002,20.134636265,6.8273615635,13.307274701,2.5016286645,-11.36156352,-8.859934853
2016,Texas,Medina County,49283,898,607,432,175,4,702,706,17,2355,12.429864439,8.8462956137,3.583568825,0.0819101446,14.375230372,14.457140517
2016,Texas,Menard County,2123,-36,19,20,-1,2,-41,-39,4,38,8.8743577767,9.3414292387,-0.467071462,0.9341429239,-19.14992994,-18.21578702
2016,Texas,Midland County,162565,1293,3031,1087,1944,238,-896,-658,7,1667,18.719293966,6.7132538901,12.006040076,1.4698752768,-5.533648101,-4.063772824
2016,Texas,Milam County,24871,387,338,275,63,22,319,341,-17,433,13.696687266,11.143754432,2.5529328336,0.8915003546,12.926755141,13.818255496
2016,Texas,Mills County,4907,24,46,61,-15,3,29,32,7,145,9.3973442288,12.461695608,-3.064351379,0.6128702758,5.924412666,6.5372829418
2016,Texas,Mitchell County,8720,-140,89,86,3,1,-158,-157,14,1898,10.125142207,9.7838452787,0.3412969283,0.1137656428,-17.97497156,-17.86120592
2016,Texas,Montague County,19414,145,226,263,-37,18,180,198,-16,248,11.684719386,13.597704418,-1.912985032,0.930641367,9.3064136701,10.237055037
2016,Texas,Montgomery County,556203,19769,7371,3816,3555,1543,14111,15654,560,3551,13.492129591,6.9849364428,6.5071931483,2.8243597828,25.829255279,28.653615062
2016,Texas,Moore County,22120,72,425,139,286,231,-437,-206,-8,153,19.244702047,6.2941496106,12.950552436,10.460061583,-19.78808187,-9.328020286
2016,Texas,Morris County,12593,96,146,157,-11,13,104,117,-10,145,11.63810283,12.514946194,-0.876843364,1.0362694301,8.2901554404,9.3264248705
2016,Texas,Motley County,1160,18,6,13,-7,0,20,20,5,0,5.212858384,11.294526499,-6.081668115,0.0,17.376194613,17.376194613
2016,Texas,Nacogdoches County,65806,165,867,602,265,148,-260,-112,12,4955,13.191628565,9.1595852321,4.0320433331,2.2518581634,-3.955967044,-1.70410888
2016,Texas,Navarro County,48523,268,720,560,160,18,77,95,13,728,14.879414743,11.572878133,3.3065366096,0.3719853686,1.5912707434,1.9632561119
2016,Texas,Newton County,14003,-4,137,171,-34,8,34,42,-12,726,9.7822206355,12.209925027,-2.427704391,0.5712245627,2.4277043913,2.9989289539
2016,Texas,Nolan County,14993,-57,219,177,42,8,-115,-107,8,367,14.579103285,11.783110874,2.7959924109,0.532569983,-7.655693506,-7.123123523
2016,Texas,Nueces County,361350,1232,5123,2944,2179,686,-1442,-756,-191,6727,14.201600071,8.1611381239,6.040461947,1.9016782449,-3.99740529,-2.095727045
2016,Texas,Ochiltree County,10306,-392,195,72,123,23,-540,-517,2,27,18.56789183,6.8558369834,11.712054847,2.1900590364,-51.41877738,-49.22871834
2016,Texas,Oldham County,2076,17,22,9,13,1,4,5,-1,278,10.640870617,4.3530834341,6.2877871826,0.4836759371,1.9347037485,2.4183796856
2016,Texas,Orange County,84964,681,1196,934,262,13,414,427,-8,697,14.133189953,11.037123258,3.0960666954,0.1536216299,4.8922580607,5.0458796906
2016,Texas,Palo Pinto County,28053,171,360,349,11,11,160,171,-11,280,12.872083669,12.478770001,0.3933136676,0.3933136676,5.7209260749,6.1142397426
2016,Texas,Panola County,23492,-225,291,258,33,17,-266,-249,-9,389,12.328157767,10.930119257,1.3980385096,0.7202016565,-11.26903768,-10.54883603
2016,Texas,Parker County,129441,3356,1493,1077,416,46,2798,2844,96,1220,11.685699303,8.4296705619,3.2560287407,0.3600416396,21.899924078,22.259965718
2016,Texas,Parmer County,9776,-12,151,50,101,57,-176,-119,6,79,15.43651605,5.1114291556,10.325086894,5.8270292374,-17.99223063,-12.16520139
2016,Texas,Pecos County,15970,-89,224,96,128,13,-232,-219,2,2074,13.987323988,5.9945674233,7.9927565644,0.8117643386,-14.48687127,-13.67510693
2016,Texas,Polk County,47916,932,517,669,-152,91,955,1046,38,4394,10.895679663,14.099051633,-3.20337197,1.9178082192,20.126448894,22.044257113
2016,Texas,Potter County,120832,-542,1966,1190,776,648,-1992,-1344,26,6929,16.234114762,9.8263461681,6.4077685937,5.3508170731,-16.44880804,-11.09799097
2016,Texas,Presidio County,6958,77,123,45,78,35,-40,-5,4,0,17.775850856,6.5033600694,11.272490787,5.0581689428,-5.780764506,-0.722595563
2016,Texas,Rains County,11314,180,96,127,-31,9,194,203,8,66,8.5531004989,11.315039202,-2.761938703,0.8018531718,17.284390592,18.086243763
2016,Texas,Randall County,132501,2218,1723,1045,678,226,1338,1564,-24,2583,13.113431564,7.9533000487,5.1601315149,1.7200438383,10.183268388,11.903312226
2016,Texas,Reagan County,3608,-123,55,16,39,6,-181,-175,13,28,14.988418041,4.3602670664,10.628150974,1.6351001499,-49.32552119,-47.69042104
2016,Texas,Real County,3389,89,34,43,-9,1,98,99,-1,72,10.165944087,12.856929287,-2.6909852,0.2989983555,29.30183884,29.600837195
2016,Texas,Red River County,12207,-178,117,180,-63,2,-115,-113,-2,177,9.515289525,14.638906962,-5.123617437,0.1626545218,-9.352635003,-9.189980481
2016,Texas,Reeves County,14921,132,211,98,113,71,-48,23,-4,3136,14.203971727,6.5971053517,7.606866375,4.7795355099,-3.231235274,1.5483002356
2016,Texas,Refugio County,7321,-38,100,76,24,11,-75,-64,2,117,13.623978202,10.354223433,3.2697547684,1.4986376022,-10.21798365,-8.719346049
2016,Texas,Roberts County,916,-2,6,4,2,0,-5,-5,1,0,6.5430752454,4.3620501636,2.1810250818,0.0,-5.452562704,-5.452562704
2016,Texas,Robertson County,16751,103,233,158,75,7,14,21,7,194,13.952513548,9.4613611186,4.4911524297,0.4191742268,0.8383484535,1.2575226803
2016,Texas,Rockwall County,93978,3306,1039,549,490,78,2615,2693,123,823,11.25372326,5.9463850528,5.3073382074,0.8448415922,28.323855944,29.168697536
2016,Texas,Runnels County,10448,-80,110,126,-16,11,-71,-60,-4,188,10.488176964,12.013729977,-1.525553013,1.0488176964,-6.769641495,-5.720823799
2016,Texas,Rusk County,52732,-202,595,558,37,17,-236,-219,-20,4820,11.261900706,10.56158083,0.7003198758,0.3217685916,-4.466905154,-4.145136562
2016,Texas,Sabine County,10303,-75,90,144,-54,0,-30,-30,9,121,8.7036410232,13.925825637,-5.222184614,0.0,-2.901213674,-2.901213674
2016,Texas,San Augustine County,8320,-64,81,124,-43,0,-17,-17,-4,171,9.6982758621,14.846743295,-5.148467433,0.0,-2.035440613,-2.035440613
2016,Texas,San Jacinto County,27707,394,294,288,6,-10,398,388,0,129,10.687022901,10.468920393,0.2181025082,-0.36350418,14.467466376,14.103962196
2016,Texas,San Patricio County,67655,299,1040,594,446,63,-168,-105,-42,645,15.406152091,8.7992830214,6.6068690699,0.9332572901,-2.488686107,-1.555428817
2016,Texas,San Saba County,5944,0,71,54,17,1,-13,-12,-5,663,11.944818304,9.0847913863,2.8600269179,0.1682368775,-2.187079408,-2.01884253
2016,Texas,Schleicher County,3056,-140,33,17,16,-1,-166,-167,11,3,10.556621881,5.4382597569,5.1183621241,-0.319897633,-53.10300704,-53.42290467
2016,Texas,Scurry County,17333,-233,247,182,65,8,-302,-294,-4,1688,14.155133385,10.430098284,3.7250351013,0.4584658586,-17.30708616,-16.8486203
2016,Texas,Shackelford County,3315,-1,30,27,3,4,-8,-4,0,11,9.0484089881,8.1435680893,0.9048408988,1.2064545317,-2.412909063,-1.206454532
2016,Texas,Shelby County,25579,158,361,307,54,56,58,114,-10,167,14.156862745,12.039215686,2.1176470588,2.1960784314,2.2745098039,4.4705882353
2016,Texas,Sherman County,3068,6,39,25,14,5,-11,-6,-2,29,12.724306688,8.1566068515,4.5676998369,1.6313213703,-3.588907015,-1.957585644
2016,Texas,Smith County,225290,2812,3146,2095,1051,325,1388,1713,48,5046,14.051919744,9.3575244323,4.6943953119,1.4516446017,6.1996390988,7.6512837005
2016,Texas,Somervell County,8775,46,79,95,-16,6,60,66,-4,287,9.0265082267,10.854661792,-1.828153565,0.6855575868,6.8555758684,7.5411334552
2016,Texas,Starr County,64122,497,1331,402,929,182,-603,-421,-11,843,20.838062733,6.2936898714,14.544372862,2.8493819816,-9.440534807,-6.591152826
2016,Texas,Stephens County,9906,2,111,90,21,6,-31,-25,6,1135,11.206461383,9.0863200404,2.1201413428,0.6057546694,-3.129732458,-2.523977789
2016,Texas,Sterling County,1367,8,18,11,7,3,-5,-2,3,36,13.206162876,8.0704328687,5.1357300073,2.201027146,-3.668378577,-1.467351431
2016,Texas,Stonewall County,1426,14,19,16,3,1,12,13,-2,29,13.389711064,11.275546159,2.1141649049,0.704721635,8.4566596195,9.1613812544
2016,Texas,Sutton County,3869,-35,48,24,24,1,-62,-61,2,13,12.350443844,6.175221922,6.175221922,0.2573009134,-15.95265663,-15.69535572
2016,Texas,Swisher County,7466,-47,100,70,30,5,-88,-83,6,645,13.35202617,9.346418319,4.005607851,0.6676013085,-11.74978303,-11.08218172
2016,Texas,Tarrant County,2016872,35462,28682,12903,15779,6348,13411,19759,-76,24398,14.347162106,6.4542721099,7.8928899963,3.1753638188,6.7083812497,9.8837450685
2016,Texas,Taylor County,136535,210,2116,1402,714,357,-882,-525,21,4973,15.509785238,10.276332185,5.2334530528,2.6167265264,-6.464853771,-3.848127245
2016,Texas,Terrell County,812,-43,10,12,-2,2,-43,-41,0,0,11.99760048,14.397120576,-2.399520096,2.399520096,-51.58968206,-49.19016197
2016,Texas,Terry County,12799,44,199,135,64,20,-47,-27,7,1177,15.574861079,10.565860531,5.0090005479,1.5653126712,-3.678484777,-2.113172106
2016,Texas,Throckmorton County,1533,-27,10,20,-10,2,-25,-23,6,13,6.4662140317,12.932428063,-6.466214032,1.2932428063,-16.16553508,-14.87229227
2016,Texas,Titus County,32592,-97,515,269,246,52,-398,-346,3,614,15.777944578,8.2412953233,7.5366492548,1.5931128506,-12.19344066,-10.60032781
2016,Texas,Tom Green County,118386,444,1695,1021,674,120,-388,-268,38,5479,14.344470397,8.6405334958,5.7039369013,1.0155377272,-3.283571985,-2.268034257
2016,Texas,Travis County,1199323,24505,16586,5683,10903,5560,8227,13787,-185,23191,13.972211423,4.7874157432,9.1847956798,4.6837993194,6.9305066548,11.614305974
2016,Texas,Trinity County,14442,21,148,209,-61,-1,82,81,1,135,10.255344212,14.482209057,-4.226864844,-0.069292866,5.6820150366,5.6127221703
2016,Texas,Tyler County,21320,46,214,241,-27,8,79,87,-14,2387,10.048363619,11.316147814,-1.267784195,0.3756397615,3.7094426445,4.085082406
2016,Texas,Upshur County,40969,488,472,434,38,58,417,475,-25,471,11.589932474,10.65684469,0.9330877839,1.4241866176,10.239410681,11.663597299
2016,Texas,Upton County,3673,47,58,18,40,3,6,9,-2,63,15.892588026,4.9321824908,10.960405535,0.8220304151,1.6440608303,2.4660912454
2016,Texas,Uvalde County,27285,173,413,249,164,52,-66,-14,23,513,15.184660919,9.1549166314,6.0297442874,1.9118701399,-2.426604408,-0.514734268
2016,Texas,Val Verde County,48881,24,883,363,520,98,-590,-492,-4,1934,18.068714318,7.4280218543,10.640692464,2.005361272,-12.07309337,-10.0677321
2016,Texas,Van Zandt County,54355,854,595,635,-40,33,901,934,-40,628,11.033229491,11.774959205,-0.741729714,0.6119270138,16.707461801,17.319388815
2016,Texas,Victoria County,92467,230,1341,836,505,91,-332,-241,-34,1825,14.520530146,9.0523215523,5.4682085932,0.9853603604,-3.594941095,-2.609580735
2016,Texas,Walker County,71484,977,679,563,116,134,737,871,-10,17117,9.5639864498,7.9300800755,1.6339063743,1.8874435704,10.380939637,12.268383207
2016,Texas,Waller County,50115,1485,664,308,356,27,1086,1113,16,4291,13.448782217,6.2382905464,7.2104916705,0.5468631323,21.996050433,22.542913565
2016,Texas,Ward County,11600,-68,189,103,86,3,-167,-164,10,128,16.245487365,8.8533608389,7.3921265257,0.2578648788,-14.35447825,-14.09661337
2016,Texas,Washington County,35056,51,416,378,38,85,-117,-32,45,2120,11.875365753,10.790596766,1.084768987,2.4264569447,-3.339946618,-0.913489673
2016,Texas,Webb County,271193,2264,5387,1342,4045,941,-2639,-1698,-83,3553,19.947345229,4.9692476885,14.978097541,3.4843979693,-9.771866356,-6.287468387
2016,Texas,Wharton County,41735,209,572,408,164,25,47,72,-27,466,13.739926256,9.8005068399,3.9394194161,0.6005212524,1.1289799546,1.729501207
2016,Texas,Wheeler County,5546,-120,87,64,23,5,-155,-150,7,41,15.519086693,11.416339636,4.1027470567,0.8919015341,-27.64894756,-26.75704602
2016,Texas,Wichita County,131838,316,1726,1328,398,437,-491,-54,-28,12400,13.107533414,10.085054678,3.0224787363,3.3186512758,-3.72873633,-0.410085055
2016,Texas,Wilbarger County,12892,-145,166,138,28,14,-190,-176,3,638,12.804196074,10.644452158,2.1597439161,1.079871958,-14.65540514,-13.57553319
2016,Texas,Willacy County,21810,-73,285,171,114,41,-243,-202,15,3307,13.04556794,7.827340764,5.218227176,1.8767308264,-11.12306319,-9.246332364
2016,Texas,Williamson County,528718,20659,6619,2611,4008,1114,14661,15775,876,5820,12.768415966,5.0367629683,7.7316529977,2.148967425,28.281877395,30.43084482
2016,Texas,Wilson County,48480,1024,548,398,150,17,801,818,56,524,11.424282855,8.2971981321,3.1270847231,0.3544029353,16.698632422,17.053035357
2016,Texas,Winkler County,7893,-103,141,48,93,10,-212,-202,6,97,17.748127635,6.0419157908,11.706211845,1.2587324564,-26.68512808,-25.42639562
2016,Texas,Wise County,64455,1619,810,580,230,33,1321,1354,35,986,12.726744232,9.1129773511,3.6137668806,0.5184969872,20.755591519,21.274088506
2016,Texas,Wood County,44227,580,416,628,-212,10,803,813,-21,1910,9.4681020552,14.293192526,-4.82509047,0.2275986071,18.27616815,18.503766757
2016,Texas,Yoakum County,8488,-25,162,49,113,25,-165,-140,2,56,19.057702488,5.764366802,13.293335686,2.9410034704,-19.4106229,-16.46961943
2016,Texas,Young County,18152,-76,225,234,-9,7,-88,-81,14,273,12.369433755,12.864211105,-0.49477735,0.3848268279,-4.83782298,-4.452996152
2016,Texas,Zapata County,14349,-48,283,99,184,12,-241,-229,-3,30,19.689695958,6.8879148403,12.801781117,0.8348987685,-16.76755027,-15.9326515
2016,Texas,Zavala County,12023,-204,193,96,97,31,-346,-315,14,413,15.917525773,7.9175257732,8.0,2.5567010309,-28.53608247,-25.97938144
2016,Utah,Utah,3051217,60585,51444,16447,34997,5634,19778,25412,176,45776,17.029224001,5.4443598309,11.58486417,1.8649919917,6.547002416,8.4119944077
2016,Utah,Beaver County,6463,119,100,49,51,7,58,65,3,38,15.616459749,7.6520652768,7.9643944718,1.0931521824,9.0575466542,10.150698837
2016,Utah,Box Elder County,53139,1141,885,341,544,5,593,598,-1,339,16.83517696,6.4867743991,10.34840256,0.0951139941,11.280519703,11.375633697
2016,Utah,Cache County,122753,2693,2395,506,1889,330,458,788,16,3487,19.727115105,4.1678163854,15.55929872,2.7181411209,3.7724504042,6.4905915252
2016,Utah,Carbon County,20399,-31,267,193,74,8,-109,-101,-4,539,13.078938989,9.454064513,3.6248744765,0.3918783218,-5.339342134,-4.947463812
2016,Utah,Daggett County,1095,-15,10,7,3,1,-22,-21,3,72,9.0702947846,6.3492063492,2.7210884354,0.9070294785,-19.95464853,-19.04761905
2016,Utah,Davis County,342281,6513,5861,1642,4219,461,1974,2435,-141,3040,17.28783613,4.8433077845,12.444528345,1.3597837324,5.822588043,7.1823717755
2016,Utah,Duchesne County,20337,-444,449,129,320,13,-786,-773,9,233,21.839583637,6.2746242522,15.564959385,0.632326475,-38.23143149,-37.59910501
2016,Utah,Emery County,10216,-136,130,81,49,0,-179,-179,-6,43,12.640995722,7.8763127188,4.7646830027,0.0,-17.40567872,-17.40567872
2016,Utah,Garfield County,4986,-5,53,30,23,11,-49,-38,10,171,10.624436203,6.0138318132,4.6106043901,2.2050716648,-9.822591962,-7.617520297
2016,Utah,Grand County,9579,86,125,71,54,5,33,38,-6,143,13.108221477,7.4454697987,5.6627516779,0.5243288591,3.4605704698,3.9848993289
2016,Utah,Iron County,49937,1643,869,294,575,25,1025,1050,18,862,17.692988975,5.9858904012,11.707098574,0.5090042858,20.869175718,21.378180004
2016,Utah,Juab County,11010,444,185,74,111,-1,319,318,15,86,17.148683723,6.8594734891,10.289210234,-0.092695588,29.569892473,29.477196885
2016,Utah,Kane County,7334,214,78,71,7,-1,202,201,6,260,10.792860108,9.8242700982,0.9685900097,-0.138370001,27.95074028,27.812370278
2016,Utah,Millard County,12694,45,204,98,106,11,-65,-54,-7,122,16.099120073,7.7338910153,8.3652290573,0.8680898078,-5.129621592,-4.261531784
2016,Utah,Morgan County,11437,346,172,38,134,21,194,215,-3,0,15.269886364,3.3735795455,11.896306818,1.8643465909,17.223011364,19.087357955
2016,Utah,Piute County,1466,-37,16,11,5,0,-44,-44,2,37,10.778039744,7.409902324,3.36813742,0.0,-29.6396093,-29.6396093
2016,Utah,Rich County,2319,23,37,15,22,2,-6,-4,5,1,16.034669556,6.5005417118,9.534127844,0.8667388949,-2.600216685,-1.73347779
2016,Utah,Salt Lake County,1121354,16732,17746,6387,11359,3353,2449,5802,-429,14042,15.944466607,5.7386063462,10.205860261,3.0126110973,2.2003831128,5.2129942102
2016,Utah,San Juan County,16895,1188,240,112,128,13,1038,1051,9,372,14.723023127,6.8707441261,7.8522790013,0.7974970861,63.677075026,64.474572112
2016,Utah,Sanpete County,29409,608,394,172,222,35,362,397,-11,2755,13.537192922,5.9096375193,7.6275554029,1.2025425185,12.437725477,13.640267995
2016,Utah,Sevier County,21267,327,317,184,133,14,166,180,14,252,15.021205013,8.7189328784,6.302272135,0.6633970668,7.8659937925,8.5293908593
2016,Utah,Summit County,40307,826,417,149,268,76,466,542,16,70,10.452699654,3.7348974783,6.7178021758,1.9050483782,11.68095453,13.586002908
2016,Utah,Tooele County,64833,1954,982,317,665,27,1263,1290,-1,354,15.37835129,4.964294663,10.414056627,0.4228263593,19.778877474,20.201703834
2016,Utah,Uintah County,36373,-1416,727,226,501,28,-1964,-1936,19,192,19.605728001,6.0947655133,13.510962488,0.7551036919,-52.96513039,-52.2100267
2016,Utah,Utah County,592299,17503,12162,2269,9893,873,6574,7447,163,13456,20.841491053,3.888286729,16.953204324,1.4960221747,11.265578209,12.761600384
2016,Utah,Wasatch County,30528,1363,475,126,349,77,891,968,46,218,15.914763875,4.2216005227,11.693163352,2.5798669861,29.852746553,32.432613539
2016,Utah,Washington County,160245,4795,2232,1206,1026,18,3267,3285,484,1903,14.140230286,7.6402857188,6.4999445667,0.1140341152,20.69719191,20.811226025
2016,Utah,Wayne County,2702,-1,35,24,11,4,-19,-15,3,9,12.950971323,8.88066605,4.0703052729,1.4801110083,-7.03052729,-5.550416281
2016,Utah,Weber County,247560,4107,3881,1625,2256,218,1689,1907,-56,2680,15.808135426,6.6189693552,9.189166071,0.8879601966,6.8796549175,7.7676151141
2016,Vermont,Vermont,624594,-1494,6035,5547,488,955,-2865,-1910,-72,25240,9.6507345592,8.8703603314,0.7803742278,1.5271667778,-4.581500333,-3.054333556
2016,Vermont,Addison County,36959,25,309,318,-9,74,-45,29,5,2849,8.3634444399,8.6070399091,-0.243595469,2.0028960795,-1.217977346,0.7849187338
2016,Vermont,Bennington County,36191,-213,344,429,-85,32,-125,-93,-35,1476,9.4772367243,11.818995799,-2.341759074,0.8816034162,-3.443763345,-2.562159928
2016,Vermont,Caledonia County,30333,-458,288,294,-6,13,-468,-455,3,1289,9.4234670506,9.6197892808,-0.19632223,0.4253648321,-15.31313396,-14.88776913
2016,Vermont,Chittenden County,161531,65,1595,1097,498,622,-1136,-514,81,9687,9.8762527206,6.7926327489,3.0836199717,3.8514289606,-7.03412106,-3.182692099
2016,Vermont,Essex County,6176,19,53,63,-10,0,22,22,7,16,8.5948268872,10.216492338,-1.62166545,0.0,3.5676639909,3.5676639909
2016,Vermont,Franklin County,48915,-20,620,398,222,46,-304,-258,16,598,12.672457844,8.1349003577,4.5375574859,0.9402146142,-6.213592233,-5.273377619
2016,Vermont,Grand Isle County,6919,47,67,52,15,3,3,6,26,0,9.7164817635,7.5411500254,2.1753317381,0.4350663476,0.4350663476,0.8701326952
2016,Vermont,Lamoille County,25333,129,256,195,61,20,68,88,-20,696,10.131191009,7.7171181511,2.4140728575,0.7914992975,2.6910976117,3.4825969092
2016,Vermont,Orange County,28919,41,268,268,0,17,35,52,-11,737,9.2738377424,9.2738377424,0.0,0.5882658269,1.2111355261,1.799401353
2016,Vermont,Orleans County,26863,-225,273,301,-28,19,-192,-173,-24,777,10.120294341,11.158273248,-1.037978907,0.7043428296,-7.117569647,-6.413226817
2016,Vermont,Rutland County,59310,-396,544,642,-98,29,-281,-252,-46,2324,9.1416280164,10.788465416,-1.6468374,0.4873294347,-4.722054178,-4.234724743
2016,Vermont,Washington County,58504,-202,566,512,54,40,-295,-255,-1,2404,9.6578790206,8.7364559338,0.9214230868,0.6825356198,-5.033700196,-4.351164576
2016,Vermont,Windham County,43145,-130,385,425,-40,22,-73,-51,-39,1500,8.9099745429,9.8356861838,-0.925711641,0.5091414025,-1.689423745,-1.180282342
2016,Vermont,Windsor County,55496,-176,467,553,-86,18,-74,-56,-34,887,8.4016983305,9.94890616,-1.54720783,0.3238341969,-1.331318365,-1.007484168
2016,Virginia,Virginia,8411808,44221,102366,66558,35808,32545,-25343,7202,1211,241626,12.201393435,7.9333015285,4.2680919068,3.8791625085,-3.020728697,0.8584338112
2016,Virginia,Accomack County,32947,-48,378,469,-91,78,-37,41,2,429,11.464620424,14.224621637,-2.760001213,2.3657153256,-1.122198295,1.2435170301
2016,Virginia,Albemarle County,106878,1275,1054,876,178,345,598,943,154,6547,9.920887044,8.245443122,1.675443922,3.2473491747,5.6287385696,8.8760877443
2016,Virginia,Alleghany County,15595,-90,121,265,-144,3,49,52,2,281,7.73657289,16.943734015,-9.207161125,0.1918158568,3.1329923274,3.3248081841
2016,Virginia,Amelia County,12913,44,129,140,-11,3,53,56,-1,128,10.006981615,10.860290125,-0.85330851,0.2327205027,4.1113955473,4.34411605
2016,Virginia,Amherst County,31633,-3,315,376,-61,17,42,59,-1,1286,9.9574831276,11.885757638,-1.92827451,0.5373879783,1.327664417,1.8650523953
2016,Virginia,Appomattox County,15475,47,193,168,25,0,30,30,-8,56,12.490696696,10.872730803,1.6179658933,0.0,1.9415590719,1.9415590719
2016,Virginia,Arlington County,230050,2153,3127,1054,2073,2071,-2082,-11,91,2921,13.656602183,4.6031527666,9.0534494166,9.0447147814,-9.092755275,-0.048040494
2016,Virginia,Augusta County,74997,460,698,758,-60,30,510,540,-20,2797,9.3356694799,10.138162558,-0.802493078,0.4012465392,6.8211911672,7.2224377065
2016,Virginia,Bath County,4476,-26,49,49,0,10,-31,-21,-5,53,10.915571397,10.915571397,0.0,2.227667632,-6.905769659,-4.678102027
2016,Virginia,Bedford County,77960,312,626,833,-207,30,500,530,-11,547,8.0458588247,10.706390417,-2.660531592,0.3855842887,6.4264048121,6.8119891008
2016,Virginia,Bland County,6513,-52,49,87,-38,-1,-10,-11,-3,686,7.4935005353,13.304786665,-5.811286129,-0.152928582,-1.529285824,-1.682214406
2016,Virginia,Botetourt County,33231,-147,246,344,-98,2,-58,-56,7,278,7.3863892267,10.328934528,-2.942545302,0.0600519449,-1.741506403,-1.681454458
2016,Virginia,Brunswick County,16243,-230,141,228,-87,4,-141,-137,-6,1847,8.6196356523,13.938134246,-5.318498594,0.244528671,-8.619635652,-8.375106981
2016,Virginia,Buchanan County,22178,-602,169,308,-139,24,-495,-471,8,1153,7.5181280306,13.701677121,-6.18354909,1.0676631523,-22.02055252,-20.95288936
2016,Virginia,Buckingham County,17048,52,147,152,-5,17,47,64,-7,2204,8.635882975,8.9296204911,-0.293737516,0.9987075549,2.7611326519,3.7598402068
2016,Virginia,Campbell County,54952,-209,438,528,-90,39,-132,-93,-26,437,7.9554639325,9.5901483022,-1.63468437,0.7083632269,-2.397537076,-1.689173849
2016,Virginia,Caroline County,30178,238,389,277,112,9,124,133,-7,513,12.941215609,9.2152100868,3.7260055225,0.2994111581,4.1252203999,4.4246315579
2016,Virginia,Carroll County,29531,-205,279,390,-111,-2,-91,-93,-1,337,9.415020163,13.160780873,-3.74576071,-0.067491184,-3.07084887,-3.138340054
2016,Virginia,Charles City County,7071,-1,63,95,-32,0,21,21,10,0,8.9090009192,13.434207735,-4.525206816,0.0,2.9696669731,2.9696669731
2016,Virginia,Charlotte County,12129,-48,147,161,-14,2,-28,-26,-8,175,12.09577882,13.247757755,-1.151978935,0.1645684193,-2.30395787,-2.139389451
2016,Virginia,Chesterfield County,339009,3470,3780,2361,1419,699,1352,2051,0,4326,11.207504877,7.0002431258,4.2072617516,2.0724989178,4.0086102101,6.0811091279
2016,Virginia,Clarke County,14374,83,135,144,-9,6,77,83,9,180,9.4191522763,10.047095761,-0.627943485,0.4186289901,5.3724053724,5.7910343625
2016,Virginia,Craig County,5158,-35,37,71,-34,0,3,3,-4,9,7.1490677229,13.718481306,-6.569413583,0.0,0.5796541397,0.5796541397
2016,Virginia,Culpeper County,50083,714,643,410,233,33,452,485,-4,1426,12.930861119,8.2451836062,4.6856775128,0.6636367293,9.0898121707,9.7534489
2016,Virginia,Cumberland County,9652,-44,85,105,-20,0,-20,-20,-4,37,8.7864378747,10.853835022,-2.067397147,0.0,-2.067397147,-2.067397147
2016,Virginia,Dickenson County,14968,-167,140,189,-49,2,-107,-105,-13,564,9.3013985317,12.556888018,-3.255489486,0.1328771219,-7.108926021,-6.976048899
2016,Virginia,Dinwiddie County,28144,177,181,262,-81,35,242,277,-19,719,6.4514979238,9.3386323537,-2.88713443,1.2475272228,8.625759655,9.8732868778
2016,Virginia,Essex County,11123,1,125,113,12,8,-20,-12,1,190,11.238480557,10.159586424,1.0788941335,0.7192627557,-1.798156889,-1.078894134
2016,Virginia,Fairfax County,1138652,1180,14298,5610,8688,9919,-17820,-7901,393,10071,12.563463151,4.9294326671,7.6340304834,8.7156938726,-15.65819788,-6.942504011
2016,Virginia,Fauquier County,69069,373,749,602,147,38,184,222,4,389,10.873589083,8.7395201974,2.1340688854,0.5516640656,2.6712154756,3.2228795412
2016,Virginia,Floyd County,15731,91,126,159,-33,8,132,140,-16,85,8.0328966243,10.136750502,-2.103853878,0.5100251825,8.4154155111,8.9254406936
2016,Virginia,Fluvanna County,26271,72,263,204,59,2,22,24,-11,1177,10.024776063,7.7758719268,2.2489041357,0.0762340385,0.8385744235,0.914808462
2016,Virginia,Franklin County,56069,-160,487,633,-146,7,27,34,-48,1362,8.6733512618,11.273575665,-2.600224403,0.1246682933,0.480863417,0.6055317103
2016,Virginia,Frederick County,84421,1244,916,654,262,48,734,782,200,1114,10.93091803,7.8043890739,3.1265289562,0.5727991981,8.759054404,9.3318536021
2016,Virginia,Giles County,16857,90,183,203,-20,17,99,116,-6,136,10.885082084,12.074708542,-1.189626457,1.0111824887,5.8886509636,6.8998334523
2016,Virginia,Gloucester County,37214,156,368,436,-68,14,190,204,20,346,9.9095217579,11.740629039,-1.831107281,0.3769926756,5.1163291685,5.493321844
2016,Virginia,Goochland County,22668,353,193,169,24,8,313,321,8,934,8.5810194963,7.5139497143,1.0670697819,0.3556899273,13.916368406,14.272058333
2016,Virginia,Grayson County,15107,-62,139,193,-54,-1,0,-1,-7,249,9.1821905139,12.74937244,-3.567181926,-0.066058925,0.0,-0.066058925
2016,Virginia,Greene County,19371,165,217,141,76,30,65,95,-6,137,11.250226819,7.3100552142,3.9401716048,1.5553308966,3.3698836094,4.9252145061
2016,Virginia,Greensville County,11706,-163,161,124,37,7,-210,-203,3,3318,13.658536585,10.51961824,3.1389183457,0.5938494168,-17.8154825,-17.22163309
2016,Virginia,Halifax County,34992,-136,364,498,-134,2,8,10,-12,753,10.38220194,14.204221335,-3.822019395,0.0570450656,0.2281802624,0.285225328
2016,Virginia,Hanover County,104392,1221,970,800,170,74,957,1031,20,2024,9.3465598397,7.7085029605,1.6380568791,0.7130365239,9.2212966666,9.9343331904
2016,Virginia,Henrico County,326501,1359,4034,2682,1352,1731,-1670,61,-54,2609,12.381012303,8.2315009906,4.1495113122,5.3127249123,-5.125505837,0.1872190755
2016,Virginia,Henry County,51445,-376,445,714,-269,36,-99,-63,-44,561,8.6185191641,13.82836558,-5.209846416,0.6972285166,-1.917378421,-1.220149904
2016,Virginia,Highland County,2216,8,14,23,-9,0,17,17,0,0,6.3291139241,10.397830018,-4.068716094,0.0,7.6853526221,7.6853526221
2016,Virginia,Isle of Wight County,36596,203,385,369,16,27,143,170,17,310,10.549534861,10.111112633,0.438422228,0.7398375098,3.9183986628,4.6582361726
2016,Virginia,James City County,74404,1323,736,657,79,139,981,1120,124,1083,9.9806760009,8.909380615,1.071295386,1.8849374513,13.303047768,15.187985219
2016,Virginia,King and Queen County,7159,-38,71,82,-11,1,-26,-25,-2,0,9.8913346336,11.423794929,-1.532460295,0.1393145723,-3.62217888,-3.482864308
2016,Virginia,King George County,25984,528,287,150,137,5,372,377,14,301,11.158631415,5.832037325,5.3265940902,0.1944012442,14.463452566,14.65785381
2016,Virginia,King William County,16334,103,173,136,37,0,71,71,-5,72,10.624904038,8.3525257178,2.2723783203,0.0,4.3605097497,4.3605097497
2016,Virginia,Lancaster County,10972,-10,90,204,-114,11,70,81,23,183,8.1989614649,18.584312654,-10.38535119,1.0020952902,6.3769700282,7.3790653184
2016,Virginia,Lee County,24179,-533,221,323,-102,5,-441,-436,5,1629,9.0405187049,13.213065799,-4.172547095,0.2045366223,-18.04013009,-17.83559346
2016,Virginia,Loudoun County,385945,11386,5105,1392,3713,2433,4902,7335,338,1362,13.425307428,3.6607302526,9.7645771751,6.3983884371,12.891450933,19.28983937
2016,Virginia,Louisa County,35236,618,360,341,19,5,585,590,9,211,10.307212185,9.7632204312,0.5439917542,0.1431557248,16.749219801,16.892375526
2016,Virginia,Lunenburg County,12273,-64,116,167,-51,10,-14,-4,-9,973,9.4270621698,13.571718813,-4.144656644,0.8126777733,-1.137748883,-0.325071109
2016,Virginia,Madison County,13078,-14,106,113,-7,3,-11,-8,1,193,8.1008788689,8.6358425678,-0.534963699,0.2292701567,-0.840657241,-0.611387084
2016,Virginia,Mathews County,8782,-84,63,125,-62,7,-19,-12,-10,86,7.1396192203,14.165911151,-7.026291931,0.7932910245,-2.153218495,-1.359927471
2016,Virginia,Mecklenburg County,30892,-119,298,471,-173,25,47,72,-18,905,9.6279663344,15.217356186,-5.589389852,0.8077152965,1.5185047574,2.326220054
2016,Virginia,Middlesex County,10778,102,101,134,-33,2,136,138,-3,409,9.4154936142,12.491843013,-3.076349399,0.1864454181,12.678288431,12.864733849
2016,Virginia,Montgomery County,98602,966,915,618,297,718,-6,712,-43,9817,9.3254109805,6.2984743016,3.0269366789,7.3176449006,-0.061150236,7.2564946646
2016,Virginia,Nelson County,14869,81,129,149,-20,15,101,116,-15,102,8.6994638702,10.048217959,-1.348754088,1.0115655663,6.8112081465,7.8227737128
2016,Virginia,New Kent County,21147,723,196,129,67,28,591,619,37,552,9.4296504775,6.206249549,3.2234009285,1.3470929254,28.433282817,29.780375743
2016,Virginia,Northampton County,12139,0,126,214,-88,25,25,50,38,258,10.379767691,17.629129253,-7.249361562,2.0594777165,2.0594777165,4.1189554329
2016,Virginia,Northumberland County,12222,-34,89,176,-87,34,24,58,-5,0,7.2718359343,14.380259825,-7.108423891,2.7780047389,1.9609445216,4.7389492606
2016,Virginia,Nottoway County,15595,-56,178,208,-30,-4,-40,-44,18,2295,11.393458363,13.313704154,-1.920245791,-0.256032772,-2.560327722,-2.816360494
2016,Virginia,Orange County,35533,289,406,312,94,47,178,225,-30,601,11.472653546,8.8164234144,2.6562301313,1.3281150656,5.029882589,6.3579976546
2016,Virginia,Page County,23654,-25,223,283,-60,0,34,34,1,194,9.4226015676,11.957830689,-2.535229121,0.0,1.4366298354,1.4366298354
2016,Virginia,Patrick County,17923,-118,136,234,-98,9,-32,-23,3,261,7.5631186742,13.013013013,-5.449894339,0.5005005005,-1.779557335,-1.279056835
2016,Virginia,Pittsylvania County,61687,-392,470,735,-265,15,-96,-81,-46,1067,7.5949776191,11.877252234,-4.282274615,0.2423929027,-1.551314578,-1.308921675
2016,Virginia,Powhatan County,28443,396,240,239,1,12,371,383,12,1390,8.497079129,8.4616746327,0.0354044964,0.4248539565,13.135068154,13.55992211
2016,Virginia,Prince Edward County,23142,-79,226,229,-3,24,-140,-116,40,4228,9.7491534198,9.8785669607,-0.129413541,1.0353083278,-6.039298579,-5.003990251
2016,Virginia,Prince George County,37845,-463,373,251,122,83,-656,-573,-12,4411,9.7960684412,6.5919924363,3.2040760049,2.1798222,-17.22847426,-15.04865206
2016,Virginia,Prince William County,455210,5031,6793,1919,4874,2079,-1804,275,-118,2669,15.00570473,4.2390618839,10.766642846,4.5925011238,-3.98502743,0.6074736936
2016,Virginia,Pulaski County,34203,-105,317,426,-109,1,17,18,-14,1156,9.2539884106,12.435959189,-3.181970778,0.0291923925,0.4962706719,0.5254630643
2016,Virginia,Rappahannock County,7388,-13,55,73,-18,1,-18,-17,22,35,7.4379606464,9.8722023125,-2.434241666,0.1352356481,-2.434241666,-2.299006018
2016,Virginia,Richmond County,8774,0,68,98,-30,4,-2,2,28,1489,7.7501709597,11.16936403,-3.41919307,0.4558924094,-0.227946205,0.2279462047
2016,Virginia,Roanoke County,94031,115,786,975,-189,212,106,318,-14,2331,8.3640600808,10.375265367,-2.011205287,2.2559551363,1.1279775681,3.3839327044
2016,Virginia,Rockbridge County,22392,-45,147,231,-84,16,14,30,9,196,6.5582547012,10.305828816,-3.747574115,0.7138236409,0.6245956858,1.3384193268
2016,Virginia,Rockingham County,79744,884,845,749,96,120,651,771,17,1660,10.655468967,9.4449068119,1.2105621548,1.5132026935,8.2091246122,9.7223273057
2016,Virginia,Russell County,27370,-439,250,369,-119,8,-308,-300,-20,429,9.0614182932,13.374653401,-4.313235108,0.2899653854,-11.16366734,-10.87370195
2016,Virginia,Scott County,21930,-230,170,289,-119,1,-92,-91,-20,805,7.7114992062,13.10954865,-5.398049444,0.04536176,-4.173281923,-4.127920163
2016,Virginia,Shenandoah County,43175,124,478,471,7,33,79,112,5,427,11.087143089,10.924779069,0.1623640201,0.7654303806,1.8323939415,2.5978243221
2016,Virginia,Smyth County,31062,-327,263,467,-204,24,-136,-112,-11,845,8.422603321,14.955725289,-6.533121968,0.7686025844,-4.355414645,-3.586812061
2016,Virginia,Southampton County,18057,-110,141,211,-70,3,-33,-30,-10,1671,7.7848939929,11.649734982,-3.864840989,0.1656360424,-1.821996466,-1.656360424
2016,Virginia,Spotsylvania County,132010,1407,1603,932,671,226,457,683,53,524,12.208078046,7.0978969053,5.1101811411,1.7211638419,3.4804065298,5.2015703716
2016,Virginia,Stafford County,144361,2569,1736,726,1010,333,1134,1467,92,3612,12.133369212,5.0742085528,7.0591606588,2.327426237,7.9258298882,10.253256125
2016,Virginia,Surry County,6544,-126,45,63,-18,0,-108,-108,0,0,6.8109580748,9.5353413047,-2.72438323,0.0,-16.34629938,-16.34629938
2016,Virginia,Sussex County,11504,-216,98,136,-38,3,-179,-176,-2,2548,8.439545298,11.712022046,-3.272476748,0.2583534275,-15.41508784,-15.15673441
2016,Virginia,Tazewell County,42150,-784,446,639,-193,13,-600,-587,-4,1629,10.483757228,15.020450378,-4.53669315,0.3055803676,-14.10370928,-13.79812891
2016,Virginia,Warren County,39155,8,496,376,120,8,-187,-179,67,942,12.668897346,9.6038415366,3.0650558096,0.204337054,-4.776378637,-4.572041583
2016,Virginia,Washington County,54214,-80,588,617,-29,16,-31,-15,-36,1494,10.837910569,11.372433369,-0.5345228,0.2949091311,-0.571386442,-0.27647731
2016,Virginia,Westmoreland County,17592,39,163,212,-49,0,83,83,5,70,9.2758571632,12.064305022,-2.788447859,0.0,4.7232892303,4.7232892303
2016,Virginia,Wise County,39228,-426,426,472,-46,16,-402,-386,6,2963,10.800943181,11.96724221,-1.166299029,0.4056692275,-10.19243934,-9.786770112
2016,Virginia,Wythe County,29016,-175,325,373,-48,5,-126,-121,-6,260,11.167041765,12.816327933,-1.649286168,0.1718006425,-4.329376192,-4.157575549
2016,Virginia,York County,67976,13,740,507,233,216,-407,-191,-29,649,10.887236187,7.4592280361,3.4280081507,3.177895968,-5.987979903,-2.810083935
2016,Virginia,Alexandria city,155810,2638,2824,798,2026,2161,-1661,500,112,1834,18.27938197,5.1653494378,13.114032533,13.987869844,-10.75143536,3.2364344849
2016,Virginia,Bristol city,16960,-197,68,244,-176,8,-20,-12,-9,219,3.9862824985,14.303719553,-10.31743705,0.4689744116,-1.172436029,-0.703461617
2016,Virginia,Buena Vista city,6452,-143,4,72,-68,5,-87,-82,7,426,0.613167778,11.037020005,-10.42385223,0.7664597225,-13.33639917,-12.56993945
2016,Virginia,Charlottesville city,46912,727,660,302,358,440,-111,329,40,2420,14.178759788,6.4878567516,7.6909030366,9.4525065255,-2.384609601,7.0678969247
2016,Virginia,Chesapeake city,237940,2509,3013,1823,1190,378,895,1273,46,4158,12.729972897,7.7022039795,5.027768917,1.5970560089,3.7813892275,5.3784452364
2016,Virginia,Colonial Heights city,17772,125,258,196,62,57,18,75,-12,171,14.568451961,11.067506141,3.50094582,3.2186114797,1.0164036252,4.2350151049
2016,Virginia,Covington city,5518,-71,0,55,-55,2,-15,-13,-3,87,0.0,9.9036643558,-9.903664356,0.3601332493,-2.70099937,-2.34086612
2016,Virginia,Danville city,41898,-231,560,666,-106,53,-143,-90,-35,1586,13.329048996,15.852047556,-2.52299856,1.26149928,-3.403667869,-2.142168589
2016,Virginia,Emporia city,5305,-177,0,74,-74,4,-114,-110,7,246,0.0,13.720218782,-13.72021878,0.7416334477,-21.13655326,-20.39491981
2016,Virginia,Fairfax city,24164,441,698,248,450,208,-224,-16,7,521,29.15196191,10.357717126,18.794244785,8.6871175893,-9.355357404,-0.668239815
2016,Virginia,Falls Church city,14014,50,280,79,201,131,-297,-166,15,42,20.015726642,5.6472943027,14.36843234,9.3645006791,-21.23096719,-11.86646651
2016,Virginia,Franklin city,8306,-81,65,92,-27,14,-80,-66,12,129,7.7876954412,11.022584317,-3.234888876,1.6773497873,-9.584855928,-7.90750614
2016,Virginia,Fredericksburg city,28297,330,408,235,173,112,38,150,7,2602,14.503057017,8.3534764681,6.1495805488,3.981231338,1.3507749182,5.3320062562
2016,Virginia,Galax city,6775,-96,59,90,-31,3,-76,-73,8,377,8.6472226293,13.190678587,-4.543455958,0.4396892862,-11.13879525,-10.69910597
2016,Virginia,Hampton city,135410,-944,1699,1267,432,287,-1613,-1326,-50,4777,12.50349568,9.3242666431,3.179229037,2.1121266982,-11.8705936,-9.758466905
2016,Virginia,Harrisonburg city,53078,756,604,253,351,356,58,414,-9,7624,11.461100569,4.8007590133,6.660341556,6.7552182163,1.10056926,7.8557874763
2016,Virginia,Hopewell city,22735,385,368,285,83,45,266,311,-9,237,16.324719973,12.642785849,3.6819341244,1.9962293446,11.799933459,13.796162804
2016,Virginia,Lexington city,7045,-29,0,42,-42,7,7,14,-1,2707,0.0,5.9494298463,-5.949429846,0.9915716411,0.9915716411,1.9831432821
2016,Virginia,Lynchburg city,80212,707,1213,710,503,261,-103,158,46,10812,15.189366191,8.8907254707,6.2986407208,3.2682807716,-1.289781301,1.9784994709
2016,Virginia,Manassas city,41483,-120,747,167,580,288,-1001,-713,13,46,17.981368702,4.0199311557,13.961437547,6.9325758852,-24.09551549,-17.1629396
2016,Virginia,Manassas Park city,15915,13,19,42,-23,91,-64,27,9,6,1.1943300751,2.6400980608,-1.445767986,5.720212465,-4.023006569,1.6972058962
2016,Virginia,Martinsville city,13445,-132,220,210,10,17,-153,-136,-6,377,16.283028643,15.542890978,0.7401376656,1.2582340315,-11.32410628,-10.06587225
2016,Virginia,Newport News city,181825,-160,2751,1518,1233,615,-1927,-1312,-81,8481,15.123278634,8.3450152552,6.7782633792,3.3808856271,-10.59344163,-7.212556005
2016,Virginia,Norfolk city,245115,-1015,3596,2096,1500,1038,-3480,-2442,-73,32949,14.640352574,8.5334201875,6.1069323861,4.2259972112,-14.16808314,-9.942085925
2016,Virginia,Norton city,3864,-62,17,27,-10,10,-65,-55,3,68,4.3645699615,6.9319640565,-2.567394095,2.567394095,-16.68806162,-14.12066752
2016,Virginia,Petersburg city,31882,-162,694,454,240,105,-496,-391,-11,887,21.7126052,14.203923286,7.5086819135,3.2850483371,-15.51794262,-12.23289428
2016,Virginia,Poquoson city,12017,-41,102,99,3,7,-48,-41,-3,51,8.4735202492,8.2242990654,0.2492211838,0.5815160955,-3.987538941,-3.406022845
2016,Virginia,Portsmouth city,95252,-1104,1464,1061,403,118,-1611,-1493,-14,3162,15.281199115,11.074694167,4.2065049476,1.2316813494,-16.81558181,-15.58390046
2016,Virginia,Radford city,17483,133,147,69,78,70,-25,45,10,3004,8.4402721557,3.9617603996,4.4785117561,4.019177217,-1.435420435,2.5837567824
2016,Virginia,Richmond city,223170,3542,2987,2054,933,598,1926,2524,85,13685,13.491479185,9.2773680098,4.2141111748,2.7010058763,8.6992262838,11.40023216
2016,Virginia,Roanoke city,99660,-309,1477,1164,313,559,-1114,-555,-67,2117,14.797449268,11.661632328,3.1358169404,5.6003887211,-11.1607031,-5.560314383
2016,Virginia,Salem city,25549,145,348,305,43,94,9,103,-1,1929,13.659647126,11.971817165,1.6878299609,3.6896747983,0.353266736,4.0429415344
2016,Virginia,Staunton city,24363,25,313,312,1,30,-2,28,-4,1097,12.853945504,12.812878586,0.0410669185,1.2320075563,-0.082133837,1.1498737192
2016,Virginia,Suffolk city,89273,1157,1201,789,412,99,599,698,47,1068,13.540862173,8.8957037922,4.6451583807,1.1161909701,6.7535191021,7.8697100722
2016,Virginia,Virginia Beach city,452602,748,6068,3238,2830,1549,-3664,-2115,33,9495,13.418010384,7.1601050797,6.2579053044,3.4252633627,-8.102107786,-4.676844424
2016,Virginia,Waynesboro city,21887,299,339,224,115,64,124,188,-4,192,15.595169638,10.304772858,5.2903967798,2.9442208166,5.7044278321,8.6486486486
2016,Virginia,Williamsburg city,15214,70,91,104,-13,145,-94,51,32,4416,5.9951248435,6.8515712498,-0.856446406,9.552671454,-6.192766322,3.3599051321
2016,Virginia,Winchester city,27516,158,395,264,131,95,-50,45,-18,933,14.396617706,9.6220432263,4.7745744797,3.4624776761,-1.822356672,1.6401210045
2016,Washington,Washington,7288000,127710,89982,55979,34003,24410,67571,91981,1726,142590,12.455730055,7.7488754725,4.7068545828,3.3789465743,9.3534944274,12.732441002
2016,Washington,Adams County,19238,88,374,116,258,14,-192,-178,8,162,19.485255809,6.0435552777,13.441700531,0.7293946025,-10.00312598,-9.273731374
2016,Washington,Asotin County,22306,217,247,250,-3,-8,222,214,6,174,11.127379209,11.262529564,-0.135150355,-0.360400946,10.001126253,9.6407253069
2016,Washington,Benton County,193686,3349,2708,1385,1323,303,1730,2033,-7,1425,14.103321936,7.2131096315,6.890212305,1.5780304825,9.0098770126,10.587907495
2016,Washington,Chelan County,76338,896,938,663,275,58,546,604,17,931,12.359994729,8.7363288971,3.6236658321,0.7642640664,7.1946237976,7.958887864
2016,Washington,Clallam County,74570,1048,689,998,-309,57,1194,1251,106,1889,9.3050266051,13.478108203,-4.173081598,0.7697917511,16.125111417,16.894903168
2016,Washington,Clark County,467018,8624,5698,3524,2174,312,5857,6169,281,3427,12.314515048,7.616067222,4.6984478265,0.6742942603,12.658145777,13.332440038
2016,Washington,Columbia County,3938,0,35,38,-3,1,6,7,-4,75,8.8877602844,9.6495683088,-0.761808024,0.2539360081,1.5236160488,1.7775520569
2016,Washington,Cowlitz County,105160,1782,1195,1094,101,47,1596,1643,38,1208,11.460740968,10.492092568,0.9686483998,0.4507571762,15.306562833,15.757320009
2016,Washington,Douglas County,41327,762,536,321,215,68,468,536,11,190,13.090411762,7.8395936111,5.2508181507,1.6607238802,11.429687882,13.090411762
2016,Washington,Ferry County,7614,30,82,77,5,6,18,24,1,252,10.790893539,10.132912225,0.6579813133,0.789577576,2.368732728,3.158310304
2016,Washington,Franklin County,90160,1335,1628,457,1171,220,-23,197,-33,2840,18.191468559,5.1065731765,13.084895382,2.458306562,-0.257004777,2.2013017851
2016,Washington,Garfield County,2247,22,25,24,1,0,19,19,2,36,11.180679785,10.733452594,0.4472271914,0.0,8.4973166369,8.4973166369
2016,Washington,Grant County,93546,422,1469,660,809,91,-452,-361,-26,1244,15.739004661,7.0713022982,8.6677023625,0.9749825896,-4.842770665,-3.867788075
2016,Washington,Grays Harbor County,71628,605,757,825,-68,50,611,661,12,2697,10.613315014,11.566690735,-0.953375721,0.7010115597,8.5663612593,9.267372819
2016,Washington,Island County,82636,1840,918,695,223,260,1281,1541,76,1895,11.234030055,8.5050663273,2.728963728,3.1817514318,15.676244554,18.857995986
2016,Washington,Jefferson County,31139,693,179,362,-183,18,749,767,109,631,5.8131038402,11.756109442,-5.943005602,0.5845579281,24.324104896,24.908662824
2016,Washington,King County,2149970,35714,25905,13580,12325,15500,8511,24011,-622,38777,12.149918883,6.3692684206,5.7806504627,7.2697835434,3.9918146927,11.261598236
2016,Washington,Kitsap County,264811,4297,3240,2295,945,314,2873,3187,165,9514,12.335221054,8.7374482463,3.5977728073,1.1954504354,10.937990768,12.133441203
2016,Washington,Kittitas County,44866,1809,391,286,105,72,1563,1635,69,2362,8.8941460141,6.5056924809,2.3884535332,1.6377967085,35.55383688,37.191633588
2016,Washington,Klickitat County,21301,308,203,199,4,16,281,297,7,198,9.599470374,9.4103182485,0.1891521256,0.7566085024,13.287936823,14.044545326
2016,Washington,Lewis County,77066,1312,870,838,32,67,1139,1206,74,943,11.385944248,10.967150896,0.4187933517,0.87684858,14.90642586,15.783274441
2016,Washington,Lincoln County,10350,38,97,121,-24,2,71,73,-11,94,9.3892169199,11.712322137,-2.323105217,0.1935921014,6.8725196012,7.0661117026
2016,Washington,Mason County,62198,1162,607,621,-14,97,1063,1160,16,2507,9.8511774348,10.078387458,-0.227210023,1.5742408751,17.251732476,18.825973352
2016,Washington,Okanogan County,41554,195,499,476,23,90,119,209,-37,640,12.036713181,11.481914778,0.5547984031,2.1709502732,2.8704786945,5.0414289677
2016,Washington,Pacific County,21249,361,204,326,-122,14,453,467,16,287,9.6827016636,15.473336972,-5.790635309,0.6644991338,21.5012934,22.165792534
2016,Washington,Pend Oreille County,13123,57,113,143,-30,0,96,96,-9,98,8.6295773034,10.920615526,-2.291038222,0.0,7.3313223109,7.3313223109
2016,Washington,Pierce County,861312,18636,11775,6964,4811,1681,11785,13466,359,16754,13.820519863,8.1737664819,5.6467533809,1.9730185893,13.832257035,15.805275624
2016,Washington,San Juan County,16339,105,89,125,-36,18,132,150,-9,187,5.4646486354,7.6750683081,-2.210419673,1.1052098364,8.1048721334,9.2100819697
2016,Washington,Skagit County,123681,1957,1447,1229,218,141,1438,1579,160,1626,11.792750759,10.016095842,1.7766549174,1.1491208411,11.71940262,12.868523461
2016,Washington,Skamania County,11510,201,91,96,-5,6,207,213,-7,25,7.9758096323,8.4140409308,-0.438231298,0.5258775582,18.142775757,18.668653315
2016,Washington,Snohomish County,787620,17455,9732,5545,4187,2425,10476,12901,367,9881,12.494663898,7.1190825435,5.3755813543,3.1133949807,13.449866317,16.563261297
2016,Washington,Spokane County,499072,8546,5961,4510,1451,880,6021,6901,194,14982,12.047316183,9.1148122773,2.9325039056,1.7784999565,12.168577544,13.9470775
2016,Washington,Stevens County,44439,639,476,460,16,34,617,651,-28,266,10.7888802,10.426228765,0.3626514353,0.7706343,13.984745974,14.755380274
2016,Washington,Thurston County,275222,6039,3172,2172,1000,665,4060,4725,314,4027,11.653089152,7.9793536062,3.6737355461,2.4430341382,14.915366317,17.358400456
2016,Washington,Wahkiakum County,4139,117,22,47,-25,5,134,139,3,48,5.3914961402,11.518196299,-6.126700159,1.2253400319,32.839112854,34.064452886
2016,Washington,Walla Walla County,60340,191,672,612,60,57,41,98,33,4629,11.154545228,10.15860369,0.9959415382,0.9461444613,0.6805600511,1.6267045124
2016,Washington,Whatcom County,216800,4636,2371,1580,791,397,3305,3702,143,5836,11.054540707,7.366585541,3.6879551664,1.8509711771,15.409218489,17.260189666
2016,Washington,Whitman County,48851,701,454,232,222,423,61,484,-5,6338,9.3607282399,4.7834558407,4.5772723993,8.7215595716,1.2577189926,9.9792785641
2016,Washington,Yakima County,249636,1521,4113,2033,2080,9,-505,-496,-63,3495,16.526335457,8.168743006,8.3575924508,0.0361626596,-2.029127013,-1.992964354
2016,West Virginia,West Virginia,1831102,-9951,19799,22479,-2680,1076,-7659,-6583,-688,48027,10.783313885,12.242947261,-1.459633376,0.5860319077,-4.171392547,-3.58536064
2016,West Virginia,Barbour County,16831,-137,169,198,-29,-1,-103,-104,-4,1037,10.000295867,11.716322968,-1.716027101,-0.059173348,-6.094854877,-6.154028226
2016,West Virginia,Berkeley County,113525,1890,1371,1001,370,14,1474,1488,32,896,12.178006751,8.8914549654,3.2865517854,0.1243560135,13.092911707,13.217267721
2016,West Virginia,Boone County,22816,-447,224,305,-81,0,-354,-354,-12,131,9.7224332125,13.238134508,-3.515701296,0.0,-15.36491677,-15.36491677
2016,West Virginia,Braxton County,14471,11,154,181,-27,6,35,41,-3,370,10.64601984,12.512529812,-1.866509972,0.4147799938,2.4195499637,2.8343299575
2016,West Virginia,Brooke County,22977,-371,199,323,-124,10,-250,-240,-7,851,8.5914732866,13.944954128,-5.353480842,0.431732326,-10.79330815,-10.36157582
2016,West Virginia,Cabell County,95987,-666,1128,1114,14,104,-716,-612,-68,4131,11.710963455,11.565614618,0.1453488372,1.0797342193,-7.433554817,-6.353820598
2016,West Virginia,Calhoun County,7336,-94,71,80,-9,0,-82,-82,-3,22,9.6166869836,10.835703644,-1.21901666,0.0,-11.10659623,-11.10659623
2016,West Virginia,Clay County,8859,-46,93,107,-14,-1,-34,-35,3,74,10.470614726,12.046836298,-1.576221572,-0.112587255,-3.827966674,-3.940553929
2016,West Virginia,Doddridge County,8413,-93,67,73,-6,0,-109,-109,22,990,7.9200898398,8.6293516165,-0.709261777,0.0,-12.88492228,-12.88492228
2016,West Virginia,Fayette County,44323,-499,490,693,-203,15,-305,-290,-6,1833,10.993325481,15.54770318,-4.554377699,0.3365303719,-6.842784228,-6.506253856
2016,West Virginia,Gilmer County,8249,-71,63,80,-17,0,-50,-50,-4,1927,7.6045627376,9.6565876034,-2.052024866,0.0,-6.035367252,-6.035367252
2016,West Virginia,Grant County,11732,-33,115,127,-12,0,-14,-14,-7,126,9.7884836362,10.809890624,-1.021406988,0.0,-1.191641486,-1.191641486
2016,West Virginia,Greenbrier County,35279,-154,328,502,-174,13,17,30,-10,616,9.2770675416,14.198438737,-4.921371196,0.3676886526,0.4808236226,0.8485122751
2016,West Virginia,Hampshire County,23301,-30,229,250,-21,-5,-1,-6,-3,402,9.8215817464,10.722250815,-0.900669068,-0.214445016,-0.042889003,-0.25733402
2016,West Virginia,Hancock County,29590,-254,283,429,-146,24,-128,-104,-4,226,9.5231685567,14.43618131,-4.913012754,0.8076185348,-4.307298853,-3.499680318
2016,West Virginia,Hardy County,13889,-15,138,166,-28,56,-38,18,-5,58,9.9305580542,11.945453891,-2.014895837,4.0297916742,-2.734501493,1.295290181
2016,West Virginia,Harrison County,68400,-170,783,882,-99,10,-47,-37,-34,867,11.433160546,12.878732569,-1.445572023,0.1460173761,-0.686281668,-0.540264291
2016,West Virginia,Jackson County,29152,-6,317,361,-44,-2,54,52,-14,180,10.872920597,12.382095695,-1.509175099,-0.068598868,1.8521694392,1.7835705711
2016,West Virginia,Jefferson County,56368,169,580,481,99,93,-3,90,-20,1219,10.304973927,8.5460214805,1.7589524461,1.6523492675,-0.053301589,1.5990476783
2016,West Virginia,Kanawha County,186241,-1966,2093,2507,-414,119,-1531,-1412,-140,3177,11.179122335,13.390377302,-2.211254967,0.6356022732,-8.177370423,-7.541768149
2016,West Virginia,Lewis County,16309,-138,195,238,-43,2,-88,-86,-9,248,11.906215655,14.531688851,-2.625473196,0.1221150324,-5.373061424,-5.250946392
2016,West Virginia,Lincoln County,21232,-138,254,304,-50,0,-90,-90,2,66,11.924322802,14.27163044,-2.347307638,0.0,-4.225153749,-4.225153749
2016,West Virginia,Logan County,33700,-814,350,500,-150,-1,-688,-689,25,551,10.261823086,14.659747266,-4.39792418,-0.029319495,-20.17181224,-20.20113173
2016,West Virginia,McDowell County,19141,-557,209,342,-133,11,-430,-419,-5,139,10.762378022,17.611164036,-6.848786014,0.5664409485,-22.14269162,-21.57625068
2016,West Virginia,Marion County,56538,-233,628,691,-63,18,-143,-125,-45,1344,11.084732899,12.196736358,-1.11200346,0.3177152742,-2.524071345,-2.206356071
2016,West Virginia,Marshall County,31793,-333,331,396,-65,2,-253,-251,-17,584,10.356857898,12.390681957,-2.033824059,0.0625792018,-7.916269028,-7.853689826
2016,West Virginia,Mason County,26825,-180,268,350,-82,-2,-102,-104,6,687,9.9572728962,13.00390117,-3.046628274,-0.074308007,-3.789708341,-3.864016348
2016,West Virginia,Mercer County,60468,-575,684,913,-229,19,-316,-297,-49,1110,11.258239995,15.027446075,-3.76920608,0.3127288887,-5.201175202,-4.888446314
2016,West Virginia,Mineral County,27411,-2,284,339,-55,6,73,79,-26,654,10.360426091,12.366846637,-2.006420546,0.2188822414,2.6630672698,2.8819495112
2016,West Virginia,Mingo County,24647,-602,321,371,-50,9,-561,-552,0,85,12.866762867,14.870931538,-2.004168671,0.3607503608,-22.48677249,-22.12602213
2016,West Virginia,Monongalia County,104622,631,1228,693,535,424,-294,130,-34,6332,11.77299593,6.6438812538,5.1291146765,4.0649432202,-2.818616289,1.2463269307
2016,West Virginia,Monroe County,13370,-131,123,154,-31,0,-90,-90,-10,57,9.1548509546,11.462171114,-2.307320159,0.0,-6.69867143,-6.69867143
2016,West Virginia,Morgan County,17632,109,144,223,-79,-3,199,196,-8,123,8.1922912815,12.686673304,-4.494382022,-0.170672735,11.321291424,11.150618689
2016,West Virginia,Nicholas County,25311,-236,252,347,-95,1,-141,-140,-1,162,9.909945338,13.64583743,-3.735892092,0.0393251799,-5.544850368,-5.505525188
2016,West Virginia,Ohio County,42516,-377,450,595,-145,28,-224,-196,-36,2380,10.537531174,13.932957885,-3.395426711,0.6556686064,-5.245348851,-4.589680244
2016,West Virginia,Pendleton County,7051,-135,59,68,-9,0,-121,-121,-5,117,8.2882629768,9.5525742783,-1.264311302,0.0,-16.99796305,-16.99796305
2016,West Virginia,Pleasants County,7591,-18,60,76,-16,0,-10,-10,8,670,7.8947368421,10.0,-2.105263158,0.0,-1.315789474,-1.315789474
2016,West Virginia,Pocahontas County,8501,-60,77,115,-38,0,-16,-16,-6,318,9.025905521,13.480248505,-4.454342984,0.0,-1.875512836,-1.875512836
2016,West Virginia,Preston County,33758,14,354,359,-5,2,45,47,-28,2187,10.488578116,10.636721875,-0.148143759,0.0592575035,1.3332938283,1.3925513318
2016,West Virginia,Putnam County,56941,142,619,585,34,26,110,136,-28,249,10.88447336,10.286618604,0.5978547565,0.4571830491,1.9342359768,2.3914190258
2016,West Virginia,Raleigh County,76601,-832,836,1068,-232,59,-623,-564,-36,3823,10.854746355,13.86706831,-3.012321955,0.7660646351,-8.089123181,-7.323058546
2016,West Virginia,Randolph County,29006,-168,320,372,-52,2,-95,-93,-23,2298,11.000343761,12.787899622,-1.787555861,0.0687521485,-3.265727054,-3.196974905
2016,West Virginia,Ritchie County,9875,-116,106,147,-41,-1,-81,-82,7,106,10.671499044,14.799154334,-4.12765529,-0.100674519,-8.154636062,-8.255310581
2016,West Virginia,Roane County,14208,-222,142,183,-41,2,-180,-178,-3,98,9.9168936378,12.780222083,-2.863328445,0.1396745583,-12.57071025,-12.43103569
2016,West Virginia,Summers County,12872,-201,92,153,-61,1,-143,-142,2,1095,7.0919252264,11.794179996,-4.70225477,0.0770861438,-11.02331856,-10.94623241
2016,West Virginia,Taylor County,16859,-5,146,194,-48,0,42,42,1,509,8.658778875,11.505500697,-2.846721822,0.0,2.4908815942,2.4908815942
2016,West Virginia,Tucker County,6926,-7,68,112,-44,0,22,22,15,131,9.8131178296,16.162782308,-6.349664478,0.0,3.174832239,3.174832239
2016,West Virginia,Tyler County,8972,19,87,111,-24,0,45,45,-2,67,9.7071129707,12.384937238,-2.677824268,0.0,5.0209205021,5.0209205021
2016,West Virginia,Upshur County,24658,-68,278,274,4,-4,-48,-52,-20,1224,11.258707274,11.096711486,0.1619957881,-0.161995788,-1.943949457,-2.105945245
2016,West Virginia,Wayne County,40531,-443,406,515,-109,10,-341,-331,-3,246,9.9625789829,12.637261518,-2.674682535,0.2453837188,-8.367584811,-8.122201092
2016,West Virginia,Webster County,8646,-86,86,124,-38,2,-52,-50,2,58,9.8975716423,14.270917252,-4.373345609,0.2301760847,-5.984578202,-5.754402118
2016,West Virginia,Wetzel County,15640,-173,175,239,-64,0,-104,-104,-5,124,11.127714367,15.197278479,-4.069564112,0.0,-6.613041681,-6.613041681
2016,West Virginia,Wirt County,5806,-34,60,48,12,0,-42,-42,-4,0,10.303967027,8.2431736218,2.0607934055,0.0,-7.212776919,-7.212776919
2016,West Virginia,Wood County,85643,-611,990,1061,-71,8,-498,-490,-50,996,11.518525629,12.344601709,-0.82607608,0.093078995,-5.794167437,-5.701088442
2016,West Virginia,Wyoming County,21763,-389,222,359,-137,0,-236,-236,-16,56,10.110440624,16.349766595,-6.239325971,0.0,-10.74803598,-10.74803598
2016,Wisconsin,Wisconsin,5778708,10817,66079,49823,16256,7990,-12395,-4405,-1034,146260,11.445621347,8.6299004581,2.8157208889,1.3839573021,-2.146952536,-0.762995233
2016,Wisconsin,Adams County,20069,-92,128,251,-123,6,-2,4,27,1159,6.3634103903,12.478250062,-6.114839672,0.298284862,-0.099428287,0.1988565747
2016,Wisconsin,Ashland County,15714,-169,175,175,0,9,-173,-164,-5,569,11.077000981,11.077000981,0.0,0.5696743362,-10.95040668,-10.38073235
2016,Wisconsin,Barron County,45412,-62,478,464,14,41,-80,-39,-37,612,10.518671743,10.210593491,0.3080782519,0.9022291662,-1.760447154,-0.858217987
2016,Wisconsin,Bayfield County,14891,-45,114,180,-66,6,23,29,-8,110,7.6440808663,12.069601368,-4.425520502,0.4023200456,1.5422268415,1.944546887
2016,Wisconsin,Brown County,260401,1881,3345,1843,1502,501,-61,440,-61,6526,12.892135797,7.1032006799,5.7889351173,1.9309297562,-0.235103224,1.6958265324
2016,Wisconsin,Buffalo County,13099,-121,142,123,19,8,-150,-142,2,92,10.790683537,9.3468596831,1.4438238535,0.607925833,-11.39860937,-10.79068354
2016,Wisconsin,Burnett County,15213,71,132,167,-35,0,102,102,4,134,8.6970845001,11.003129633,-2.306045133,0.0,6.7204743864,6.7204743864
2016,Wisconsin,Calumet County,49553,-239,527,347,180,24,-463,-439,20,179,10.609492174,6.9857567064,3.6237354673,0.483164729,-9.321052896,-8.837888167
2016,Wisconsin,Chippewa County,63649,114,704,597,107,8,46,54,-47,2646,11.070574915,9.38797333,1.6826015851,0.1258019877,0.7233614291,0.8491634168
2016,Wisconsin,Clark County,34557,116,553,331,222,21,-109,-88,-18,516,16.029450129,9.5944809994,6.4349691295,0.608713296,-3.15951187,-2.550798574
2016,Wisconsin,Columbia County,56927,173,607,528,79,20,70,90,4,1419,10.679005287,9.2891512214,1.3898540653,0.3518617887,1.2315162604,1.5833780491
2016,Wisconsin,Crawford County,16321,-73,164,168,-4,3,-57,-54,-15,770,10.025981965,10.270518111,-0.244536145,0.1834021091,-3.484640073,-3.301237964
2016,Wisconsin,Dane County,531273,8395,6246,3177,3069,1843,3426,5269,57,12739,11.850294692,6.0275994616,5.8226952306,3.4966527566,6.5000175497,9.9966703062
2016,Wisconsin,Dodge County,88068,-366,805,905,-100,43,-314,-271,5,6302,9.121709669,10.254841305,-1.133131636,0.4872466034,-3.558033337,-3.070786733
2016,Wisconsin,Door County,27587,47,204,356,-152,3,176,179,20,335,7.4010920239,12.915631179,-5.514539155,0.1088395886,6.3852558637,6.4940954523
2016,Wisconsin,Douglas County,43509,-114,411,399,12,41,-145,-104,-22,1379,9.4339622642,9.1585181105,0.2754441537,0.9411008585,-3.328283524,-2.387182665
2016,Wisconsin,Dunn County,44704,152,444,325,119,49,-22,27,6,3253,9.9489109976,7.2824235906,2.666487407,1.0979654029,-0.492964058,0.6050013444
2016,Wisconsin,Eau Claire County,102965,846,1211,811,400,143,341,484,-38,4921,11.809795011,7.9089543797,3.9008406312,1.3945505256,3.3254666381,4.7200171637
2016,Wisconsin,Florence County,4456,-11,29,55,-26,0,16,16,-1,53,6.500056035,12.32769248,-5.827636445,0.0,3.5862378124,3.5862378124
2016,Wisconsin,Fond du Lac County,102144,201,1050,880,170,158,-75,83,-52,3532,10.28972938,8.6237731948,1.6659561854,1.5483592782,-0.73498067,0.8133786081
2016,Wisconsin,Forest County,9064,21,110,114,-4,1,32,33,-8,361,12.149997239,12.59181532,-0.441818081,0.1104545204,3.5345446512,3.6449991716
2016,Wisconsin,Grant County,52214,-89,563,496,67,35,-158,-123,-33,4881,10.773367012,9.4912789307,1.2820880814,0.6697475052,-3.023431595,-2.35368409
2016,Wisconsin,Green County,37075,-78,387,357,30,61,-142,-81,-27,344,10.427332004,9.6190116937,0.8083203104,1.6435846311,-3.826049469,-2.182464838
2016,Wisconsin,Green Lake County,18719,-110,189,221,-32,-1,-59,-60,-18,157,10.067114094,11.77159902,-1.704484926,-0.053265154,-3.142644082,-3.195909236
2016,Wisconsin,Iowa County,23654,-175,246,211,35,11,-224,-213,3,188,10.3616031,8.8873912769,1.4742118232,0.4633237159,-9.434955668,-8.971631952
2016,Wisconsin,Iron County,5726,-60,32,92,-60,0,-6,-6,6,82,5.5594162613,15.983321751,-10.42390549,0.0,-1.042390549,-1.042390549
2016,Wisconsin,Jackson County,20562,-27,268,189,79,3,-95,-92,-14,1320,13.025199874,9.1856820004,3.8395178732,0.1458044762,-4.617141746,-4.47133727
2016,Wisconsin,Jefferson County,84625,-15,839,670,169,72,-232,-160,-24,3246,9.913449325,7.9165805099,1.9968688152,0.85073701,-2.741263699,-1.890526689
2016,Wisconsin,Juneau County,26274,70,270,271,-1,5,84,89,-18,1689,10.290026297,10.328137505,-0.038111209,0.1905560425,3.2013415145,3.3918975571
2016,Wisconsin,Kenosha County,168183,15,1910,1342,568,135,-659,-524,-29,4361,11.357183419,7.9797592396,3.3774241789,0.8027328594,-3.918525588,-3.115792728
2016,Wisconsin,Kewaunee County,20405,24,188,183,5,12,18,30,-11,177,9.2188496053,8.9736674349,0.2451821704,0.5884372088,0.8826558133,1.4710930221
2016,Wisconsin,La Crosse County,118122,62,1254,960,294,81,-234,-153,-79,5748,10.61892947,8.1293239959,2.4896054737,0.6859117122,-1.981522724,-1.295611012
2016,Wisconsin,Lafayette County,16753,-59,225,128,97,0,-164,-164,8,95,13.406822583,7.6269924028,5.7798301802,0.0,-9.772084016,-9.772084016
2016,Wisconsin,Langlade County,19221,32,179,232,-53,7,92,99,-14,257,9.3204894559,12.080187451,-2.759697995,0.3644884145,4.7904191617,5.1549075762
2016,Wisconsin,Lincoln County,27902,-64,252,313,-61,1,16,17,-20,656,9.021264409,11.204983175,-2.183718766,0.0357986683,0.5727786926,0.6085773609
2016,Wisconsin,Manitowoc County,79536,-181,784,859,-75,55,-94,-39,-67,1038,9.8459683648,10.787865849,-0.941897484,0.6907248215,-1.180511513,-0.489786692
2016,Wisconsin,Marathon County,135603,-179,1582,1141,441,92,-629,-537,-83,1591,11.658713636,8.4087182416,3.249995394,0.6780035743,-4.635480959,-3.957477385
2016,Wisconsin,Marinette County,40491,-363,359,494,-135,9,-205,-196,-32,615,8.8266027414,12.145798758,-3.319196017,0.2212797345,-5.040260618,-4.818980884
2016,Wisconsin,Marquette County,15067,11,148,179,-31,3,24,27,15,134,9.8263785148,11.884606447,-2.058227932,0.1991833483,1.5934667862,1.7926501344
2016,Wisconsin,Menominee County,4533,19,89,60,29,8,-23,-15,5,57,19.675030397,13.264065436,6.4109649608,1.7685420581,-5.084558417,-3.316016359
2016,Wisconsin,Milwaukee County,951448,-4866,13675,8176,5499,2505,-13186,-10681,316,23538,14.336169816,8.5712997743,5.7648700414,2.6261137396,-13.82352725,-11.19741351
2016,Wisconsin,Monroe County,45623,104,604,415,189,22,-125,-103,18,818,13.254043141,9.1066687148,4.1473744267,0.4827631608,-2.742972504,-2.260209344
2016,Wisconsin,Oconto County,37430,-82,359,359,0,20,-123,-103,21,272,9.5807424408,9.5807424408,0.0,0.533746097,-3.282538496,-2.748792399
2016,Wisconsin,Oneida County,35601,61,286,472,-186,17,258,275,-28,510,8.0403705318,13.269422696,-5.229052164,0.4779241225,7.2532013888,7.7311255113
2016,Wisconsin,Outagamie County,184526,1262,2295,1358,937,190,197,387,-62,3025,12.479947796,7.3846488485,5.0952989478,1.0331982925,1.0712634928,2.1044617853
2016,Wisconsin,Ozaukee County,88314,405,826,799,27,94,269,363,15,2019,9.3744857368,9.0680558156,0.3064299212,1.066830096,3.0529499555,4.1197800514
2016,Wisconsin,Pepin County,7307,14,77,79,-2,5,14,19,-3,125,10.547945205,10.821917808,-0.273972603,0.6849315068,1.9178082192,2.602739726
2016,Wisconsin,Pierce County,41238,354,372,272,100,7,255,262,-8,2457,9.0596916782,6.6242906895,2.4354009888,0.1704780692,6.2102725214,6.3807505906
2016,Wisconsin,Polk County,43481,44,414,441,-27,23,77,100,-29,433,9.5262201155,10.14749534,-0.621275225,0.5292344509,1.7717849007,2.3010193516
2016,Wisconsin,Portage County,70447,-87,674,507,167,101,-307,-206,-48,3505,9.5615721267,7.1924585582,2.3691135685,1.4328171881,-4.3551968,-2.922379611
2016,Wisconsin,Price County,13517,-142,114,165,-51,10,-93,-83,-8,165,8.3897556668,12.143067412,-3.753311746,0.7359434795,-6.84427436,-6.10833088
2016,Wisconsin,Racine County,195140,223,2353,1676,677,152,-479,-327,-127,4792,12.064903335,8.5936158049,3.4712875298,0.7793732711,-2.456051295,-1.676678024
2016,Wisconsin,Richland County,17476,-8,171,183,-12,9,-23,-14,18,346,9.7826086957,10.469107551,-0.686498856,0.5148741419,-1.315789474,-0.800915332
2016,Wisconsin,Rock County,161620,286,1923,1440,483,107,-199,-92,-105,2665,11.908816736,8.9176786787,2.9911380568,0.6626330685,-1.232373651,-0.569740582
2016,Wisconsin,Rusk County,14127,-10,139,170,-31,19,10,29,-8,157,9.8358335692,12.029436739,-2.19360317,1.3444664591,0.7076139258,2.0520803849
2016,Wisconsin,St. Croix County,88029,527,1043,591,452,47,32,79,-4,811,11.883940728,6.7338532795,5.1500874489,0.5355179427,0.364607961,0.9001259037
2016,Wisconsin,Sauk County,63949,303,760,624,136,74,138,212,-45,733,11.912692504,9.7809475293,2.1317449743,1.1599200596,2.1630941651,3.3230142247
2016,Wisconsin,Sawyer County,16369,18,155,200,-45,2,68,70,-7,314,9.4743276284,12.224938875,-2.750611247,0.1222493888,4.1564792176,4.2787286064
2016,Wisconsin,Shawano County,41062,-144,396,402,-6,10,-158,-148,10,732,9.6270724948,9.7729372295,-0.145864735,0.2431078913,-3.841104682,-3.597996791
2016,Wisconsin,Sheboygan County,115427,-164,1226,1086,140,131,-389,-258,-46,2818,10.613891558,9.4018647898,1.2120267685,1.1341107619,-3.36770295,-2.233592188
2016,Wisconsin,Taylor County,20439,-44,233,196,37,9,-74,-65,-16,219,11.387517717,9.5791994526,1.808318264,0.4398611994,-3.616636528,-3.176775329
2016,Wisconsin,Trempealeau County,29633,81,411,269,142,35,-96,-61,0,466,13.88865422,9.090141083,4.7985131368,1.1827321112,-3.244065219,-2.061333108
2016,Wisconsin,Vernon County,30814,291,429,318,111,7,169,176,4,358,13.988294178,10.368945335,3.6193488433,0.2282472244,5.5105401308,5.7387873551
2016,Wisconsin,Vilas County,21435,44,174,289,-115,17,160,177,-18,190,8.1259048242,13.496474105,-5.37056928,0.7939102414,7.47209639,8.2660066315
2016,Wisconsin,Walworth County,102959,234,1047,910,137,57,-4,53,44,2683,10.180665487,8.8485249217,1.3321405651,0.5542482643,-0.038894615,0.5153536493
2016,Wisconsin,Washburn County,15648,92,127,200,-73,7,170,177,-12,205,8.1399820536,12.818869376,-4.678887322,0.4486604282,10.896038969,11.344699398
2016,Wisconsin,Washington County,134296,481,1337,1100,237,86,148,234,10,1073,9.9734811328,8.2055566538,1.767924479,0.6415253384,1.1040203498,1.7455456882
2016,Wisconsin,Waukesha County,398424,2113,3751,3351,400,535,1365,1900,-187,5308,9.4396245289,8.4329996791,1.0066248498,1.3463607366,3.4351072999,4.7814680365
2016,Wisconsin,Waupaca County,51533,-392,515,731,-216,18,-160,-142,-34,1545,9.955730828,14.131338321,-4.175607493,0.3479672911,-3.093042587,-2.745075296
2016,Wisconsin,Waushara County,24162,121,232,252,-20,9,109,118,23,1222,9.6259568906,10.455780761,-0.82982387,0.3734207414,4.5225400909,4.8959608323
2016,Wisconsin,Winnebago County,169886,321,1833,1449,384,134,-131,3,-66,7714,10.799791428,8.537314664,2.262476764,0.7895101208,-0.771834521,0.0176755997
2016,Wisconsin,Wood County,73107,-181,785,749,36,14,-178,-164,-53,799,10.724409987,10.232589911,0.4918200758,0.1912633628,-2.431777042,-2.240513679
2016,Wyoming,Wyoming,585501,-1054,7590,4838,2752,524,-4347,-3823,17,14290,12.951599582,8.2555782318,4.6960213505,0.8941552281,-7.417734306,-6.523579078
2016,Wyoming,Albany County,38256,177,437,183,254,164,-254,-90,13,2289,11.44953167,4.7946551385,6.6548765311,4.2968494138,-6.654876531,-2.358027117
2016,Wyoming,Big Horn County,12005,14,149,121,28,5,-11,-6,-8,183,12.418736456,10.085014169,2.333722287,0.4167361227,-0.91681947,-0.500083347
2016,Wyoming,Campbell County,48803,-530,767,333,434,24,-1020,-996,32,422,15.631368713,6.7865003668,8.844868346,0.4891171436,-20.7874786,-20.29836146
2016,Wyoming,Carbon County,15618,64,200,138,62,7,2,9,-7,809,12.832028744,8.8540998332,3.9779289106,0.449121006,0.1283202874,0.5774412935
2016,Wyoming,Converse County,14191,-130,210,112,98,26,-250,-224,-4,103,14.730639731,7.8563411897,6.874298541,1.8237934905,-17.53647587,-15.71268238
2016,Wyoming,Crook County,7464,50,98,66,32,0,14,14,4,34,13.173813685,8.8721602366,4.301653448,0.0,1.8819733835,1.8819733835
2016,Wyoming,Fremont County,40242,-113,562,481,81,13,-189,-176,-18,888,13.945928509,11.935928136,2.0100003722,0.3225926523,-4.690000869,-4.367408216
2016,Wyoming,Goshen County,13390,-202,147,138,9,17,-220,-203,-8,1219,10.896152991,10.229041583,0.6671114076,1.2600993255,-16.30716774,-15.04706842
2016,Wyoming,Hot Springs County,4679,-66,49,69,-20,0,-47,-47,1,86,10.398981324,14.643463497,-4.244482173,0.0,-9.974533107,-9.974533107
2016,Wyoming,Johnson County,8486,-101,84,76,8,5,-113,-108,-1,71,9.840098401,8.9029461723,0.9371522287,0.5857201429,-13.23727523,-12.65155509
2016,Wyoming,Laramie County,98136,953,1252,850,402,88,458,546,5,1945,12.820053349,8.7037103405,4.1163430081,0.9010900117,4.6897639247,5.5908539364
2016,Wyoming,Lincoln County,19110,353,241,121,120,10,234,244,-11,71,12.72876119,6.3907888135,6.337972377,0.5281643648,12.359046135,12.8872105
2016,Wyoming,Natrona County,81039,-1152,1216,729,487,40,-1652,-1612,-27,1767,14.899221957,8.9321815843,5.9670403725,0.4901059854,-20.2413772,-19.75127121
2016,Wyoming,Niobrara County,2480,-17,25,21,4,0,-31,-31,10,250,10.046212578,8.4388185654,1.6073940125,0.0,-12.4573036,-12.4573036
2016,Wyoming,Park County,29353,297,317,260,57,44,220,264,-24,793,10.854491602,8.9027375918,1.9517540105,1.5066171309,7.5330856546,9.0397027855
2016,Wyoming,Platte County,8680,-125,86,82,4,1,-135,-134,5,102,9.8370031456,9.3794681155,0.45753503,0.1143837575,-15.44180726,-15.32742351
2016,Wyoming,Sheridan County,30200,131,315,334,-19,34,109,143,7,1036,10.453135111,11.083641673,-0.630506562,1.1282749009,3.6171165939,4.7453914948
2016,Wyoming,Sublette County,9769,-108,118,58,60,2,-182,-180,12,550,12.012623435,5.9045098239,6.1081136109,0.203603787,-18.52794462,-18.32434083
2016,Wyoming,Sweetwater County,44165,-528,604,275,329,10,-889,-879,22,684,13.594724167,6.1896509037,7.405073263,0.2250782147,-20.00945329,-19.78437507
2016,Wyoming,Teton County,23191,118,239,87,152,48,-109,-61,27,267,10.332007609,3.7610236901,6.5709839184,2.0750475532,-4.712087152,-2.637039599
2016,Wyoming,Uinta County,20773,-46,309,134,175,-14,-203,-217,-4,254,14.858626659,6.4435468359,8.415079823,-0.673206386,-9.761492595,-10.43469898
2016,Wyoming,Washakie County,8235,-99,98,93,5,-4,-95,-99,-5,140,11.829319814,11.225783089,0.6035367252,-0.48282938,-11.46719778,-11.95002716
2016,Wyoming,Weston County,7236,6,67,77,-10,4,16,20,-4,327,9.263099682,10.645651873,-1.382552191,0.5530208765,2.2120835062,2.7651043827
2020,Alabama,Alabama,4921532,13567,56739,58354,-1615,2078,13115,15193,-11,116767,11.544639568,11.873242344,-0.328602776,0.4228090206,2.6684987034,3.0913077241
2020,Alabama,Autauga County,56145,376,606,582,24,-8,360,352,0,455,10.829744268,10.400843505,0.4289007631,-0.142966921,6.4335114463,6.2905445253
2020,Alabama,Baldwin County,229287,5722,2317,2543,-226,60,5918,5978,-30,2268,10.232923781,11.231042371,-0.998118591,0.2649872364,26.136574422,26.401561658
2020,Alabama,Barbour County,24589,-68,250,334,-84,6,10,16,0,2777,10.153108882,13.564553466,-3.411444584,0.2436746132,0.4061243553,0.6497989684
2020,Alabama,Bibb County,22136,-177,249,266,-17,6,-166,-160,0,2121,11.203851605,11.968773201,-0.764921596,0.2699723278,-7.469234403,-7.199262076
2020,Alabama,Blount County,57879,39,665,697,-32,1,68,69,2,489,11.493358913,12.0464228,-0.553063888,0.0172832465,1.175260761,1.1925440075
2020,Alabama,Bullock County,9976,-168,114,116,-2,5,-170,-165,-1,1704,11.332007952,11.530815109,-0.198807157,0.4970178926,-16.89860835,-16.40159046
2020,Alabama,Butler County,19504,3,200,266,-66,16,52,68,1,333,10.255095501,13.639277016,-3.384181515,0.82040764,2.6663248301,3.4867324702
2020,Alabama,Calhoun County,113469,-601,1230,1553,-323,10,-289,-279,1,3285,10.811333442,13.650407183,-2.839073741,0.0878970199,-2.540223874,-2.452326854
2020,Alabama,Chambers County,32865,-379,334,519,-185,13,-208,-195,1,458,10.104524346,15.701341724,-5.596817377,0.3932898698,-6.292637916,-5.899348046
2020,Alabama,Cherokee County,26294,40,236,406,-170,2,208,210,0,290,8.982263835,15.452538631,-6.470274796,0.07612088,7.9165715156,7.9926923955
2020,Alabama,Chilton County,44397,84,533,554,-21,6,95,101,4,393,12.016683576,12.4901364,-0.473452824,0.1352722354,2.1418103934,2.2770826288
2020,Alabama,Choctaw County,12418,-159,136,183,-47,-5,-107,-112,0,129,10.882176435,14.642928586,-3.76075215,-0.400080016,-8.561712342,-8.961792358
2020,Alabama,Clarke County,23291,-360,265,348,-83,-1,-275,-276,-1,280,11.290528738,14.82680755,-3.536278812,-0.042605769,-11.71658643,-11.75919219
2020,Alabama,Clay County,13112,-153,158,224,-66,-1,-87,-88,1,255,11.980134208,16.984494067,-5.004359859,-0.075823634,-6.596656178,-6.672479812
2020,Alabama,Cleburne County,14967,15,177,216,-39,-2,56,54,0,178,11.831946255,14.43898526,-2.607039005,-0.133694308,3.743440623,3.6097463151
2020,Alabama,Coffee County,53230,591,568,590,-22,51,562,613,0,600,10.730242092,11.14585006,-0.415607968,0.9634548357,10.616894464,11.5803493
2020,Alabama,Colbert County,55411,170,631,724,-93,33,230,263,0,474,11.405125981,13.086071648,-1.680945667,0.5964645917,4.1571774573,4.7536420489
2020,Alabama,Conecuh County,11851,-204,119,199,-80,0,-124,-124,0,45,9.955659667,16.648540115,-6.692880448,0.0,-10.3739647,-10.3739647
2020,Alabama,Coosa County,10650,-27,79,143,-64,8,28,36,1,259,7.4084493834,13.410231162,-6.001781779,0.7502227224,2.6257795283,3.3760022507
2020,Alabama,Covington County,36930,-152,395,555,-160,-1,8,7,1,575,10.673944766,14.997567962,-4.323623196,-0.027022645,0.2161811598,0.1891585148
2020,Alabama,Crenshaw County,13681,-130,135,201,-66,4,-66,-62,-2,132,9.8210388477,14.622435618,-4.80139677,0.2909937436,-4.80139677,-4.510403026
2020,Alabama,Cullman County,84515,871,948,1115,-167,3,1037,1040,-2,1040,11.275043263,13.26125869,-1.986215427,0.0356805167,12.333565257,12.369245773
2020,Alabama,Dale County,48959,-335,642,622,20,11,-364,-353,-2,927,13.068303258,12.661191007,0.407112251,0.2239117381,-7.409442969,-7.185531231
2020,Alabama,Dallas County,36098,-1084,398,573,-175,7,-910,-903,-6,853,10.862445415,15.638646288,-4.776200873,0.1910480349,-24.83624454,-24.64519651
2020,Alabama,DeKalb County,71658,152,816,893,-77,39,189,228,1,781,11.399513844,12.475203263,-1.075689419,0.5448297058,2.6403285742,3.18515828
2020,Alabama,Elmore County,82158,583,902,876,26,17,537,554,3,4172,11.01793774,10.700347517,0.3175902231,0.2076551459,6.559459608,6.7671147539
2020,Alabama,Escambia County,36281,-288,434,503,-69,1,-220,-219,0,2392,11.914893617,13.80919698,-1.894303363,0.0274536719,-6.039807824,-6.012354152
2020,Alabama,Etowah County,102371,-89,1173,1609,-436,29,317,346,1,2085,11.453344464,15.710512569,-4.257168104,0.2831602638,3.095234608,3.3783948719
2020,Alabama,Fayette County,16241,-38,160,247,-87,3,47,50,-1,291,9.840098401,15.190651907,-5.350553506,0.184501845,2.8905289053,3.0750307503
2020,Alabama,Franklin County,31507,-80,428,416,12,52,-144,-92,0,272,13.567058674,13.186673852,0.3803848226,1.6483342315,-4.564617872,-2.91628364
2020,Alabama,Geneva County,26411,102,264,379,-115,-3,219,216,1,229,10.015174507,14.37784522,-4.362670713,-0.113808801,8.3080424886,8.1942336874
2020,Alabama,Greene County,7990,-114,83,91,-8,0,-104,-104,-2,45,10.314402883,11.308562197,-0.994159314,0.0,-12.92407108,-12.92407108
2020,Alabama,Hale County,14670,1,178,203,-25,2,25,27,-1,221,12.134019564,13.838235795,-1.704216231,0.1363372985,1.704216231,1.8405535294
2020,Alabama,Henry County,17223,98,149,229,-80,-2,182,180,-2,199,8.6759054385,13.334109701,-4.658204262,-0.116455107,10.597414697,10.48095959
2020,Alabama,Houston County,106580,340,1376,1253,123,14,198,212,5,1418,12.931115497,11.775209097,1.1559063998,0.1315665821,1.8607273752,1.9922939573
2020,Alabama,Jackson County,51582,-90,559,736,-177,-7,91,84,3,597,10.827667693,14.256106301,-3.428438608,-0.135587968,1.762643578,1.6270556104
2020,Alabama,Jefferson County,655342,-3197,8257,7768,489,252,-3949,-3697,11,16627,12.568870392,11.824510743,0.744359649,0.3835963835,-6.011198883,-5.6276025
2020,Alabama,Lamar County,13764,-53,175,223,-48,0,-5,-5,0,217,12.689895218,16.170552192,-3.480656974,0.0,-0.362568435,-0.362568435
2020,Alabama,Lauderdale County,93368,340,916,1217,-301,32,608,640,1,2411,9.8285370931,13.058220133,-3.22968304,0.3433550076,6.5237451447,6.8671001524
2020,Alabama,Lawrence County,32857,6,332,476,-144,-3,153,150,0,229,10.105314421,14.488342363,-4.383027942,-0.091313082,4.6569671882,4.565654106
2020,Alabama,Lee County,166831,1816,1754,1272,482,242,1082,1324,10,4960,10.571168554,7.6662066139,2.9049619402,1.4585078621,6.5210971354,7.9796049975
2020,Alabama,Limestone County,102228,3092,1037,931,106,24,2978,3002,-16,2734,10.299755666,9.2469358972,1.0528197692,0.2383742874,29.578276157,29.816650444
2020,Alabama,Lowndes County,9641,-85,110,161,-51,0,-34,-34,0,96,11.359529096,16.626219859,-5.266690763,0.0,-3.511127175,-3.511127175
2020,Alabama,Macon County,17895,-170,170,283,-113,1,-59,-58,1,1582,9.4549499444,15.73971079,-6.284760845,0.0556173526,-3.281423804,-3.225806452
2020,Alabama,Madison County,379453,6906,4315,3585,730,214,5986,6200,-24,8186,11.47606383,9.5345744681,1.9414893617,0.5691489362,15.920212766,16.489361702
2020,Alabama,Marengo County,18733,-186,190,259,-69,6,-122,-116,-1,254,10.092425369,13.757569319,-3.66514395,0.3187081696,-6.480399448,-6.161691278
2020,Alabama,Marion County,29703,-123,312,448,-136,8,4,12,1,813,10.482285945,15.05148751,-4.569201566,0.2687765627,0.1343882813,0.403164844
2020,Alabama,Marshall County,96990,239,1371,1263,108,32,94,126,5,1044,14.15291549,13.038024992,1.1148904981,0.3303379254,0.9703676558,1.3007055812
2020,Alabama,Mobile County,412716,-800,5393,5011,382,229,-1425,-1196,14,7386,13.054444756,12.129765005,0.924679751,0.5543237251,-3.449394359,-2.895070634
2020,Alabama,Monroe County,20459,-230,182,286,-104,0,-125,-125,-1,230,8.8461164577,13.901040148,-5.05492369,0.0,-6.075629435,-6.075629435
2020,Alabama,Montgomery County,224639,-1435,3064,2419,645,230,-2308,-2078,-2,8755,13.596235298,10.73410352,2.8621317779,1.0206051301,-10.24155061,-9.22094548
2020,Alabama,Morgan County,119883,253,1416,1383,33,25,191,216,4,2007,11.823992852,11.548433697,0.2755591555,0.2087569359,1.5949029907,1.8036599266
2020,Alabama,Perry County,8687,-253,88,138,-50,0,-201,-201,-2,723,9.9846825892,15.657797697,-5.673115108,0.0,-22.80592273,-22.80592273
2020,Alabama,Pickens County,19793,-147,207,283,-76,3,-75,-72,1,1875,10.4195505,14.245085949,-3.825535449,0.1510079783,-3.775199456,-3.624191478
2020,Alabama,Pike County,32966,-68,353,376,-23,76,-123,-47,2,1912,10.696969697,11.393939394,-0.696969697,2.303030303,-3.727272727,-1.424242424
2020,Alabama,Randolph County,22920,139,243,306,-63,0,203,203,-1,390,10.634340605,13.391391873,-2.757051268,0.0,8.8838318636,8.8838318636
2020,Alabama,Russell County,58237,139,747,701,46,-11,101,90,3,574,12.842222891,12.051403275,0.7908196158,-0.189109039,1.7363648085,1.54725577
2020,Alabama,St. Clair County,90739,1004,946,1046,-100,39,1066,1105,-1,1515,10.483504549,11.591697419,-1.10819287,0.4321952193,11.813335993,12.245531212
2020,Alabama,Shelby County,221428,3252,2223,1868,355,117,2789,2906,-9,2541,10.113647738,8.4985577929,1.6150899446,0.5322972493,12.688692551,13.2209898
2020,Alabama,Sumter County,12225,-133,137,160,-23,23,-133,-110,0,784,11.145913843,13.017125656,-1.871211813,1.871211813,-10.8204857,-8.949273888
2020,Alabama,Talladega County,79985,-241,845,1155,-310,23,42,65,4,3251,10.548589048,14.418485622,-3.869896574,0.2871213587,0.5243085681,0.8114299268
2020,Alabama,Tallapoosa County,40133,-204,375,585,-210,-8,13,5,1,576,9.320243569,14.539579968,-5.219336399,-0.198831863,0.3231017771,0.1242699143
2020,Alabama,Tuscaloosa County,210758,437,2362,2063,299,144,-23,121,17,10665,11.218797423,9.7986363604,1.4201610624,0.6839571672,-0.109243159,0.5747140085
2020,Alabama,Walker County,63143,-537,767,988,-221,4,-320,-316,0,852,12.095597802,15.58077005,-3.485172248,0.0630800407,-5.046403255,-4.983323214
2020,Alabama,Washington County,15976,-303,181,231,-50,3,-253,-250,-3,147,11.223066191,14.323360719,-3.100294528,0.1860176717,-15.68749031,-15.50147264
2020,Alabama,Wilcox County,10206,-190,123,143,-20,5,-174,-169,-1,108,11.940588292,13.882147364,-1.941559072,0.485389768,-16.89156393,-16.40617416
2020,Alabama,Winston County,23508,-192,241,362,-121,-1,-69,-70,-1,301,10.210133876,15.336383664,-5.126249788,-0.042365701,-2.92323335,-2.965599051
2020,Alaska,Alaska,731158,-2445,9733,5249,4484,1078,-7980,-6902,-27,27015,13.289540068,7.1670395375,6.1225005308,1.4719124827,-10.89597552,-9.424063038
2020,Alaska,Aleutians East Borough,3401,46,4,7,-3,49,-2,47,2,1745,1.1841326229,2.07223209,-0.888099467,14.50562463,-0.592066311,13.913558319
2020,Alaska,Aleutians West Census Area,5680,-22,33,7,26,68,-115,-47,-1,2542,5.7986294149,1.2300123001,4.5686171147,11.948690915,-20.20734493,-8.258654015
2020,Alaska,Anchorage Municipality,287095,-1695,3861,2047,1814,490,-3994,-3504,-5,8022,13.40892713,7.1090582321,6.2998688974,1.7017286437,-13.8708249,-12.16909626
2020,Alaska,Bethel Census Area,18437,-56,426,165,261,8,-325,-317,0,360,23.070674249,8.9358245329,14.134849716,0.4332520986,-17.6008665,-17.16761441
2020,Alaska,Bristol Bay Borough,788,-52,8,6,2,0,-55,-55,1,15,9.828009828,7.371007371,2.457002457,0.0,-67.56756757,-67.56756757
2020,Alaska,Chugach Census Area,6427,-82,73,34,39,5,-126,-121,0,183,11.286332715,5.2566481138,6.0296846011,0.7730364873,-19.48051948,-18.70748299
2020,Alaska,Copper River Census Area,2919,33,32,2,30,3,-1,2,1,18,11.024978467,0.6890611542,10.335917313,1.0335917313,-0.344530577,0.6890611542
2020,Alaska,Denali Borough,2081,-44,14,0,14,14,-72,-58,0,101,6.6571564432,0.0,6.6571564432,6.6571564432,-34.23680456,-27.57964812
2020,Alaska,Dillingham Census Area,4833,-99,81,54,27,1,-126,-125,-1,52,16.589861751,11.059907834,5.5299539171,0.204813108,-25.80645161,-25.6016385
2020,Alaska,Fairbanks North Star Borough,95651,-1437,1408,540,868,88,-2380,-2292,-13,4821,14.610431724,5.6034326213,9.0069991024,0.9131519827,-24.69661044,-23.78345846
2020,Alaska,Haines Borough,2614,53,19,5,14,1,39,40,-1,0,7.3429951691,1.9323671498,5.4106280193,0.38647343,15.072463768,15.458937198
2020,Alaska,Hoonah-Angoon Census Area,2141,-3,19,23,-4,7,-6,1,0,0,8.8681446908,10.73512252,-1.86697783,3.2672112019,-2.800466744,0.4667444574
2020,Alaska,Juneau City and Borough,31849,-189,315,200,115,35,-339,-304,0,995,9.8611611126,6.2610546747,3.6001064379,1.0956845681,-10.61248767,-9.516803105
2020,Alaska,Kenai Peninsula Borough,59414,500,680,550,130,35,335,370,0,1704,11.493475762,9.2961936313,2.197282131,0.5915759584,5.66222703,6.2538029883
2020,Alaska,Ketchikan Gateway Borough,13747,-158,135,101,34,26,-217,-191,-1,264,9.7642123535,7.3050773904,2.4591349631,1.8805149718,-15.69506726,-13.81455229
2020,Alaska,Kodiak Island Borough,12992,-217,145,64,81,83,-379,-296,-2,388,11.068279837,4.885309721,6.1829701156,6.3356360444,-28.9301935,-22.59455746
2020,Alaska,Kusilvak Census Area,8328,-56,234,109,125,10,-189,-179,-2,9,28.003829584,13.044518909,14.959310675,1.196744854,-22.61847774,-21.42173289
2020,Alaska,Lake and Peninsula Borough,1493,-90,26,16,10,0,-98,-98,-2,37,16.905071521,10.403120936,6.5019505852,0.0,-63.71911573,-63.71911573
2020,Alaska,Matanuska-Susitna Borough,110213,1635,1372,721,651,73,912,985,-1,2101,12.541649337,6.5907647024,5.9508846342,0.6673034997,8.3367231742,9.0040266739
2020,Alaska,Nome Census Area,9909,-131,167,113,54,4,-189,-185,0,188,16.742693869,11.328888666,5.4138052033,0.4010226076,-18.94831821,-18.5472956
2020,Alaska,North Slope Borough,9294,-139,144,71,73,7,-218,-211,-1,2240,15.378864741,7.5826346986,7.7962300422,0.7475837027,-23.28189245,-22.53430875
2020,Alaska,Northwest Arctic Borough,7644,-29,158,89,69,5,-102,-97,-1,400,20.630671803,11.621074623,9.0095971796,0.6528693608,-13.31853496,-12.6656656
2020,Alaska,Petersburg Borough,3296,2,26,38,-12,10,2,12,2,43,7.8907435508,11.53262519,-3.641881639,3.0349013657,0.6069802731,3.6418816388
2020,Alaska,Prince of Wales-Hyder Census Area,6147,-64,64,57,7,5,-76,-71,0,50,10.357663052,9.2247936559,1.1328693963,0.809192426,-12.29972487,-11.49053245
2020,Alaska,Sitka City and Borough,8405,-96,80,51,29,18,-143,-125,0,257,9.4640955874,6.0333609369,3.4307346504,2.1294215072,-16.91707086,-14.78764936
2020,Alaska,Skagway Municipality,1179,-14,6,16,-10,1,-5,-4,0,32,5.0590219224,13.490725126,-8.431703204,0.8431703204,-4.215851602,-3.372681282
2020,Alaska,Southeast Fairbanks Census Area,6957,78,96,48,48,23,8,31,-1,364,13.876843018,6.9384215091,6.9384215091,3.3246603064,1.1564035849,4.4810638913
2020,Alaska,Wrangell City and Borough,2510,-3,23,40,-17,7,6,13,1,17,9.1578737806,15.92673701,-6.768863229,2.7871789767,2.3890105515,5.1761895282
2020,Alaska,Yakutat City and Borough,637,61,6,6,0,2,60,62,-1,18,9.8928276999,9.8928276999,0.0,3.2976092333,98.928276999,102.22588623
2020,Alaska,Yukon-Koyukuk Census Area,5077,-177,78,69,9,0,-185,-185,-1,49,15.100183912,13.357855,1.742328913,0.0,-35.81453877,-35.81453877
2020,Arizona,Arizona,7421401,129558,81451,66385,15066,9272,105434,114706,-214,155824,11.071793549,9.0238427365,2.0479508122,1.2603610733,14.331849591,15.592210664
2020,Arizona,Apache County,71875,-45,891,774,117,29,-194,-165,3,953,12.392642303,10.765325637,1.6273166661,0.4033519942,-2.698285754,-2.29493376
2020,Arizona,Cochise County,127450,202,1335,1442,-107,115,191,306,3,5393,10.4830034,11.32321416,-0.840210759,0.9030302554,1.4998154677,2.4028457232
2020,Arizona,Coconino County,142481,-1486,1440,963,477,86,-2049,-1963,0,11916,10.054180864,6.7237334525,3.330447411,0.6004580238,-14.30626152,-13.7058035
2020,Arizona,Gila County,54303,226,481,910,-429,17,644,661,-6,846,8.8761764163,16.792766193,-7.916589777,0.3137110168,11.88411146,12.197822476
2020,Arizona,Graham County,39211,321,514,321,193,40,86,126,2,2831,13.162443503,8.2201252225,4.9423182802,1.0243146695,2.2022765394,3.2265912088
2020,Arizona,Greenlee County,9341,-126,123,57,66,11,-202,-191,-1,35,13.079540621,6.0612505317,7.0182900893,1.1697150149,-21.48022118,-20.31050617
2020,Arizona,La Paz County,21480,223,188,330,-142,71,295,366,-1,361,8.7979970517,15.443292697,-6.645295645,3.3226478227,13.805367714,17.128015537
2020,Arizona,Maricopa County,4579081,86820,52573,36247,16326,6185,64403,70588,-94,65297,11.591008254,7.9915408327,3.5994674217,1.3636350608,14.199222122,15.562857183
2020,Arizona,Mohave County,217206,3360,1780,3656,-1876,-62,5322,5260,-24,4152,8.2588643598,16.963150618,-8.704286258,-0.287668309,24.693076473,24.405408164
2020,Arizona,Navajo County,112112,1075,1363,1227,136,55,884,939,0,2214,12.216052951,10.997136442,1.2189165087,0.4929441763,7.9229573066,8.4159014829
2020,Arizona,Pima County,1061175,11914,10667,11132,-465,1584,10778,12362,17,24584,10.108811639,10.549478875,-0.440667237,1.5011116186,10.214003173,11.715114791
2020,Arizona,Pinal County,480828,19188,4678,3777,901,405,17977,18382,-95,23582,9.9271274993,8.015126243,1.9120012563,0.8594456257,38.148775343,39.008220969
2020,Arizona,Santa Cruz County,46808,80,612,371,241,129,-292,-163,2,293,13.085870681,7.9327745467,5.1530961341,2.758296271,-6.243585358,-3.485289087
2020,Arizona,Yavapai County,240226,4164,1798,3298,-1500,22,5671,5693,-29,3976,7.550053749,13.848763773,-6.298710024,0.0923810804,23.813323031,23.905704112
2020,Arizona,Yuma County,217824,3642,3008,1880,1128,585,1920,2505,9,9391,13.925732513,8.7035828206,5.2221496924,2.7082957181,8.8887654338,11.597061152
2020,Arkansas,Arkansas,3030522,9537,36332,33832,2500,1517,5550,7067,-30,82365,12.007587532,11.18134706,0.826240472,0.5013627184,1.8342538478,2.3356165663
2020,Arkansas,Arkansas County,17383,-132,208,236,-28,4,-109,-105,1,247,11.920453894,13.52513038,-1.604676486,0.229239498,-6.24677632,-6.017536822
2020,Arkansas,Ashley County,19339,-403,222,271,-49,-3,-347,-350,-4,191,11.361019421,13.868631816,-2.507612395,-0.153527289,-17.75798982,-17.91151711
2020,Arkansas,Baxter County,42242,264,350,753,-403,-5,677,672,-5,595,8.3115649489,17.881738304,-9.570173355,-0.118736642,16.076941344,15.958204702
2020,Arkansas,Benton County,288774,8939,3875,1998,1877,330,6765,7095,-33,2034,13.629752607,7.0276763118,6.602076295,1.1607273188,23.794910035,24.955637354
2020,Arkansas,Boone County,37625,9,372,493,-121,-4,134,130,0,465,9.8882258343,13.104557356,-3.216331521,-0.106325009,3.5618878005,3.4555627916
2020,Arkansas,Bradley County,10639,-153,136,131,5,-1,-157,-158,0,224,12.691894919,12.225281135,0.4666137838,-0.093322757,-14.65167281,-14.74499557
2020,Arkansas,Calhoun County,5113,-24,29,53,-24,0,-1,-1,1,175,5.6585365854,10.341463415,-4.682926829,0.0,-0.195121951,-0.195121951
2020,Arkansas,Carroll County,28276,-76,322,331,-9,32,-98,-66,-1,230,11.372465918,11.690329872,-0.317863954,1.1301829484,-3.461185279,-2.331002331
2020,Arkansas,Chicot County,9924,-265,114,161,-47,0,-216,-216,-2,734,11.335951872,16.009546065,-4.673594193,0.0,-21.47864565,-21.47864565
2020,Arkansas,Clark County,22103,-262,218,259,-41,18,-237,-219,-2,2976,9.8048034542,11.648826122,-1.844022668,0.8095709274,-10.65935054,-9.849779617
2020,Arkansas,Clay County,14375,-119,153,208,-55,0,-64,-64,0,125,10.599605113,14.409920676,-3.810315563,0.0,-4.433821747,-4.433821747
2020,Arkansas,Cleburne County,24935,-84,215,413,-198,-2,117,115,-1,339,8.6079192857,16.535212395,-7.92729311,-0.080073668,4.6843095648,4.604235897
2020,Arkansas,Cleveland County,7957,20,65,94,-29,0,50,50,-1,52,8.1791871146,11.828362904,-3.64917579,0.0,6.2916823959,6.2916823959
2020,Arkansas,Columbia County,23331,-165,281,300,-19,3,-148,-145,-1,2204,12.001622995,12.813120636,-0.81149764,0.1281312064,-6.321139514,-6.193008307
2020,Arkansas,Conway County,21037,132,239,238,1,15,116,131,0,286,11.396690668,11.34900577,0.0476848982,0.7152734729,5.5314481904,6.2467216632
2020,Arkansas,Craighead County,112245,1473,1544,1123,421,80,969,1049,3,3943,13.846478071,10.070981136,3.7754969352,0.717434097,8.6899204993,9.4073545963
2020,Arkansas,Crawford County,63409,3,714,719,-5,18,-12,6,2,540,11.260497575,11.3393526,-0.078855025,0.2838780901,-0.18925206,0.09462603
2020,Arkansas,Crittenden County,47616,-308,689,567,122,3,-433,-430,0,1011,14.423278208,11.869374084,2.5539041239,0.0628009211,-9.064266276,-9.001465355
2020,Arkansas,Cross County,16142,-191,199,225,-26,3,-167,-164,-1,225,12.255581216,13.856812933,-1.601231717,0.1847575058,-10.28483449,-10.10007698
2020,Arkansas,Dallas County,6802,-149,53,87,-34,-1,-113,-114,-1,401,7.7074092925,12.651785065,-4.944375773,-0.145422817,-16.4327783,-16.57820112
2020,Arkansas,Desha County,11110,-290,139,178,-39,17,-267,-250,-1,56,12.350066637,15.815193247,-3.46512661,1.5104398045,-23.72278987,-22.21235007
2020,Arkansas,Drew County,17977,-115,247,213,34,-1,-147,-148,-1,781,13.69597161,11.810696166,1.8852754443,-0.055449278,-8.151043833,-8.20649311
2020,Arkansas,Faulkner County,126919,1091,1441,1012,429,104,549,653,9,4046,11.402707055,8.008008008,3.3946990469,0.8229573447,4.3442652138,5.1672225585
2020,Arkansas,Franklin County,17897,160,173,203,-30,5,187,192,-2,447,9.7098276927,11.393612842,-1.683785149,0.2806308582,10.495594096,10.776224954
2020,Arkansas,Fulton County,12381,-135,119,223,-104,2,-32,-30,-1,165,9.5593846648,17.913804876,-8.354420211,0.1606619271,-2.570590834,-2.409928907
2020,Arkansas,Garland County,99789,317,1043,1445,-402,12,711,723,-4,2164,10.468681779,14.503590768,-4.034908989,0.1204450444,7.136368883,7.2568139275
2020,Arkansas,Grant County,18449,162,182,201,-19,0,181,181,0,143,9.9085365854,10.942944251,-1.034407666,0.0,9.8540940767,9.8540940767
2020,Arkansas,Greene County,45597,281,534,539,-5,-4,290,286,0,601,11.747494858,11.857490128,-0.10999527,-0.087996216,6.3797256718,6.2917294556
2020,Arkansas,Hempstead County,21253,-315,274,251,23,2,-337,-335,-3,301,12.797459191,11.723219915,1.0742392751,0.0934121109,-15.73994068,-15.64652857
2020,Arkansas,Hot Spring County,33787,3,361,410,-49,10,41,51,1,2162,10.685057199,12.135383523,-1.450326323,0.295984964,1.2135383523,1.5095233162
2020,Arkansas,Howard County,13109,-110,165,177,-12,6,-104,-98,0,181,12.534184139,13.445761167,-0.911577028,0.4557885141,-7.900334245,-7.444545731
2020,Arkansas,Independence County,37757,-62,431,461,-30,13,-45,-32,0,957,11.405737271,12.199640097,-0.793902826,0.3440245581,-1.190854239,-0.846829681
2020,Arkansas,Izard County,13613,-7,125,202,-77,0,71,71,-1,944,9.1800389234,14.8349429,-5.654903977,0.0,5.2142621085,5.2142621085
2020,Arkansas,Jackson County,16636,-146,187,227,-40,-1,-105,-106,0,2117,11.191573404,13.585492848,-2.393919445,-0.059847986,-6.284038542,-6.343886528
2020,Arkansas,Jefferson County,65377,-1760,789,880,-91,27,-1684,-1657,-12,5351,11.90817574,13.281615527,-1.373439787,0.4075041128,-25.41618244,-25.00867833
2020,Arkansas,Johnson County,26513,-83,329,271,58,20,-163,-143,2,626,12.389613813,10.205426576,2.1841872376,0.753168013,-6.138319306,-5.385151293
2020,Arkansas,Lafayette County,6596,-60,66,103,-37,8,-31,-23,0,82,9.9607606399,15.544823423,-5.584062783,1.207364926,-4.678539088,-3.471174162
2020,Arkansas,Lawrence County,16410,-30,185,276,-91,2,59,61,0,691,11.263318113,16.803652968,-5.540334855,0.1217656012,3.5920852359,3.7138508371
2020,Arkansas,Lee County,8513,-376,81,121,-40,12,-345,-333,-3,1624,9.309274796,13.906447535,-4.597172739,1.3791518216,-39.65061487,-38.27146305
2020,Arkansas,Lincoln County,12944,-68,126,167,-41,19,-46,-27,0,3519,9.7087378641,12.867930344,-3.15919248,1.4640160271,-3.544459855,-2.080443828
2020,Arkansas,Little River County,12180,-188,155,182,-27,-3,-156,-159,-2,123,12.628320026,14.828091902,-2.199771876,-0.244419097,-12.70979306,-12.95421216
2020,Arkansas,Logan County,21410,-85,243,312,-69,6,-22,-16,0,575,11.327351125,14.543759469,-3.216408344,0.2796876821,-1.025521501,-0.745833819
2020,Arkansas,Lonoke County,73921,273,888,755,133,6,128,134,6,572,12.035048011,10.232501406,1.8025466053,0.081317892,1.7347816953,1.8160995873
2020,Arkansas,Madison County,16644,125,195,157,38,5,82,87,0,79,11.760094081,9.4683834394,2.2917106414,0.3015408739,4.9452703314,5.2468112053
2020,Arkansas,Marion County,16790,145,141,300,-159,5,303,308,-4,141,8.4342754598,17.945266936,-9.510991476,0.2990877823,18.124719605,18.423807387
2020,Arkansas,Miller County,43177,-193,524,495,29,-14,-210,-224,2,1339,12.109027465,11.438871365,0.6701561002,-0.323523635,-4.852854518,-5.176378153
2020,Arkansas,Mississippi County,40066,-651,563,532,31,7,-688,-681,-1,767,13.938576186,13.171087976,0.7674882092,0.1733037892,-17.03328671,-16.85998292
2020,Arkansas,Monroe County,6584,-139,104,124,-20,0,-119,-119,0,84,15.63087097,18.636807695,-3.005936725,0.0,-17.88532351,-17.88532351
2020,Arkansas,Montgomery County,9006,-41,86,160,-74,0,33,33,0,121,9.5275023542,17.725585775,-8.198083421,0.0,3.6559020661,3.6559020661
2020,Arkansas,Nevada County,8099,-106,79,114,-35,-3,-67,-70,-1,157,9.6908734053,13.984298332,-4.293424926,-0.368007851,-8.218842002,-8.586849853
2020,Arkansas,Newton County,7602,-110,66,115,-49,0,-62,-62,1,51,8.6195637978,15.01893692,-6.399373123,0.0,-8.097165992,-8.097165992
2020,Arkansas,Ouachita County,23167,-205,257,360,-103,1,-101,-100,-2,352,11.044500312,15.470895378,-4.426395067,0.0429747094,-4.340445648,-4.297470938
2020,Arkansas,Perry County,10327,-90,96,143,-47,0,-41,-41,-2,152,9.2556883918,13.787119167,-4.531430775,0.0,-3.952950251,-3.952950251
2020,Arkansas,Phillips County,17299,-470,247,275,-28,-2,-437,-439,-3,246,14.086916847,15.683814304,-1.596897456,-0.114064104,-24.92300673,-25.03707083
2020,Arkansas,Pike County,10643,-62,104,148,-44,8,-27,-19,1,196,9.7433014802,13.865467491,-4.122166011,0.7494847292,-2.529510961,-1.780026232
2020,Arkansas,Poinsett County,23283,-219,278,362,-84,2,-139,-137,2,341,11.884150903,15.475045421,-3.590894517,0.0854974885,-5.942075452,-5.856577963
2020,Arkansas,Polk County,19707,-237,192,316,-124,1,-113,-112,-1,155,9.6844972384,15.939068372,-6.254571133,0.0504400898,-5.699730146,-5.649290056
2020,Arkansas,Pope County,64334,189,767,636,131,16,39,55,3,3345,11.939694425,9.9004506573,2.0392437675,0.2490679411,0.6071031063,0.8561710474
2020,Arkansas,Prairie County,7966,-127,86,130,-44,0,-83,-83,0,131,10.710505013,16.190298275,-5.479793262,0.0,-10.33688274,-10.33688274
2020,Arkansas,Pulaski County,392980,662,5010,4104,906,309,-578,-269,25,8613,12.759487481,10.452083158,2.3074043229,0.7869624015,-1.472052648,-0.685090246
2020,Arkansas,Randolph County,18247,86,269,272,-3,17,73,90,-1,349,14.776972094,14.941771039,-0.164798945,0.93386069,4.0101076686,4.9439683586
2020,Arkansas,St. Francis County,24682,-295,287,334,-47,17,-265,-248,0,4095,11.558831229,13.451740873,-1.892909644,0.6846694456,-10.67278842,-9.988118971
2020,Arkansas,Saline County,123968,1418,1339,1201,138,40,1243,1283,-3,1407,10.863304099,9.7437103984,1.1195937011,0.3245199134,10.084456307,10.408976221
2020,Arkansas,Scott County,10164,-53,114,129,-15,0,-38,-38,0,79,11.18688975,12.658848928,-1.471959178,0.0,-3.72896325,-3.72896325
2020,Arkansas,Searcy County,7842,-20,68,121,-53,2,31,33,0,71,8.6602139582,15.410086602,-6.749872644,0.2547121752,3.9480387163,4.2027508915
2020,Arkansas,Sebastian County,127590,-98,1615,1383,232,-11,-324,-335,5,2185,12.652872555,10.835246281,1.8176262741,-0.086180556,-2.538409107,-2.624589663
2020,Arkansas,Sevier County,16702,-270,233,166,67,-12,-323,-335,-2,173,13.838569816,9.8592385817,3.9793312348,-0.712716042,-19.18394013,-19.89665617
2020,Arkansas,Sharp County,17424,148,176,250,-74,3,223,226,-4,189,10.144092219,14.409221902,-4.265129683,0.1729106628,12.853025937,13.025936599
2020,Arkansas,Stone County,12674,60,135,184,-49,-1,111,110,-1,151,10.677000949,14.552356849,-3.8753559,-0.079088896,8.778867447,8.6997785511
2020,Arkansas,Union County,38219,-458,434,573,-139,7,-325,-318,-1,524,11.287973367,14.903245943,-3.615272576,0.1820640866,-8.452975447,-8.270911361
2020,Arkansas,Van Buren County,16541,12,145,262,-117,10,120,130,-1,189,8.7692772906,15.845176897,-7.075899607,0.6047777442,7.2573329301,7.8621106743
2020,Arkansas,Washington County,243216,3824,3220,1761,1459,324,2028,2352,13,7996,13.344163379,7.2978483573,6.0463150217,1.3427046381,8.4043364387,9.7470410768
2020,Arkansas,White County,78729,108,880,899,-19,12,111,123,4,3033,11.185255799,11.42675564,-0.241499841,0.1525262154,1.4108674929,1.5633937083
2020,Arkansas,Woodruff County,6264,-167,91,105,-14,0,-152,-152,-1,106,14.336352895,16.541945648,-2.205592753,0.0,-23.9464356,-23.9464356
2020,Arkansas,Yell County,21181,-195,250,252,-2,22,-214,-192,-1,323,11.748948469,11.842940057,-0.093991588,1.0339074653,-10.05709989,-9.023192424
2020,California,California,39368078,-69532,448160,304961,143199,28803,-242313,-213510,779,829974,11.373798297,7.7395682403,3.6342300571,0.7309878444,-6.149632245,-5.4186444
2020,California,Alameda County,1662323,-6089,18186,11948,6238,4436,-16777,-12341,14,36710,10.920112227,7.1743924389,3.7457197886,2.6636763357,-10.07405272,-7.410376388
2020,California,Alpine County,1119,6,10,13,-3,0,8,8,1,24,8.9605734767,11.64874552,-2.688172043,0.0,7.1684587814,7.1684587814
2020,California,Amador County,40083,390,314,494,-180,11,564,575,-5,4390,7.8720417168,12.384677096,-4.512635379,0.2757721621,14.139590854,14.415363016
2020,California,Butte County,212744,-5982,2236,2371,-135,20,-5850,-5830,-17,5443,10.364567641,10.990335365,-0.625767724,0.0927063295,-27.11660139,-27.02389506
2020,California,Calaveras County,46308,189,390,569,-179,3,369,372,-4,493,8.439092473,12.312419531,-3.873327058,0.0649160959,7.9846798014,8.0495958973
2020,California,Colusa County,21558,84,260,134,126,-35,-8,-43,1,262,12.084030489,6.2279234058,5.8561070831,-1.626696412,-0.371816323,-1.998512735
2020,California,Contra Costa County,1152333,-550,11771,9228,2543,1515,-4664,-3149,56,10284,10.212492018,8.0061911769,2.2063008412,1.31441045,-4.046475471,-2.732065021
2020,California,Del Norte County,27968,65,267,306,-39,16,87,103,1,3082,9.5577312022,10.953804299,-1.396073097,0.5727479372,3.1143169086,3.6870648458
2020,California,El Dorado County,192925,-132,1608,1846,-238,41,67,108,-2,1643,8.3319947562,9.5652128856,-1.233218129,0.2124451399,0.3471664482,0.5596115881
2020,California,Fresno County,1000918,3071,14251,7941,6310,41,-3336,-3295,56,17672,14.25980543,7.9459065973,6.3138988325,0.0410253331,-3.338061253,-3.29703592
2020,California,Glenn County,28283,-162,385,249,136,-25,-273,-298,0,319,13.573543929,8.778733606,4.7948103229,-0.881398956,-9.624876604,-10.50627556
2020,California,Humboldt County,134977,-862,1370,1523,-153,13,-725,-712,3,5258,10.117570601,11.24748907,-1.129918469,0.0960061444,-5.354188822,-5.258182678
2020,California,Imperial County,180267,-172,2541,1120,1421,-75,-1522,-1597,4,8535,14.089036501,6.2100436366,7.878992864,-0.415851136,-8.439005728,-8.854856864
2020,California,Inyo County,18046,53,181,192,-11,4,61,65,-1,410,10.044673826,10.655123616,-0.610449791,0.221981742,3.3852215655,3.6072033075
2020,California,Kern County,901362,2464,12826,6980,5846,-316,-3122,-3438,56,30547,14.249052915,7.7544354704,6.4946174441,-0.351060402,-3.4683879,-3.819448302
2020,California,Kings County,152692,-35,2184,986,1198,-94,-1143,-1237,4,15835,14.301664271,6.4567037414,7.8449605296,-0.615547821,-7.48479957,-8.100347392
2020,California,Lake County,64479,16,732,917,-185,-23,226,203,-2,1101,11.353942082,14.223449303,-2.86950722,-0.356749546,3.5054520637,3.1487025174
2020,California,Lassen County,30016,-678,291,208,83,2,-761,-759,-2,7045,9.5865590512,6.852248394,2.7343106572,0.0658870038,-25.07000494,-25.00411794
2020,California,Los Angeles County,9943046,-68556,107789,73513,34276,7573,-110428,-102855,23,180231,10.803397785,7.3680076942,3.4353900906,0.7590211564,-11.06789756,-10.30887641
2020,California,Madera County,157761,1044,2042,1178,864,-184,360,176,4,7131,12.986600017,7.4917800291,5.4948199874,-1.170193145,2.2895083281,1.1193151826
2020,California,Marin County,257332,-1753,2065,2183,-118,255,-1892,-1637,2,8416,7.9974129434,8.4544079688,-0.456995025,0.9875739954,-7.327411762,-6.339837767
2020,California,Mariposa County,17160,43,136,185,-49,7,87,94,-2,726,7.9353502349,10.794410246,-2.859060011,0.4084371444,5.0762902238,5.4847273682
2020,California,Mendocino County,86061,-871,890,979,-89,-24,-756,-780,-2,1970,10.289433677,11.318377044,-1.028943368,-0.277467874,-8.740238044,-9.017705919
2020,California,Merced County,279252,2138,3855,1922,1933,-205,392,187,18,6943,13.857784264,6.9091209743,6.94866329,-0.736924974,1.4091443402,0.6722193664
2020,California,Modoc County,8763,-103,68,104,-36,-2,-64,-66,-1,333,7.7145612343,11.798740711,-4.084179477,-0.22689886,-7.260763515,-7.487662374
2020,California,Mono County,14534,84,119,42,77,33,-29,4,3,337,8.2114269942,2.8981507038,5.3132762904,2.2771184102,-2.001104057,0.2760143527
2020,California,Monterey County,430906,-2474,5799,2892,2907,-260,-5111,-5371,-10,17092,13.419169118,6.6922291927,6.726939925,-0.601652694,-11.82710353,-12.42875622
2020,California,Napa County,135965,-1713,1226,1415,-189,-29,-1490,-1519,-5,5079,8.9605800258,10.341941873,-1.381361847,-0.211954992,-10.89010134,-11.10205633
2020,California,Nevada County,99606,-42,790,1065,-275,-4,239,235,-2,1172,7.9295773234,10.689873227,-2.760295904,-0.040149759,2.3989480763,2.3587983177
2020,California,Orange County,3166857,-3994,35163,23233,11930,2336,-18375,-16039,115,43650,11.096440543,7.3316725857,3.7647679571,0.7371750166,-5.798626254,-5.061451238
2020,California,Placer County,402950,4032,3678,3692,-14,51,4017,4068,-22,3932,9.1735796914,9.2084981568,-0.034918465,0.127202981,10.019105389,10.14630837
2020,California,Plumas County,18967,-85,154,212,-58,1,-27,-26,-1,280,8.1012125516,11.152318578,-3.051106026,0.0526052763,-1.42034246,-1.367737184
2020,California,Riverside County,2489188,23619,28383,19696,8687,-781,15656,14875,57,34027,11.456868621,7.9503394415,3.5065291799,-0.315252595,6.3195833822,6.0043307876
2020,California,Sacramento County,1559146,7486,19084,13340,5744,1599,39,1638,104,23150,12.269489001,8.5765554008,3.6929335998,1.0280293917,0.0250738876,1.0531032793
2020,California,San Benito County,64055,1252,808,383,425,-48,878,830,-3,397,12.738652667,6.0382474893,6.7004051774,-0.756751644,13.842248814,13.08549717
2020,California,San Bernardino County,2189183,11904,28808,16533,12275,-556,-1,-557,186,38664,13.195122275,7.5727213474,5.6224009278,-0.254668425,-0.000458037,-0.255126462
2020,California,San Diego County,3332427,1968,39080,25040,14040,2458,-14678,-12220,148,110390,11.730652453,7.5162624724,4.2143899806,0.7378184168,-4.405898585,-3.668080168
2020,California,San Francisco County,866606,-12220,8547,6898,1649,2118,-15926,-13808,-61,25704,9.7935640002,7.9040604274,1.8895035728,2.4269063475,-18.24877738,-15.82187103
2020,California,San Joaquin County,767967,6396,9957,6339,3618,269,2473,2742,36,15882,13.019617688,8.2887773955,4.730840293,0.3517401987,3.2336561759,3.5853963746
2020,California,San Luis Obispo County,282249,-479,2423,2641,-218,-50,-222,-272,11,16154,8.5773403165,9.3490531473,-0.771712831,-0.176998356,-0.785872699,-0.962871055
2020,California,San Mateo County,758308,-6502,8226,5556,2670,1677,-10815,-9138,-34,9323,10.801526868,7.2955608167,3.5059660512,2.2020618232,-14.20113215,-11.99907033
2020,California,Santa Barbara County,444766,-698,5390,3550,1840,162,-2710,-2548,10,19942,12.109230199,7.9754670141,4.1337631848,0.3639508891,-6.088314256,-5.724363367
2020,California,Santa Clara County,1907105,-15306,21070,12110,8960,6959,-31149,-24190,-76,30408,11.00400155,6.3245590304,4.6794425196,3.6344018409,-16.26785213,-12.63345028
2020,California,Santa Cruz County,269925,-2945,2402,2096,306,-26,-3219,-3245,-6,13687,8.850486832,7.7229893422,1.1274974898,-0.09580044,-11.86083144,-11.95663188
2020,California,Shasta County,179027,-618,1918,2381,-463,102,-265,-163,8,2924,10.695008253,13.276754249,-2.581745996,0.5687647767,-1.477673194,-0.908908418
2020,California,Sierra County,2920,-39,18,40,-22,0,-17,-17,0,33,6.1234903895,13.607756421,-7.484266032,0.0,-5.783296479,-5.783296479
2020,California,Siskiyou County,43245,-418,383,607,-224,5,-198,-193,-1,596,8.8139181663,13.968794587,-5.154876421,0.1150642058,-4.556542551,-4.441478345
2020,California,Solano County,446935,-499,5023,3953,1070,102,-1690,-1588,19,11825,11.232500232,8.839751825,2.392748407,0.2280937734,-3.779200755,-3.551106982
2020,California,Sonoma County,489819,-2499,4353,4751,-398,-53,-2058,-2111,10,10527,8.8643437728,9.6748213335,-0.810477561,-0.107927916,-4.190861356,-4.298789273
2020,California,Stanislaus County,550081,320,7335,4676,2659,-58,-2313,-2371,32,6536,13.338279498,8.5030395275,4.8352399708,-0.105469695,-4.206058688,-4.311528383
2020,California,Sutter County,96385,-525,1244,899,345,31,-898,-867,-3,736,12.871517628,9.3018443312,3.5696732973,0.3207532528,-9.291497452,-8.970744199
2020,California,Tehama County,64494,-692,765,735,30,-30,-691,-721,-1,795,11.798272671,11.335595312,0.4626773597,-0.46267736,-10.65700185,-11.11967921
2020,California,Trinity County,12216,-121,96,180,-84,3,-40,-37,0,375,7.8198183521,14.66215941,-6.842341058,0.2443693235,-3.258257647,-3.013888323
2020,California,Tulare County,468680,2929,6787,3404,3383,-291,-194,-485,31,4977,14.526487242,7.2857171905,7.2407700515,-0.622838926,-0.41522595,-1.038064876
2020,California,Tuolumne County,54515,225,457,679,-222,13,438,451,-4,3941,8.4003492487,12.48104407,-4.080694821,0.2389596066,8.0511005928,8.2900601994
2020,California,Ventura County,841387,-2816,8820,6741,2079,-320,-4601,-4921,26,11350,10.465178365,7.9983863217,2.4667920431,-0.379689011,-5.459216061,-5.838905072
2020,California,Yolo County,219728,-291,2068,1489,579,435,-1317,-882,12,10093,9.4054081097,6.7720757617,2.6333323479,1.9784103132,-5.989807776,-4.011397463
2020,California,Yuba County,80160,1611,1138,604,534,1,1081,1082,-5,1193,14.340711617,7.6114146016,6.7292970153,0.0126016798,13.622415868,13.635017548
2020,Colorado,Colorado,5807719,49233,63285,42735,20550,3118,25498,28616,67,117920,10.943088074,7.3896321222,3.5534559521,0.5391569664,4.4090520616,4.9482090279
2020,Colorado,Adams County,519883,3308,6565,3458,3107,312,-138,174,27,4035,12.668144778,6.6727257641,5.9954190136,0.6020504449,-0.266291543,0.335758902
2020,Colorado,Alamosa County,16180,-20,191,127,64,-3,-82,-85,1,852,11.797405806,7.8443483632,3.9530574429,-0.185299568,-5.064854849,-5.250154416
2020,Colorado,Arapahoe County,657452,1401,7501,4531,2970,779,-2392,-1613,44,5061,11.421367138,6.8991087192,4.5222584189,1.1861411813,-3.64216907,-2.456027889
2020,Colorado,Archuleta County,14196,268,109,103,6,6,259,265,-3,129,7.751386716,7.3247048784,0.4266818376,0.4266818376,18.418432655,18.845114493
2020,Colorado,Baca County,3555,-65,39,49,-10,1,-56,-55,0,82,10.871080139,13.658536585,-2.787456446,0.2787456446,-15.6097561,-15.33101045
2020,Colorado,Bent County,5356,-222,41,54,-13,1,-208,-207,-2,1518,7.4995427108,9.8774464972,-2.377903786,0.1829156759,-38.04646058,-37.86354491
2020,Colorado,Boulder County,327171,1151,2517,2164,353,289,485,774,24,10463,7.7067810181,6.6259333028,1.0808477153,0.8848866564,1.4850173992,2.3699040556
2020,Colorado,Broomfield County,72236,1619,672,445,227,40,1355,1395,-3,282,9.4082728399,6.2301806752,3.1780921647,0.5600162405,18.970550146,19.530566386
2020,Colorado,Chaffee County,20661,342,138,191,-53,5,394,399,-4,1395,6.7349926794,9.3216203026,-2.586627623,0.2440214739,19.228892143,19.472913616
2020,Colorado,Cheyenne County,1795,-29,14,14,0,1,-30,-29,0,42,7.7369439072,7.7369439072,0.0,0.5526388505,-16.57916552,-16.02652666
2020,Colorado,Clear Creek County,9586,-12,63,81,-18,8,-1,7,-1,84,6.5679733111,8.4445371143,-1.876563803,0.834028357,-0.104253545,0.7297748123
2020,Colorado,Conejos County,8143,-26,97,80,17,1,-44,-43,0,36,11.893084846,9.8087297695,2.084355076,0.1226091221,-5.394801373,-5.272192251
2020,Colorado,Costilla County,3921,49,36,29,7,7,37,44,-2,0,9.2390606955,7.4425766714,1.7964840241,1.7964840241,9.4957012704,11.292185294
2020,Colorado,Crowley County,5696,-293,27,48,-21,5,-276,-271,-1,2675,4.621309371,8.215661104,-3.594351733,0.8557980317,-47.24005135,-46.38425332
2020,Colorado,Custer County,5183,64,37,42,-5,0,71,71,-2,150,7.1830712483,8.1537565521,-0.970685304,0.0,13.783731314,13.783731314
2020,Colorado,Delta County,31067,46,268,422,-154,-2,205,203,-3,582,8.6329081304,13.593609071,-4.960700941,-0.064424688,6.6035304729,6.5391057853
2020,Colorado,Denver County,735538,10030,9233,5406,3827,588,5641,6229,-26,16064,12.63889022,7.4001776809,5.2387125388,0.8049027888,7.72186502,8.5267678088
2020,Colorado,Dolores County,2096,54,16,11,5,0,48,48,1,0,7.7332044466,5.316578057,2.4166263896,0.0,23.19961334,23.19961334
2020,Colorado,Douglas County,360750,8908,3525,1704,1821,183,6930,7113,-26,651,9.8934593709,4.7825403597,5.1109190112,0.5136178907,19.450120125,19.963738016
2020,Colorado,Eagle County,54929,-254,559,163,396,52,-702,-650,0,55,10.15329846,2.9606219122,7.1926765475,0.94449288,-12.75065388,-11.806161
2020,Colorado,Elbert County,27313,606,216,170,46,5,560,565,-5,73,7.997038134,6.2939651981,1.7030729359,0.1851166235,20.733061829,20.918178452
2020,Colorado,El Paso County,728310,6381,9089,5259,3830,77,2429,2506,45,19818,12.534485695,7.2525976753,5.2818880198,0.1061893936,3.3497926893,3.455982083
2020,Colorado,Fremont County,47867,-142,378,612,-234,-1,91,90,2,7851,7.8851850307,12.76649005,-4.881305019,-0.020860278,1.8982852852,1.8774250073
2020,Colorado,Garfield County,60366,335,763,405,358,1,-28,-27,4,865,12.67473442,6.7277423856,5.9469920347,0.0166117096,-0.465127869,-0.448516159
2020,Colorado,Gilpin County,6235,3,31,38,-7,0,10,10,0,49,4.9731290607,6.0960936873,-1.122964627,0.0,1.6042351809,1.6042351809
2020,Colorado,Grand County,15794,46,110,70,40,8,-3,5,1,222,6.9748272145,4.4385264092,2.5363008053,0.5072601611,-0.19022256,0.3170376007
2020,Colorado,Gunnison County,17593,113,131,77,54,0,58,58,1,990,7.4701337211,4.3908419582,3.0792917629,0.0,3.307387449,3.307387449
2020,Colorado,Hinsdale County,808,19,6,7,-1,0,20,20,0,56,7.5140889167,8.7664370695,-1.252348153,0.0,25.046963056,25.046963056
2020,Colorado,Huerfano County,6883,15,39,106,-67,0,84,84,-2,165,5.6723147407,15.417060577,-9.744745837,0.0,12.217293288,12.217293288
2020,Colorado,Jackson County,1389,-8,12,12,0,1,-9,-8,0,2,8.6145010768,8.6145010768,0.0,0.7178750897,-6.460875808,-5.743000718
2020,Colorado,Jefferson County,583283,483,5701,5002,699,209,-447,-238,22,8123,9.7780346682,8.5791491686,1.1988854996,0.3584650492,-0.766669268,-0.408204219
2020,Colorado,Kiowa County,1458,41,19,14,5,1,34,35,1,14,13.217391304,9.7391304348,3.4782608696,0.6956521739,23.652173913,24.347826087
2020,Colorado,Kit Carson County,7121,-40,91,71,20,4,-64,-60,0,58,12.743313261,9.9425850721,2.8007281893,0.5601456379,-8.962330206,-8.402184568
2020,Colorado,Lake County,7987,-85,95,35,60,2,-147,-145,0,153,11.831371816,4.3589264587,7.4724453577,0.2490815119,-18.30749113,-18.05840961
2020,Colorado,La Plata County,56564,124,439,399,40,1,81,82,2,1809,7.769636473,7.0616969311,0.707939542,0.0176984885,1.4335775725,1.451276061
2020,Colorado,Larimer County,360428,3187,3241,2488,753,162,2257,2419,15,9905,9.0320189391,6.9335585068,2.0984604323,0.451461607,6.2898076969,6.7412693038
2020,Colorado,Las Animas County,14420,5,111,177,-66,14,57,71,0,808,7.6989769377,12.276747009,-4.577770071,0.9710421363,3.9535286978,4.9245708341
2020,Colorado,Lincoln County,5680,-14,58,48,10,3,-27,-24,0,1011,10.198698787,8.4403024442,1.7583963425,0.5275189028,-4.747670125,-4.220151222
2020,Colorado,Logan County,21974,-435,219,218,1,-7,-427,-434,-2,3448,9.8686433995,9.8235811009,0.0450622986,-0.31543609,-19.24160151,-19.5570376
2020,Colorado,Mesa County,155603,1051,1596,1688,-92,0,1141,1141,2,4434,10.291628379,10.884880141,-0.593251761,0.0,7.3576115168,7.3576115168
2020,Colorado,Mineral County,773,17,6,10,-4,0,22,22,-1,0,7.8482668411,13.080444735,-5.232177894,0.0,28.776978417,28.776978417
2020,Colorado,Moffat County,13144,-65,154,99,55,-1,-117,-118,-2,102,11.687473912,7.5133760862,4.1740978257,-0.075892688,-8.879444466,-8.955337153
2020,Colorado,Montezuma County,26408,39,253,323,-70,-3,110,107,2,243,9.5875097107,12.240180382,-2.652670671,-0.113685886,4.1684824829,4.054796597
2020,Colorado,Montrose County,43322,531,410,495,-85,-8,625,617,-1,542,9.5223717673,11.496522012,-1.974150244,-0.185802376,14.515810621,14.330008245
2020,Colorado,Morgan County,28941,3,428,268,160,82,-237,-155,-2,563,14.789474594,9.2606990446,5.528775549,2.8334974689,-8.189498782,-5.356001313
2020,Colorado,Otero County,18201,-42,218,241,-23,-1,-18,-19,0,489,11.963560531,13.225771046,-1.262210515,-0.054878718,-0.987816925,-1.042695643
2020,Colorado,Ouray County,5001,-4,22,23,-1,-1,-2,-3,0,0,4.3973615831,4.597241655,-0.199880072,-0.199880072,-0.399760144,-0.599640216
2020,Colorado,Park County,18955,74,138,105,33,3,38,41,0,92,7.2946400254,5.5502695845,1.7443704408,0.158579131,2.0086689925,2.1672481235
2020,Colorado,Phillips County,4367,8,50,57,-7,32,-17,15,0,60,11.460004584,13.064405226,-1.604400642,7.3344029338,-3.896401559,3.4380013752
2020,Colorado,Pitkin County,17894,-8,129,51,78,45,-131,-86,0,72,7.2075092189,2.8494803889,4.35802883,2.5142474019,-7.319253548,-4.805006146
2020,Colorado,Prowers County,12106,0,145,123,22,0,-22,-22,0,315,11.977531802,10.160251115,1.8172806873,0.0,-1.817280687,-1.817280687
2020,Colorado,Pueblo County,169823,1414,1803,2000,-197,2,1616,1618,-7,4077,10.661321223,11.826202133,-1.16488091,0.0118262021,9.5555713238,9.567397526
2020,Colorado,Rio Blanco County,6342,-8,58,49,9,7,-24,-17,0,262,9.1396155058,7.7213993066,1.4182161992,1.1030570438,-3.781909864,-2.678852821
2020,Colorado,Rio Grande County,11296,19,122,133,-11,-1,32,31,-1,198,10.809374031,11.783989722,-0.974615691,-0.088601426,2.8352456475,2.746644221
2020,Colorado,Routt County,25560,-19,189,139,50,20,-92,-72,3,324,7.391618921,5.43616418,1.955454741,0.7821818964,-3.598036723,-2.815854827
2020,Colorado,Saguache County,6938,109,54,60,-6,5,114,119,-4,18,7.8448463718,8.7164959686,-0.871649597,0.7263746641,16.56134234,17.287717004
2020,Colorado,San Juan County,748,25,2,6,-4,0,30,30,-1,0,2.7192386132,8.1577158396,-5.438477226,0.0,40.788579198,40.788579198
2020,Colorado,San Miguel County,8105,-64,53,35,18,17,-99,-82,0,9,6.5134570481,4.30133956,2.212117488,2.089222072,-12.16664618,-10.07742411
2020,Colorado,Sedgwick County,2260,-14,18,25,-7,0,-7,-7,0,35,7.9400088222,11.027790031,-3.087781209,0.0,-3.087781209,-3.087781209
2020,Colorado,Summit County,30631,-220,252,75,177,48,-447,-399,2,273,8.1975212257,2.43973846,5.7577827657,1.5614326144,-14.54084122,-12.97940861
2020,Colorado,Teller County,25529,121,173,218,-45,-1,168,167,-1,132,6.7927047137,8.559593223,-1.766888509,-0.039264189,6.5963837682,6.5571195791
2020,Colorado,Washington County,4875,6,46,49,-3,-1,10,9,0,184,9.4417077176,10.057471264,-0.615763547,-0.205254516,2.052545156,1.8472906404
2020,Colorado,Weld County,333983,9280,4428,2042,2386,96,6828,6924,-30,5724,13.44494949,6.200222868,7.2447266224,0.2914894198,20.732184986,21.023674406
2020,Colorado,Yuma County,10047,27,141,91,50,25,-48,-23,0,196,14.052922709,9.0696167838,4.9833059252,2.4916529626,-4.783973688,-2.292320726
2020,Connecticut,Connecticut,3557006,-9016,34258,33477,781,9387,-19294,-9907,110,110606,9.6189429552,9.399654192,0.2192887631,2.6356768498,-5.417359022,-2.781682172
2020,Connecticut,Fairfield County,942426,-1962,9461,7423,2038,3386,-7417,-4031,31,19496,10.028545474,7.8682901441,2.1602553299,3.5891190123,-7.861930217,-4.272811204
2020,Connecticut,Hartford County,889226,-2123,9108,8831,277,2671,-5105,-2434,34,24967,10.2304031,9.9192676523,0.3111354478,3.0001544445,-5.734102748,-2.733948303
2020,Connecticut,Litchfield County,179610,-786,1375,1973,-598,191,-378,-187,-1,2463,7.6387615762,10.960928429,-3.322166853,1.0610934262,-2.099965001,-1.038871574
2020,Connecticut,Middlesex County,161657,-881,1274,1662,-388,180,-675,-495,2,4956,7.8594672959,10.253088419,-2.393621123,1.1104427891,-4.164160459,-3.05371767
2020,Connecticut,New Haven County,851948,-1870,8397,8512,-115,2089,-3873,-1784,29,28515,9.8454301469,9.9802669299,-0.134836783,2.4493394756,-4.541068353,-2.091728877
2020,Connecticut,New London County,264999,-785,2455,2768,-313,376,-858,-482,10,10858,9.2504846613,10.429874355,-1.179389694,1.4167748402,-3.232959609,-1.816184769
2020,Connecticut,Tolland County,150600,-265,1156,1151,5,297,-570,-273,3,14683,7.6692153318,7.6360439852,0.0331713466,1.9703779875,-3.781533511,-1.811155524
2020,Connecticut,Windham County,116540,-344,1032,1157,-125,197,-418,-221,2,4668,8.842278429,9.9132908356,-1.071012407,1.6879155528,-3.581465488,-1.893549935
2020,Delaware,Delaware,986809,10141,10516,10368,148,1217,8772,9989,4,24938,10.711610067,10.560857092,0.1507529755,1.2396376428,8.9351695996,10.174807242
2020,Delaware,Kent County,183643,2151,2151,1947,204,201,1746,1947,0,4615,11.781943665,10.664548729,1.1173949361,1.1009626576,9.5635860709,10.664548729
2020,Delaware,New Castle County,561531,1590,6097,5242,855,847,-146,701,34,17477,10.873209496,9.3484277806,1.5247817155,1.510514752,-0.260372082,1.2501426696
2020,Delaware,Sussex County,241635,6400,2268,3179,-911,169,7172,7341,-30,2846,9.5120263384,13.332774131,-3.820747793,0.7087885587,30.079476587,30.788265146
2020,District of Columbia,District of Columbia,712816,4563,9155,6093,3062,2143,-658,1485,16,38802,12.884666403,8.5752345593,4.3094318432,3.0160393338,-0.926063407,2.0899759266
2020,District of Columbia,District of Columbia,712816,4563,9155,6093,3062,2143,-658,1485,16,38802,12.884666403,8.5752345593,4.3094318432,3.0160393338,-0.926063407,2.0899759266
2020,Florida,Florida,21733312,241256,219996,230396,-10400,78072,174645,252717,-1061,430318,10.179022652,10.660221562,-0.481198911,3.612323208,8.0806715168,11.692994725
2020,Florida,Alachua County,271218,1729,2680,2236,444,675,585,1260,25,14597,9.9129473079,8.2706530524,1.6422942555,2.4967311316,2.1638336474,4.6605647791
2020,Florida,Baker County,29566,278,359,284,75,6,194,200,3,2831,12.199680565,9.6510007816,2.5486797839,0.2038943827,6.5925850409,6.7964794237
2020,Florida,Bay County,171322,-2573,1894,2065,-171,232,-2627,-2395,-7,3645,10.972808407,11.963489631,-0.990681224,1.3440821281,-15.21941272,-13.87533059
2020,Florida,Bradford County,28593,245,292,355,-63,1,309,310,-2,4225,10.256230133,12.469046908,-2.212816775,0.0351240758,10.853339422,10.888463497
2020,Florida,Brevard County,608459,7435,5236,8105,-2869,489,9874,10363,-59,6768,8.6582448865,13.402420704,-4.744175817,0.8086099598,16.327637511,17.136247471
2020,Florida,Broward County,1958105,2630,21491,17369,4122,10567,-12084,-1517,25,16287,10.982783027,8.8762718534,2.1065111739,5.4001706877,-6.175419948,-0.77524926
2020,Florida,Calhoun County,14078,-62,121,159,-38,7,-30,-23,-1,1688,8.5760861861,11.269402509,-2.693316323,0.4961372174,-2.12630236,-1.630165143
2020,Florida,Charlotte County,194711,5042,1002,3117,-2115,200,7009,7209,-52,2885,5.2135907175,16.218325615,-11.0047349,1.0406368698,36.469119101,37.509755971
2020,Florida,Citrus County,153010,2857,1029,2865,-1836,22,4707,4729,-36,2253,6.7884273477,18.900723373,-12.11229603,0.1451364448,31.052602066,31.19773851
2020,Florida,Clay County,221770,2756,2211,2104,107,162,2498,2660,-11,1249,10.032124578,9.5466260118,0.4854985662,0.735053904,11.334349704,12.069403608
2020,Florida,Collier County,392973,7056,3163,4286,-1123,1594,6617,8211,-32,4547,8.1218143769,11.005405128,-2.883590751,4.0930041469,16.990845947,21.083850094
2020,Florida,Columbia County,72654,888,789,926,-137,26,1003,1029,-4,5441,10.926464479,12.823708628,-1.897244149,0.3600609334,13.89004293,14.250103864
2020,Florida,DeSoto County,38520,699,403,371,32,103,566,669,-2,3583,10.557891565,9.7195478183,0.8383437471,2.6984189361,14.828205027,17.526623964
2020,Florida,Dixie County,17057,170,153,235,-82,-2,255,253,-1,1758,9.0148479849,13.84633514,-4.831487155,-0.11784115,15.024746642,14.906905491
2020,Florida,Duval County,966728,6875,12932,9624,3308,1978,1552,3530,37,20763,13.42481837,9.9907556443,3.4340627256,2.053378498,1.6111443017,3.6645227997
2020,Florida,Escambia County,322364,2985,3812,3925,-113,258,2836,3094,4,18012,11.880145167,12.232311065,-0.352165898,0.8040601923,8.8384290908,9.6424892831
2020,Florida,Flagler County,118451,2970,840,1560,-720,100,3612,3712,-22,684,7.1815741327,13.337209104,-6.155634971,0.8549493015,30.88076877,31.735718072
2020,Florida,Franklin County,12201,88,88,141,-53,4,139,143,-2,1765,7.238627951,11.598256149,-4.359628198,0.3290285432,11.433741877,11.76277042
2020,Florida,Gadsden County,45277,-393,492,540,-48,26,-369,-343,-2,3267,10.819488273,11.875048105,-1.055559832,0.5717615754,-8.114616205,-7.54285463
2020,Florida,Gilchrist County,18885,313,191,210,-19,4,329,333,-1,1182,10.198360787,11.21285741,-1.014496623,0.2135782364,17.566809942,17.780388178
2020,Florida,Glades County,14198,284,61,147,-86,15,356,371,-1,1468,4.3397837223,10.458167331,-6.118383608,1.0671599317,25.327262379,26.394422311
2020,Florida,Gulf County,13534,36,115,196,-81,1,117,118,-1,398,8.5084344481,14.501331755,-5.992897307,0.0739863865,8.6564072211,8.7303936076
2020,Florida,Hamilton County,14521,51,167,146,21,12,16,28,2,2705,11.520816805,10.072091339,1.4487254665,0.8278431237,1.1037908316,1.9316339554
2020,Florida,Hardee County,26822,16,330,225,105,0,-90,-90,1,1590,12.307003804,8.3911389573,3.9158648467,0.0,-3.356455583,-3.356455583
2020,Florida,Hendry County,42813,744,593,363,230,268,245,513,1,696,13.972338069,8.5530501166,5.4192879527,6.314648571,5.7727197757,12.087368347
2020,Florida,Hernando County,198792,4502,1607,3098,-1491,127,5911,6038,-45,1832,8.1764110287,15.762614416,-7.586203388,0.6461756071,30.075149714,30.721325321
2020,Florida,Highlands County,106639,749,835,1807,-972,244,1485,1729,-8,1734,7.8577511775,17.004738177,-9.146986999,2.2961572303,13.974563471,16.270720702
2020,Florida,Hillsborough County,1497957,21526,17169,12718,4451,5483,11559,17042,33,23501,11.544559755,8.5516751681,2.9928845867,3.6868088494,7.772355187,11.459164036
2020,Florida,Holmes County,19594,-67,192,277,-85,3,15,18,0,1760,9.7821933512,14.112851866,-4.330658515,0.1528467711,0.7642338556,0.9170806267
2020,Florida,Indian River County,162518,2779,1277,2416,-1139,119,3815,3934,-16,1326,7.9253515052,14.994243725,-7.06889222,0.7385409782,23.676754888,24.415295866
2020,Florida,Jackson County,46085,-172,468,668,-200,20,7,27,1,6313,10.1362327,14.467956076,-4.331723376,0.4331723376,0.1516103182,0.5847826558
2020,Florida,Jefferson County,14543,263,110,170,-60,29,297,326,-3,1273,7.6327932554,11.796135031,-4.163341776,2.0122818582,20.60854179,22.620823648
2020,Florida,Lafayette County,8482,98,57,82,-25,19,104,123,0,1259,6.7591604411,9.7237044942,-2.964544053,2.2530534804,12.332503261,14.585556741
2020,Florida,Lake County,375492,8551,3456,4968,-1512,445,9677,10122,-59,3948,9.3099309971,13.383025808,-4.073094811,1.1987613697,26.068345561,27.267106931
2020,Florida,Lee County,790767,18499,6919,8819,-1900,1985,18519,20504,-105,8476,8.853288634,11.284456202,-2.431167568,2.5399303279,23.696206419,26.236136747
2020,Florida,Leon County,295460,1594,2919,2175,744,342,484,826,24,15011,9.9062318649,7.3813135684,2.5249182965,1.1606479266,1.6425543757,2.8032023023
2020,Florida,Levy County,42214,594,431,604,-173,15,756,771,-4,335,10.282224396,14.409428156,-4.12720376,0.357850037,18.035641864,18.393491901
2020,Florida,Liberty County,8364,23,66,71,-5,-5,33,28,0,2050,7.9018258007,8.5004489674,-0.598623167,-0.598623167,3.9509129003,3.3522897336
2020,Florida,Madison County,18707,108,198,248,-50,27,132,159,-1,2022,10.614914491,13.295448453,-2.680533962,1.4474883397,7.0766096606,8.5240980003
2020,Florida,Manatee County,411219,8242,3496,4839,-1343,528,9099,9627,-42,4814,8.5876128107,11.886572766,-3.298959956,1.2969850012,22.350883571,23.647868572
2020,Florida,Marion County,373513,7516,3532,5608,-2076,250,9397,9647,-55,9218,9.5522710984,15.166799638,-5.614528539,0.676123379,25.41412557,26.090248949
2020,Florida,Martin County,162088,876,1230,2210,-980,49,1818,1867,-11,4216,7.609031859,13.671512527,-6.062480668,0.3031240334,11.24652026,11.549644293
2020,Florida,Miami-Dade County,2707303,-4309,30086,23189,6897,28593,-39667,-11074,-132,42231,11.104067881,8.5585398553,2.5455280254,10.553035063,-14.64020011,-4.087165051
2020,Florida,Monroe County,73900,3,675,771,-96,210,-113,97,2,1998,9.1341502196,10.433229362,-1.299079142,2.8417356239,-1.529124407,1.3126112167
2020,Florida,Nassau County,91113,2530,859,1074,-215,14,2745,2759,-14,543,9.5605912207,11.953521503,-2.392930282,0.1558187161,30.551598255,30.707416971
2020,Florida,Okaloosa County,212820,1409,2733,2085,648,158,594,752,9,5221,12.884489818,9.82955041,3.054939408,0.7448772013,2.800361124,3.5452383253
2020,Florida,Okeechobee County,42297,156,529,498,31,46,77,123,2,3024,12.529903598,11.795637035,0.7342665624,1.0895568346,1.823823397,2.9133802316
2020,Florida,Orange County,1404396,9025,16684,9545,7139,8377,-6553,1824,62,35766,11.918134616,6.8184245332,5.099710083,5.9840693886,-4.68110382,1.3029655682
2020,Florida,Osceola County,385315,11145,4493,2723,1770,2594,6807,9401,-26,3288,11.831701745,7.1706485316,4.6610532137,6.8309446533,17.925304647,24.756249301
2020,Florida,Palm Beach County,1507600,9800,14865,16781,-1916,5962,5715,11677,39,21850,9.8921940507,11.167232315,-1.275038264,3.9675251214,3.8031543222,7.7706794437
2020,Florida,Pasco County,570412,16380,5194,7082,-1888,495,17889,18384,-116,5798,9.2383435725,12.596447667,-3.358104094,0.8804351306,31.818392023,32.698827154
2020,Florida,Pinellas County,976802,1435,7928,13821,-5893,1146,6206,7352,-24,19928,8.1222476128,14.159634745,-6.037387132,1.1740786786,6.3580560904,7.5321347691
2020,Florida,Polk County,744552,19585,8169,8009,160,1207,18329,19536,-111,13783,11.11792362,10.900165292,0.2177583277,1.6427143848,24.94557743,26.588291815
2020,Florida,Putnam County,74815,506,814,1064,-250,-5,765,760,-4,1422,10.917089134,14.270003487,-3.352914353,-0.067058287,10.259917921,10.192859634
2020,Florida,St. Johns County,278715,13647,2282,2330,-48,100,13690,13790,-95,2967,8.3930538468,8.5695948568,-0.17654101,0.3677937707,50.350967206,50.718760976
2020,Florida,St. Lucie County,337186,9123,3152,3913,-761,438,9494,9932,-48,3041,9.4761510352,11.76401618,-2.287865145,1.3168001756,28.542696043,29.859496219
2020,Florida,Santa Rosa County,189139,4552,1967,1855,112,-6,4474,4468,-28,6169,10.526428453,9.9270588613,0.5993695916,-0.032109085,23.94267458,23.910565495
2020,Florida,Sarasota County,443465,8459,2895,6732,-3837,561,11804,12365,-69,6003,6.5909973124,15.32663002,-8.735632707,1.2772191683,26.873966244,28.151185412
2020,Florida,Seminole County,474171,2380,4654,3972,682,1053,624,1677,21,3513,9.8397187202,8.3978003345,1.4419183857,2.2263050736,1.3192918954,3.545596969
2020,Florida,Sumter County,139018,5246,469,2269,-1800,2,7085,7087,-41,8264,3.4385424686,16.635507167,-13.1969647,0.0146632941,51.944719381,51.959382675
2020,Florida,Suwannee County,44851,431,458,617,-159,0,592,592,-2,2513,10.260890995,13.823078043,-3.562187048,0.0,13.26298574,13.26298574
2020,Florida,Taylor County,21600,63,234,262,-28,4,87,91,0,2428,10.849155018,12.147344507,-1.298189489,0.1854556413,4.0336601989,4.2191158402
2020,Florida,Union County,15182,-31,163,257,-94,2,60,62,1,4814,10.725448265,16.910676098,-6.185227834,0.1316005922,3.9480177661,4.0796183583
2020,Florida,Volusia County,561497,7432,4836,7812,-2976,672,9776,10448,-40,14480,8.6700694359,14.005496781,-5.335427345,1.2047739166,17.526591978,18.731365894
2020,Florida,Wakulla County,34319,683,325,306,19,2,664,666,-2,3248,9.5651534103,9.0059598264,0.559193584,0.0588624825,19.542344198,19.601206681
2020,Florida,Walton County,76648,2521,850,740,110,8,2418,2426,-15,2031,11.27507876,9.8159509202,1.4591278395,0.1061183883,32.074282872,32.18040126
2020,Florida,Washington County,25932,285,276,357,-81,11,356,367,-1,2620,10.702029896,13.842843018,-3.140813122,0.426530177,13.804067547,14.230597724
2020,Georgia,Georgia,10710017,81997,125818,94638,31180,13275,37563,50838,-21,268022,11.792837364,8.8703567249,2.9224806387,1.2442569108,3.5207549785,4.7650118893
2020,Georgia,Appling County,18325,-64,213,224,-11,3,-57,-54,1,416,11.603203138,12.202429591,-0.599226453,0.1634253963,-3.10508253,-2.941657134
2020,Georgia,Atkinson County,8393,124,134,81,53,26,44,70,1,21,16.084503661,9.7227223623,6.3617812988,3.1208738447,5.2814788141,8.4023526587
2020,Georgia,Bacon County,11036,-62,136,113,23,-4,-80,-84,-1,297,12.288786482,10.210535827,2.0782506551,-0.361434897,-7.228697931,-7.590132827
2020,Georgia,Baker County,2971,-76,24,25,-1,0,-74,-74,-1,0,7.9760717846,8.308408109,-0.332336324,0.0,-24.592888,-24.592888
2020,Georgia,Baldwin County,45099,93,390,510,-120,30,180,210,3,5819,8.6565673381,11.320126519,-2.663559181,0.6658897952,3.9953387714,4.6612285667
2020,Georgia,Banks County,19352,177,200,173,27,4,148,152,-2,0,10.382329276,8.9807148234,1.4016144522,0.2076465855,7.6829236639,7.8905702494
2020,Georgia,Barrow County,85588,2007,1094,725,369,101,1543,1644,-6,360,12.93381175,8.5713103465,4.3625014039,1.1940722,18.242112917,19.436185117
2020,Georgia,Bartow County,109426,1669,1236,1091,145,27,1500,1527,-3,1034,11.382106334,10.04682687,1.3352794648,0.2486382452,13.813235843,14.061874088
2020,Georgia,Ben Hill County,16614,-97,214,250,-36,9,-71,-62,1,298,12.843210803,15.003750938,-2.160540135,0.5401350338,-4.261065266,-3.720930233
2020,Georgia,Berrien County,19408,31,252,260,-8,1,36,37,2,199,12.994714451,13.407245069,-0.412530618,0.0515663272,1.8563877788,1.907954106
2020,Georgia,Bibb County,152737,-454,1993,1891,102,91,-650,-559,3,6719,13.029209487,12.362385921,0.6668235663,0.5949112209,-4.249365864,-3.654454643
2020,Georgia,Bleckley County,12955,32,135,121,14,9,9,18,0,1413,10.433572919,9.3515727645,1.0820001546,0.6955715279,0.6955715279,1.3911430559
2020,Georgia,Brantley County,19202,78,215,241,-26,4,98,102,2,89,11.219537651,12.576318948,-1.356781297,0.2087355842,5.1140218129,5.3227573971
2020,Georgia,Brooks County,15357,-161,155,215,-60,19,-120,-101,0,51,10.04048583,13.927125506,-3.886639676,1.2307692308,-7.773279352,-6.542510121
2020,Georgia,Bryan County,40755,1063,565,283,282,5,781,786,-5,120,14.046515097,7.0356880928,7.0108270041,0.1243054433,19.416510249,19.540815692
2020,Georgia,Bulloch County,80839,1121,893,636,257,86,775,861,3,6525,11.123775357,7.9224200751,3.2013552819,1.0712706391,9.6538923871,10.725163026
2020,Georgia,Burke County,22648,151,288,248,40,-2,113,111,0,296,12.758888027,10.986820246,1.7720677816,-0.088603389,5.006091483,4.9174880939
2020,Georgia,Butts County,25426,509,303,286,17,-3,497,494,-2,3014,12.037423276,11.362056294,0.6753669825,-0.119182409,19.744552371,19.625369962
2020,Georgia,Calhoun County,6231,47,49,49,0,2,45,47,0,1700,7.8936770036,7.8936770036,0.0,0.3221908981,7.2492952074,7.5714861055
2020,Georgia,Camden County,55388,604,733,425,308,22,272,294,2,2017,13.306466253,7.715208946,5.5912573068,0.3993755219,4.9377337254,5.3371092474
2020,Georgia,Candler County,10985,150,128,128,0,1,151,152,-2,267,11.732355637,11.732355637,0.0,0.0916590284,13.840513291,13.932172319
2020,Georgia,Carroll County,121633,1518,1545,1186,359,64,1093,1157,2,4114,12.781905124,9.811870212,2.9700349124,0.529476976,9.0424739812,9.5719509572
2020,Georgia,Catoosa County,67996,411,616,722,-106,2,516,518,-1,468,9.0868189496,10.650459873,-1.563640923,0.0295026589,7.6116860032,7.6411886621
2020,Georgia,Charlton County,13430,153,107,106,1,45,106,151,1,2571,8.0128805182,7.9379937844,0.0748867338,3.3699030217,7.9379937844,11.307896806
2020,Georgia,Chatham County,289463,-722,3528,2836,692,377,-1789,-1412,-2,14736,12.172904935,9.7852489787,2.3876559567,1.3007894446,-6.172711715,-4.87192227
2020,Georgia,Chattahoochee County,10551,-440,198,32,166,25,-626,-601,-5,2697,18.382694272,2.9709404883,15.411753783,2.3210472565,-58.1190233,-55.79797605
2020,Georgia,Chattooga County,24843,-3,307,312,-5,6,-6,0,2,1274,12.356859667,12.558111453,-0.201251786,0.2415021433,-0.241502143,0.0
2020,Georgia,Cherokee County,265274,5799,2695,1855,840,228,4740,4968,-9,1624,10.271577459,7.0700468224,3.2015306366,0.8689868871,18.065780021,18.934766908
2020,Georgia,Clarke County,127795,-443,1298,834,464,221,-1128,-907,0,10411,10.139317979,6.5147852035,3.6245327751,1.726339964,-8.81136416,-7.085024196
2020,Georgia,Clay County,2866,-35,31,44,-13,2,-23,-21,-1,57,10.750823652,15.25923357,-4.508409919,0.6936015259,-7.976417548,-7.282816022
2020,Georgia,Clayton County,292646,242,4046,1982,2064,302,-2132,-1830,8,4775,13.83129647,6.7754892744,7.055807196,1.032390394,-7.28826596,-6.255875566
2020,Georgia,Clinch County,6582,-55,91,78,13,10,-78,-68,0,126,13.768061124,11.801195249,1.9668658749,1.5129737499,-11.80119525,-10.2882215
2020,Georgia,Cobb County,762944,1884,8769,5210,3559,1474,-3199,-1725,50,9693,11.507843811,6.8372523957,4.6705914158,1.934378125,-4.198151711,-2.263773586
2020,Georgia,Coffee County,43218,-60,555,453,102,1,-164,-163,1,3277,12.832963374,10.474472808,2.358490566,0.0231224565,-3.792082871,-3.768960414
2020,Georgia,Colquitt County,45542,-27,586,504,82,-12,-99,-111,2,1231,12.863430321,11.063428126,1.8000021951,-0.263414955,-2.173173382,-2.436588337
2020,Georgia,Columbia County,160377,3248,1789,1138,651,95,2514,2609,-12,715,11.26907838,7.1683684718,4.1007099078,0.5984138882,15.835921211,16.434335099
2020,Georgia,Cook County,17291,50,211,211,0,0,50,50,0,143,12.220549056,12.220549056,0.0,0.0,2.8958647052,2.8958647052
2020,Georgia,Coweta County,150849,2345,1630,1211,419,108,1817,1925,1,637,10.890153097,8.0907824542,2.7993706427,0.7215561561,12.139514219,12.861070375
2020,Georgia,Crawford County,12231,-114,104,159,-55,-1,-58,-59,0,142,8.4635416667,12.939453125,-4.475911458,-0.081380208,-4.720052083,-4.801432292
2020,Georgia,Crisp County,22034,-348,237,317,-80,-1,-266,-267,-1,467,10.671829971,14.274135447,-3.602305476,-0.045028818,-11.97766571,-12.02269452
2020,Georgia,Dade County,16057,-46,145,198,-53,-3,9,6,1,984,9.0174129353,12.313432836,-3.2960199,-0.186567164,0.5597014925,0.3731343284
2020,Georgia,Dawson County,27113,1022,291,252,39,0,988,988,-5,110,10.939027141,9.472971957,1.4660551838,0.0,37.140064657,37.140064657
2020,Georgia,Decatur County,26457,-39,349,342,7,2,-48,-46,0,1053,13.181500576,12.917115178,0.2643853984,0.0755386852,-1.812928446,-1.737389761
2020,Georgia,DeKalb County,762009,2077,10514,5495,5019,3081,-6022,-2941,-1,11844,13.816567134,7.2210420772,6.5955250565,4.0487771865,-7.913578779,-3.864801592
2020,Georgia,Dodge County,20452,-220,206,295,-89,12,-143,-131,0,1818,10.018480693,14.346853419,-4.328372726,0.583600817,-6.954576403,-6.370975586
2020,Georgia,Dooly County,13174,-226,110,133,-23,1,-203,-202,-1,1876,8.2787687213,10.009783999,-1.731015278,0.0752615338,-15.27809137,-15.20282983
2020,Georgia,Dougherty County,86477,-1377,1169,1046,123,29,-1522,-1493,-7,4555,13.411269367,12.000160614,1.4111087529,0.3327004377,-17.46103676,-17.12833633
2020,Georgia,Douglas County,147988,1308,1669,1167,502,83,720,803,3,1252,11.328003041,7.920778639,3.4072244017,0.5633458672,4.8868557156,5.4502015828
2020,Georgia,Early County,10037,-139,124,159,-35,4,-108,-104,0,137,12.269331618,15.732449414,-3.463117795,0.3957848909,-10.68619205,-10.29040716
2020,Georgia,Echols County,4002,39,36,24,12,-2,30,28,-1,0,9.0395480226,6.0263653484,3.0131826742,-0.502197112,7.5329566855,7.0307595731
2020,Georgia,Effingham County,65765,1423,806,525,281,23,1124,1147,-5,607,12.38980224,8.0702806152,4.3195216245,0.3535551508,17.278086498,17.631641649
2020,Georgia,Elbert County,19335,130,214,282,-68,-1,200,199,-1,275,11.105345096,14.634146341,-3.528801245,-0.051894136,10.378827193,10.326933057
2020,Georgia,Emanuel County,22507,-93,288,303,-15,-4,-76,-80,2,1368,12.769636642,13.434721884,-0.665085242,-0.177356064,-3.369765225,-3.547121289
2020,Georgia,Evans County,10638,-23,130,125,5,7,-36,-29,1,404,12.207145875,11.737640265,0.4695056106,0.6573078548,-3.380440396,-2.723132541
2020,Georgia,Fannin County,26521,453,199,390,-191,-5,653,648,-4,160,7.5681226112,14.831999087,-7.263876476,-0.190153834,24.834090779,24.643936945
2020,Georgia,Fayette County,115821,1176,868,990,-122,119,1192,1311,-13,491,7.5325644564,8.5912889537,-1.058724497,1.0326902884,10.344259023,11.376949311
2020,Georgia,Floyd County,98604,279,1088,1252,-164,119,320,439,4,3725,11.049667647,12.715242549,-1.665574903,1.2085573989,3.249902249,4.4584596479
2020,Georgia,Forsyth County,250847,6223,2366,1522,844,410,4994,5404,-25,652,9.550508506,6.1436491742,3.4068593318,1.6549909076,20.158596568,21.813587475
2020,Georgia,Franklin County,23504,182,280,308,-28,23,188,211,-1,816,11.959167984,13.155084782,-1.195916798,0.9823602272,8.0297270747,9.0120873019
2020,Georgia,Fulton County,1077402,12383,12264,8114,4150,2455,5728,8183,50,34052,11.448730198,7.574608352,3.8741218463,2.291799791,5.3472216712,7.6390214622
2020,Georgia,Gilmer County,31978,403,326,411,-85,8,482,490,-2,171,10.259153777,12.93408651,-2.674932733,0.2517583749,15.168442088,15.420200463
2020,Georgia,Glascock County,2984,25,26,31,-5,0,31,31,-1,85,8.7497896685,10.432441528,-1.682651859,0.0,10.432441528,10.432441528
2020,Georgia,Glynn County,85568,242,898,1007,-109,51,298,349,2,1531,10.509438599,11.785083151,-1.275644552,0.5968612122,3.4875419851,4.0844031973
2020,Georgia,Gordon County,58780,734,684,641,43,39,652,691,0,669,11.709722151,10.973584647,0.7361375036,0.6676595963,11.161898892,11.829558489
2020,Georgia,Grady County,24491,-97,289,285,4,0,-103,-103,2,200,11.77693107,11.613928564,0.1630025062,0.0,-4.197314534,-4.197314534
2020,Georgia,Greene County,18837,481,178,252,-74,29,529,558,-3,177,9.5716935983,13.550937004,-3.979243406,1.5594332267,28.446212997,30.005646224
2020,Georgia,Gwinnett County,942627,5228,11123,5160,5963,2175,-2942,-767,32,4945,11.832815078,5.4892857865,6.3435292916,2.3137977879,-3.12974395,-0.815946162
2020,Georgia,Habersham County,46047,505,473,506,-33,78,461,539,-1,2380,10.328751269,11.049361823,-0.720610554,1.7032613087,10.066711068,11.769972377
2020,Georgia,Hall County,206591,2281,2546,1773,773,40,1459,1499,9,2962,12.392279406,8.6298159411,3.7624634644,0.1946940991,7.1014672634,7.2961613625
2020,Georgia,Hancock County,8494,19,53,136,-83,5,98,103,-1,1301,6.2466851317,16.029229772,-9.78254464,0.5893099181,11.550474394,12.139784313
2020,Georgia,Haralson County,30383,499,360,361,-1,0,504,504,-4,350,11.946836577,11.980022234,-0.033185657,0.0,16.725571208,16.725571208
2020,Georgia,Harris County,36080,892,314,385,-71,-1,973,972,-9,446,8.8118089465,10.80428804,-1.992479093,-0.028063086,27.3053825,27.277319414
2020,Georgia,Hart County,26406,151,246,349,-103,-3,257,254,0,662,9.3427773874,13.254590684,-3.911813296,-0.11393631,9.760543856,9.6466075464
2020,Georgia,Heard County,11973,148,117,135,-18,-1,168,167,-1,130,9.8327590554,11.345491218,-1.512732162,-0.084040676,14.118833515,14.03479284
2020,Georgia,Henry County,239139,4468,2657,1824,833,46,3612,3658,-23,982,11.215466115,7.6992887444,3.5161773707,0.1941706591,15.246617843,15.440788502
2020,Georgia,Houston County,160110,2683,1995,1415,580,54,2057,2111,-8,1546,12.565464812,8.9123472225,3.6531175894,0.3401178445,12.955970485,13.29608833
2020,Georgia,Irwin County,9387,-55,105,116,-11,2,-46,-44,0,1147,11.153008657,12.321419088,-1.168410431,0.2124382601,-4.886079983,-4.673641723
2020,Georgia,Jackson County,76199,3184,889,683,206,26,2972,2998,-20,716,11.915771979,9.1546369644,2.7611350141,0.3484927688,39.835404185,40.183896953
2020,Georgia,Jasper County,14483,276,140,134,6,1,272,273,-3,95,9.759498083,9.3412338794,0.4182642036,0.0697107006,18.961310561,19.031021262
2020,Georgia,Jeff Davis County,15213,112,194,165,29,4,79,83,0,112,12.799366629,10.886059247,1.9133073827,0.2639044666,5.212113215,5.4760176816
2020,Georgia,Jefferson County,15267,-77,188,237,-49,2,-31,-29,1,599,12.283166182,15.484629708,-3.201463526,0.1306719807,-2.0254157,-1.89474372
2020,Georgia,Jenkins County,8746,12,98,111,-13,14,10,24,1,1184,11.212814645,12.700228833,-1.487414188,1.6018306636,1.1441647597,2.7459954233
2020,Georgia,Johnson County,9667,-57,105,144,-39,-2,-16,-18,0,1692,10.829766386,14.852251044,-4.022484658,-0.206281265,-1.650250116,-1.856531381
2020,Georgia,Jones County,28787,98,231,322,-91,0,191,191,-2,306,8.0381376575,11.204676735,-3.166539077,0.0,6.6462523488,6.6462523488
2020,Georgia,Lamar County,19261,260,216,235,-19,12,267,279,0,1175,11.290575506,12.283727981,-0.993152475,0.6272541948,13.956405833,14.583660028
2020,Georgia,Lanier County,10737,156,127,123,4,11,141,152,0,260,11.914813772,11.539544047,0.3752697251,1.0319917441,13.22825781,14.260249554
2020,Georgia,Laurens County,47512,-55,620,634,-14,6,-49,-43,2,1184,13.041786304,13.336278253,-0.294491949,0.1262108352,-1.030721821,-0.904510986
2020,Georgia,Lee County,30234,189,334,277,57,5,127,132,0,907,11.08180295,9.190597057,1.8912058926,0.1658952537,4.2137394449,4.3796346987
2020,Georgia,Liberty County,63004,191,1429,390,1039,37,-880,-843,-5,2349,22.715531288,6.1994801974,16.51605109,0.5881558136,-13.9885707,-13.40041489
2020,Georgia,Lincoln County,8031,62,78,110,-32,3,92,95,-1,67,9.75,13.75,-4.0,0.375,11.5,11.875
2020,Georgia,Long County,20171,524,261,116,145,2,379,381,-2,330,13.109648903,5.8265106233,7.2831382792,0.1004570797,19.036616606,19.137073685
2020,Georgia,Lowndes County,118268,668,1639,1046,593,73,-9,64,11,6067,13.897603744,8.8693676124,5.0282361321,0.6189902827,-0.07631387,0.5426764122
2020,Georgia,Lumpkin County,34186,494,286,328,-42,-3,541,538,-2,3054,8.4268835263,9.6643978903,-1.237514364,-0.088393883,15.940363594,15.85196971
2020,Georgia,McDuffie County,21162,-155,270,288,-18,-13,-124,-137,0,265,12.712163657,13.559641234,-0.847477577,-0.612067139,-5.838178865,-6.450246004
2020,Georgia,McIntosh County,14387,93,103,143,-40,2,131,133,0,71,7.182455284,9.9717583069,-2.789303023,0.1394651511,9.1349674,9.2744325512
2020,Georgia,Macon County,12712,-222,131,180,-49,0,-174,-174,1,1893,10.216018092,14.037276768,-3.821258676,0.0,-13.56936754,-13.56936754
2020,Georgia,Madison County,30457,532,355,320,35,2,498,500,-3,248,11.758471068,10.599185188,1.1592858799,0.0662449074,16.494981948,16.561226856
2020,Georgia,Marion County,8516,103,83,108,-25,3,126,129,-1,75,9.8056589285,12.759170654,-2.953511725,0.3544214071,14.885699096,15.240120503
2020,Georgia,Meriwether County,21164,52,234,307,-73,-1,127,126,-1,245,11.070110701,14.523606775,-3.453496073,-0.047308165,6.0081370044,5.9608288391
2020,Georgia,Miller County,5622,-45,66,91,-25,0,-19,-19,-1,127,11.692798299,16.121888564,-4.429090265,0.0,-3.366108601,-3.366108601
2020,Georgia,Mitchell County,21602,-244,215,259,-44,10,-208,-198,-2,2108,9.8968882342,11.922297919,-2.025409685,0.460320383,-9.574663966,-9.114343583
2020,Georgia,Monroe County,28042,365,245,346,-101,4,466,470,-4,1153,8.7941276764,12.419461943,-3.625334267,0.1435775947,16.726789784,16.870367379
2020,Georgia,Montgomery County,9012,-136,98,98,0,5,-140,-135,-1,806,10.792951542,10.792951542,0.0,0.550660793,-15.4185022,-14.86784141
2020,Georgia,Morgan County,19636,397,210,168,42,3,353,356,-1,163,10.803858521,8.6430868167,2.1607717042,0.154340836,18.160771704,18.31511254
2020,Georgia,Murray County,40032,36,465,455,10,2,22,24,2,273,11.620932674,11.371020143,0.2499125306,0.0499825061,0.5498075674,0.5997900735
2020,Georgia,Muscogee County,196442,368,2794,2102,692,145,-481,-336,12,6861,14.236362339,10.710391424,3.5259709158,0.7388233855,-2.450855507,-1.712032121
2020,Georgia,Newton County,113295,1401,1401,1049,352,45,1006,1051,-2,1649,12.442881313,9.3166184849,3.1262628281,0.399664282,8.9347170599,9.3343813419
2020,Georgia,Oconee County,41124,828,345,293,52,28,755,783,-7,147,8.4745762712,7.1972488332,1.277327438,0.6877916974,18.54581184,19.233603537
2020,Georgia,Oglethorpe County,15383,161,146,189,-43,0,205,205,-1,218,9.5409246855,12.350923052,-2.809998366,0.0,13.396503839,13.396503839
2020,Georgia,Paulding County,173359,4057,1887,1235,652,42,3378,3420,-15,529,11.013800812,7.2082904095,3.8055104024,0.2451402406,19.716279355,19.961419595
2020,Georgia,Peach County,27950,253,333,302,31,1,221,222,0,1440,11.968300178,10.854134095,1.1141660826,0.0359408414,7.9429259439,7.9788667853
2020,Georgia,Pickens County,33127,479,301,398,-97,-1,581,580,-4,398,9.152413531,12.10186241,-2.949448879,-0.030406689,17.666286583,17.635879894
2020,Georgia,Pierce County,19522,79,250,253,-3,-4,84,80,2,149,12.832028744,12.986013089,-0.153984345,-0.20531246,4.3115616579,4.106249198
2020,Georgia,Pike County,19121,168,209,217,-8,1,176,177,-1,257,10.978620581,11.398854862,-0.420234281,0.0525292851,9.2451541735,9.2976834585
2020,Georgia,Polk County,42840,224,574,557,17,7,199,206,1,386,13.433813893,13.035948324,0.3978655682,0.1638269987,4.6573675342,4.8211945329
2020,Georgia,Pulaski County,11191,30,102,145,-43,0,72,72,1,1237,9.1267000716,12.974230494,-3.847530422,0.0,6.4423765211,6.4423765211
2020,Georgia,Putnam County,22520,437,230,307,-77,2,515,517,-3,157,10.313207632,13.765890187,-3.452682555,0.0896800664,23.092617089,23.182297155
2020,Georgia,Quitman County,2271,-29,18,39,-21,0,-7,-7,-1,0,7.8757383505,17.064099759,-9.188361409,0.0,-3.062787136,-3.062787136
2020,Georgia,Rabun County,17273,157,154,254,-100,4,253,257,0,448,8.956352322,14.772165518,-5.815813196,0.2326325278,14.714007386,14.946639914
2020,Georgia,Randolph County,6682,-124,58,83,-25,0,-97,-97,-2,350,8.6002372479,12.307236062,-3.706998814,0.0,-14.3831554,-14.3831554
2020,Georgia,Richmond County,202079,-560,2817,2254,563,125,-1250,-1125,2,12830,13.920804115,11.138619977,2.7821841381,0.6177140626,-6.177140626,-5.559426564
2020,Georgia,Rockdale County,90939,300,954,805,149,6,141,147,4,766,10.507880911,8.8667129278,1.6411679829,0.0660873013,1.5530515811,1.6191388825
2020,Georgia,Schley County,5196,-58,50,45,5,10,-75,-65,2,0,9.5693779904,8.6124401914,0.956937799,1.9138755981,-14.35406699,-12.44019139
2020,Georgia,Screven County,14012,67,175,190,-15,1,79,80,2,479,12.519225954,13.592302464,-1.07307651,0.071538434,5.6515362879,5.7230747219
2020,Georgia,Seminole County,8060,-30,86,115,-29,0,0,0,-1,52,10.650154799,14.241486068,-3.591331269,0.0,0.0,0.0
2020,Georgia,Spalding County,67414,579,848,872,-24,-4,607,603,0,1379,12.633241216,12.990785779,-0.357544563,-0.05959076,9.0428978987,8.9833071382
2020,Georgia,Stephens County,26107,90,311,385,-74,3,162,165,-1,567,11.933082649,14.772465659,-2.83938301,0.115110122,6.2159465889,6.3310567109
2020,Georgia,Stewart County,6689,40,40,70,-30,141,-72,69,1,1699,5.9979007347,10.496326286,-4.498425551,21.14260009,-10.79622132,10.346378767
2020,Georgia,Sumter County,29282,-119,338,363,-25,18,-113,-95,1,1604,11.519520134,12.371555646,-0.852035513,0.6134655692,-3.851200518,-3.237734949
2020,Georgia,Talbot County,6143,-45,56,101,-45,0,2,2,-2,0,9.0827994485,16.381477577,-7.298678128,0.0,0.3243856946,0.3243856946
2020,Georgia,Taliaferro County,1562,13,13,30,-17,1,29,30,0,7,8.3574413372,19.286403086,-10.92896175,0.6428801029,18.643522983,19.286403086
2020,Georgia,Tattnall County,25365,48,247,280,-33,40,39,79,2,4446,9.7470502348,11.049287716,-1.302237481,1.5784696737,1.5390079318,3.1174776055
2020,Georgia,Taylor County,8074,23,84,88,-4,0,29,29,-2,214,10.418604651,10.914728682,-0.496124031,0.0,3.5968992248,3.5968992248
2020,Georgia,Telfair County,15781,-32,124,178,-54,39,-19,20,2,3133,7.8495916946,11.267962271,-3.418370577,2.4688231943,-1.202760018,1.2660631766
2020,Georgia,Terrell County,8523,-50,107,109,-2,0,-48,-48,0,267,12.517547964,12.751520824,-0.233972859,0.0,-5.61534862,-5.61534862
2020,Georgia,Thomas County,44372,-55,521,577,-56,6,-7,-1,2,651,11.734366378,12.995641843,-1.261275465,0.1351366569,-0.157659433,-0.022522776
2020,Georgia,Tift County,40719,66,537,466,71,5,-12,-7,2,1588,13.198643268,11.453571253,1.7450720149,0.1228923954,-0.294941749,-0.172049354
2020,Georgia,Toombs County,26973,129,364,350,14,-9,124,115,0,390,13.52732408,13.007042384,0.5202816954,-0.334466804,4.6082093019,4.2737424977
2020,Georgia,Towns County,12247,238,100,193,-93,6,325,331,0,1167,8.2453825858,15.913588391,-7.668205805,0.4947229551,26.797493404,27.292216359
2020,Georgia,Treutlen County,6822,-38,69,82,-13,0,-25,-25,0,494,10.086244701,11.986551674,-1.900306973,0.0,-3.654436486,-3.654436486
2020,Georgia,Troup County,70214,155,910,810,100,85,-33,52,3,2162,12.974699336,11.5489082,1.4257911359,1.2119224655,-0.470511075,0.7414113906
2020,Georgia,Turner County,7882,-47,124,127,-3,-1,-44,-45,1,393,15.685282398,16.064765037,-0.379482639,-0.126494213,-5.565745367,-5.69223958
2020,Georgia,Twiggs County,8103,-61,69,148,-79,13,5,18,0,106,8.4834327165,18.196348435,-9.712915719,1.5983279031,0.6147415012,2.2130694043
2020,Georgia,Union County,25358,752,169,316,-147,-1,905,904,-5,296,6.7648707069,12.649107357,-5.88423665,-0.040028821,36.22608278,36.186053959
2020,Georgia,Upson County,26527,125,298,425,-127,4,249,253,-1,414,11.260367662,16.059249183,-4.798881521,0.1511458747,9.4088306977,9.5599765724
2020,Georgia,Walker County,70116,347,731,887,-156,24,478,502,1,1353,10.451442256,12.681845802,-2.230403546,0.343139007,6.8341852236,7.1773242306
2020,Georgia,Walton County,96875,2057,1157,985,172,14,1878,1892,-7,792,12.071384975,10.27684892,1.794536055,0.1460668882,19.593829717,19.739896606
2020,Georgia,Ware County,35826,10,503,488,15,4,-11,-7,2,2471,14.042042377,13.623293599,0.4187487786,0.111666341,-0.307082438,-0.195416097
2020,Georgia,Warren County,5232,12,59,72,-13,0,24,24,1,89,11.28970532,13.777267509,-2.487562189,0.0,4.5924225029,4.5924225029
2020,Georgia,Washington County,20150,-202,222,257,-35,1,-168,-167,0,1879,10.962421609,12.690731322,-1.728309713,0.0493802775,-8.295886623,-8.246506345
2020,Georgia,Wayne County,30023,6,348,362,-14,7,11,18,2,2062,11.592271819,12.058627582,-0.466355763,0.2331778814,0.3664223851,0.5996002665
2020,Georgia,Webster County,2595,22,20,24,-4,-2,28,26,0,0,7.7399380805,9.2879256966,-1.547987616,-0.773993808,10.835913313,10.061919505
2020,Georgia,Wheeler County,7751,-119,63,67,-4,0,-114,-114,-1,2510,8.0660649126,8.5781960182,-0.512131106,0.0,-14.59573651,-14.59573651
2020,Georgia,White County,31094,493,280,375,-95,5,588,593,-5,823,9.0769106086,12.156576708,-3.079666099,0.1620876894,19.061512278,19.223599968
2020,Georgia,Whitfield County,103837,-428,1250,941,309,-4,-736,-740,3,1126,12.013339612,9.0436420601,2.9696975522,-0.038442687,-7.073454364,-7.11189705
2020,Georgia,Wilcox County,8502,-105,76,110,-34,1,-72,-71,0,1849,8.8842129873,12.858729324,-3.974516336,0.1168975393,-8.41662283,-8.299725291
2020,Georgia,Wilkes County,9694,-75,95,163,-68,3,-11,-8,1,182,9.7621127267,16.749730257,-6.987617531,0.308277244,-1.130349895,-0.822072651
2020,Georgia,Wilkinson County,8812,-124,96,138,-42,0,-82,-82,0,179,10.818120352,15.551048005,-4.732927654,0.0,-9.2404778,-9.2404778
2020,Georgia,Worth County,19972,-213,196,275,-79,4,-138,-134,0,177,9.7616853849,13.696242249,-3.934556864,0.1992180691,-6.873023383,-6.673805314
2020,Hawaii,Hawaii,1407006,-8609,16420,13768,2652,2187,-13375,-11188,-73,42318,11.634576516,9.7554719532,1.8791045627,1.5496235591,-9.477007363,-7.927383804
2020,Hawaii,Hawaii County,203340,1175,2078,2227,-149,382,943,1325,-1,3929,10.248948842,10.983834971,-0.73488613,1.88407048,4.6509907399,6.53506122
2020,Hawaii,Honolulu County,963826,-9665,11793,9226,2567,1376,-13530,-12154,-78,34383,12.174569263,9.5245125088,2.6500567537,1.4205212673,-13.96777089,-12.54724962
2020,Hawaii,Kalawao County,87,0,0,0,0,0,0,0,0,3,0.0,0.0,0.0,0.0,0.0,0.0
2020,Hawaii,Kauai County,71851,-339,755,760,-5,91,-426,-335,1,1158,10.483126332,10.55255101,-0.069424678,1.2635291341,-5.91498254,-4.651453406
2020,Hawaii,Maui County,167902,220,1794,1555,239,338,-362,-24,5,2845,10.691808906,9.2674263374,1.4243825689,2.0143987794,-2.157433012,-0.143034233
2020,Idaho,Idaho,1826913,37853,21656,14637,7019,678,30283,30961,-127,30633,11.977965543,8.0957462901,3.8822192533,0.3750028001,16.749571969,17.124574769
2020,Idaho,Ada County,494399,12519,4912,3426,1486,145,10923,11068,-35,11296,10.062697241,7.0184854944,3.0442117468,0.2970462337,22.376800075,22.673846308
2020,Idaho,Adams County,4447,182,32,28,4,1,178,179,-1,21,7.3461891644,6.4279155188,0.9182736455,0.2295684114,40.863177227,41.092745638
2020,Idaho,Bannock County,88795,973,1092,734,358,79,533,612,3,2010,12.365740557,8.3117706676,4.0539698896,0.8945911209,6.0356590815,6.9302502024
2020,Idaho,Bear Lake County,6143,12,73,62,11,4,-3,1,0,31,11.895062734,10.102656021,1.7924067134,0.6517842594,-0.488838195,0.1629460649
2020,Idaho,Benewah County,9430,127,94,126,-32,3,158,161,-2,71,10.035765761,13.452196658,-3.416430897,0.3202903966,16.868627556,17.188917952
2020,Idaho,Bingham County,47202,430,609,392,217,11,200,211,2,338,12.961031775,8.3427330964,4.6182986784,0.2341073063,4.2564964777,4.490603784
2020,Idaho,Blaine County,23426,414,186,136,50,126,238,364,0,258,8.0106809079,5.8572720617,2.1534088462,5.4265902924,10.250226108,15.6768164
2020,Idaho,Boise County,8065,162,47,66,-19,9,175,184,-3,34,5.8867735471,8.2665330661,-2.379759519,1.127254509,21.918837675,23.046092184
2020,Idaho,Bonner County,46817,1043,418,502,-84,3,1130,1133,-6,406,9.028955298,10.843386506,-1.814431208,0.0648011146,24.408419825,24.473220939
2020,Idaho,Bonneville County,122134,2848,1841,936,905,25,1927,1952,-9,1285,15.251429045,7.7541214481,7.4973075967,0.2071079447,15.963880374,16.170988319
2020,Idaho,Boundary County,12656,316,153,137,16,3,299,302,-2,67,12.241958713,10.961753881,1.2802048328,0.2400384061,23.923827812,24.163866219
2020,Idaho,Butte County,2646,26,21,25,-4,0,30,30,0,18,7.9756931257,9.4948727687,-1.519179643,0.0,11.393847322,11.393847322
2020,Idaho,Camas County,1130,39,6,11,-5,0,45,45,-1,0,5.4029716344,9.9054479964,-4.502476362,0.0,40.522287258,40.522287258
2020,Idaho,Canyon County,237053,6783,3007,1683,1324,-24,5501,5477,-18,3509,12.869043467,7.2027270218,5.6663164449,-0.102712685,23.542603296,23.439890611
2020,Idaho,Caribou County,7123,-26,92,67,25,11,-61,-50,-1,32,12.892376682,9.3890134529,3.5033632287,1.5414798206,-8.548206278,-7.006726457
2020,Idaho,Cassia County,24277,225,384,201,183,17,23,40,2,286,15.89107989,8.3179871299,7.57309276,0.7035113493,0.9518094726,1.6553208219
2020,Idaho,Clark County,852,14,12,2,10,2,2,4,0,2,14.201183432,2.3668639053,11.834319527,2.3668639053,2.3668639053,4.7337278107
2020,Idaho,Clearwater County,8846,85,64,99,-35,2,119,121,-1,740,7.2698358607,11.245527347,-3.975691486,0.2271823706,13.517351054,13.744533424
2020,Idaho,Custer County,4249,-24,27,38,-11,0,-12,-12,-1,21,6.3365407181,8.9180943441,-2.581553626,0.0,-2.816240319,-2.816240319
2020,Idaho,Elmore County,27448,75,419,211,208,30,-163,-133,0,699,15.286112986,7.6977800478,7.5883329381,1.0944710968,-5.946626293,-4.852155196
2020,Idaho,Franklin County,14215,317,203,98,105,-7,220,213,-1,102,14.441717355,6.9718635507,7.4698538043,-0.497990254,15.651122257,15.153132003
2020,Idaho,Fremont County,13218,113,180,97,83,2,27,29,1,458,13.676252707,7.3699806253,6.3062720814,0.1519583634,2.051437906,2.2033962694
2020,Idaho,Gem County,18703,529,190,211,-21,4,549,553,-3,147,10.304525856,11.443447135,-1.138921279,0.2169373864,29.77465629,29.991593676
2020,Idaho,Gooding County,15618,328,188,119,69,40,219,259,0,31,12.16513524,7.7002717743,4.4648634658,2.5883266468,14.171088391,16.759415038
2020,Idaho,Idaho County,16823,200,152,192,-40,2,239,241,-1,524,9.0892782396,11.481193566,-2.391915326,0.1195957663,14.291694074,14.41128984
2020,Idaho,Jefferson County,30581,663,439,163,276,5,384,389,-2,175,14.512636573,5.3885188185,9.124117754,0.1652919883,12.694424701,12.85971669
2020,Idaho,Jerome County,24578,92,356,170,186,90,-185,-95,1,152,14.511658242,6.9297244415,7.5819338008,3.6686776455,-7.541170716,-3.87249307
2020,Idaho,Kootenai County,170628,4972,1785,1675,110,-55,4945,4890,-28,1467,10.61602693,9.9618179872,0.6542089424,-0.327104471,29.40966564,29.082561169
2020,Idaho,Latah County,40830,458,394,229,165,75,215,290,3,2774,9.704194478,5.6402551661,4.0639393118,1.8472451417,5.295436073,7.1426812147
2020,Idaho,Lemhi County,8054,-13,75,103,-28,-3,20,17,-2,80,9.3046337076,12.778363625,-3.473729917,-0.372185348,2.4812356554,2.1090503071
2020,Idaho,Lewis County,3838,-7,34,41,-7,2,-1,1,-1,74,8.8507093583,10.672914226,-1.822204868,0.5206299623,-0.260314981,0.2603149811
2020,Idaho,Lincoln County,5358,33,63,37,26,15,-8,7,0,37,11.794439764,6.9268931948,4.8675465693,2.8081999438,-1.497706637,1.3104933071
2020,Idaho,Madison County,40318,113,1131,150,981,29,-891,-862,-6,624,28.091352781,3.7256436049,24.365709176,0.720291097,-22.13032301,-21.41003192
2020,Idaho,Minidoka County,21216,306,306,209,97,-11,221,210,-1,82,14.527845036,9.922613113,4.6052319233,-0.522242795,10.492332526,9.9700897308
2020,Idaho,Nez Perce County,40755,154,444,489,-45,-1,199,198,1,1062,10.914990904,12.021239982,-1.106249078,-0.024583313,4.8920792566,4.8674959438
2020,Idaho,Oneida County,4520,20,56,38,18,-1,4,3,-1,50,12.416851441,8.4257206208,3.9911308204,-0.22172949,0.8869179601,0.6651884701
2020,Idaho,Owyhee County,12133,310,145,109,36,-2,280,278,-4,160,12.105526799,9.1000166973,3.0055101019,-0.166972783,23.376189681,23.209216898
2020,Idaho,Payette County,24771,720,304,248,56,-21,688,667,-3,149,12.453402155,10.159354389,2.2940477654,-0.860267912,28.184015403,27.323747491
2020,Idaho,Power County,7643,7,110,67,43,-10,-26,-36,0,47,14.398848092,8.7702074743,5.6286406178,-1.30898619,-3.403364095,-4.712350285
2020,Idaho,Shoshone County,12911,43,141,189,-48,3,89,92,-1,160,10.939136506,14.66309787,-3.723961364,0.2327475852,6.9048450289,7.1375926141
2020,Idaho,Teton County,12501,405,128,67,61,17,329,346,-2,7,10.407773306,5.4478188397,4.959954466,1.3822823922,26.751229825,28.133512217
2020,Idaho,Twin Falls County,88411,1284,1155,850,305,70,908,978,1,962,13.159543802,9.6845127551,3.4750310474,0.7975481092,10.345338331,11.142886441
2020,Idaho,Valley County,11792,349,96,94,2,-4,354,350,-3,66,8.2633957392,8.0912416613,0.1721540779,-0.344308156,30.471271788,30.126963632
2020,Idaho,Washington County,10360,234,92,110,-18,-8,262,254,-2,119,8.9817436298,10.739041296,-1.757297667,-0.781021185,25.578443815,24.79742263
2020,Illinois,Illinois,12587530,-79487,140833,118232,22601,11164,-113205,-102041,-47,296880,11.153080671,9.363224769,1.789855902,0.8841180165,-8.965118242,-8.081000225
2020,Illinois,Adams County,64783,-619,737,900,-163,17,-472,-455,-1,2018,11.322348965,13.826477705,-2.50412874,0.2611668011,-7.251219419,-6.990052617
2020,Illinois,Alexander County,5497,-294,43,84,-41,0,-251,-251,-2,132,7.6187101347,14.883061658,-7.264351524,0.0,-44.47200567,-44.47200567
2020,Illinois,Bond County,16262,-196,147,177,-30,5,-171,-166,0,1602,8.9853300733,10.819070905,-1.833740831,0.3056234719,-10.45232274,-10.14669927
2020,Illinois,Boone County,52777,-504,501,414,87,-9,-580,-589,-2,310,9.4476607139,7.8070489732,1.6406117407,-0.169718456,-10.9374116,-11.10713006
2020,Illinois,Brown County,6546,-73,64,61,3,5,-80,-75,-1,1985,9.7227497152,9.2669958223,0.4557538929,0.7595898215,-12.15343714,-11.39384732
2020,Illinois,Bureau County,32303,-318,298,406,-108,10,-220,-210,0,457,9.1799642659,12.506931181,-3.326966915,0.3080524921,-6.777154827,-6.469102335
2020,Illinois,Calhoun County,4616,-124,36,68,-32,0,-92,-92,0,90,7.6955964087,14.53612655,-6.840530141,0.0,-19.66652416,-19.66652416
2020,Illinois,Carroll County,14241,-97,129,201,-72,2,-26,-24,-1,223,9.027607684,14.066272438,-5.038664754,0.1399629098,-1.819517828,-1.679554918
2020,Illinois,Cass County,11925,-216,159,145,14,35,-263,-228,-2,184,13.213662428,12.050195296,1.1634671321,2.9086678301,-21.85656112,-18.94789329
2020,Illinois,Champaign County,209192,-420,2200,1528,672,1030,-2126,-1096,4,16384,10.506107869,7.2969694654,3.2091384036,4.9187686842,-10.1527206,-5.23395192
2020,Illinois,Christian County,32075,-352,340,395,-55,3,-298,-295,-2,1596,10.542308766,12.247682242,-1.705373477,0.0930203715,-9.240023565,-9.147003194
2020,Illinois,Clark County,15268,-197,185,214,-29,0,-167,-167,-1,221,12.03917613,13.926398334,-1.887222204,0.0,-10.86779683,-10.86779683
2020,Illinois,Clay County,13079,-98,153,192,-39,-1,-59,-60,1,305,11.654478976,14.625228519,-2.970749543,-0.076173065,-4.494210847,-4.570383912
2020,Illinois,Clinton County,37398,-42,388,422,-34,5,-15,-10,2,2071,10.369063845,11.277693151,-0.908629306,0.1336219568,-0.40086587,-0.267243914
2020,Illinois,Coles County,50383,-391,461,518,-57,30,-364,-334,0,3296,9.1145447176,10.241505778,-1.126961061,0.5931374003,-7.19673379,-6.60359639
2020,Illinois,Cook County,5108284,-37042,60224,46387,13837,6356,-57179,-50823,-56,90933,11.746887194,9.0479353125,2.6989518813,1.2397584851,-11.15295003,-9.913191549
2020,Illinois,Crawford County,18512,-174,190,247,-57,-1,-117,-118,1,1493,10.215602989,13.280283886,-3.064680897,-0.053766332,-6.290660788,-6.34442712
2020,Illinois,Cumberland County,10649,-84,105,121,-16,0,-68,-68,0,117,9.8213450566,11.31793097,-1.496585913,0.0,-6.360490132,-6.360490132
2020,Illinois,DeKalb County,104491,-640,1084,776,308,156,-1106,-950,2,5647,10.34242589,7.4038030359,2.9386228545,1.4883933938,-10.55232752,-9.063934129
2020,Illinois,De Witt County,15368,-256,169,228,-59,-1,-195,-196,-1,249,10.906040268,14.713474445,-3.807434177,-0.064532783,-12.58389262,-12.6484254
2020,Illinois,Douglas County,19510,60,230,186,44,-1,17,16,0,168,11.80698152,9.5482546201,2.2587268994,-0.051334702,0.8726899384,0.8213552361
2020,Illinois,DuPage County,917481,-5280,9987,7223,2764,1189,-9244,-8055,11,12825,10.854007245,7.8500545037,3.003952741,1.2922213491,-10.04650475,-8.754283404
2020,Illinois,Edgar County,16858,-311,165,242,-77,2,-233,-231,-3,283,9.6981808564,14.223998589,-4.525817733,0.1175537074,-13.69500691,-13.5774532
2020,Illinois,Edwards County,6356,-49,92,70,22,1,-72,-71,0,52,14.418932686,10.970927043,3.4480056422,0.1567275292,-11.2843821,-11.12765457
2020,Illinois,Effingham County,34065,-44,435,355,80,18,-142,-124,0,440,12.761463314,10.414527532,2.346935782,0.5280605509,-4.165811013,-3.637750462
2020,Illinois,Fayette County,21264,-68,220,223,-3,2,-68,-66,1,1651,10.329608414,10.47046671,-0.140858297,0.093905531,-3.192788055,-3.098882524
2020,Illinois,Ford County,12949,-23,141,180,-39,0,16,16,0,411,10.879209907,13.888353073,-3.009143166,0.0,1.2345202731,1.2345202731
2020,Illinois,Franklin County,38060,-470,455,557,-102,5,-371,-366,-2,517,11.881446664,14.544979762,-2.663533098,0.130565348,-9.687948818,-9.55738347
2020,Illinois,Fulton County,33690,-550,297,479,-182,2,-368,-366,-2,2685,8.7442955984,14.102752834,-5.358457235,0.0588841454,-10.83468276,-10.77579862
2020,Illinois,Gallatin County,4793,-40,33,78,-45,0,6,6,-1,25,6.8564305007,16.206108456,-9.349677956,0.0,1.2466237274,1.2466237274
2020,Illinois,Greene County,12702,-220,133,177,-44,0,-177,-177,1,284,10.380892913,13.815173275,-3.434280362,0.0,-13.81517328,-13.81517328
2020,Illinois,Grundy County,50993,-38,560,451,109,12,-160,-148,1,254,10.977809143,8.8410570062,2.1367521368,0.2352387673,-3.136516898,-2.901278131
2020,Illinois,Hamilton County,8084,-49,81,117,-36,3,-16,-13,0,117,9.9895171733,14.429302584,-4.43978541,0.3699821175,-1.97323796,-1.603255843
2020,Illinois,Hancock County,17422,-278,179,218,-39,1,-237,-236,-3,223,10.193041399,12.413871647,-2.220830249,0.0569443654,-13.49581459,-13.43887022
2020,Illinois,Hardin County,3808,-40,33,68,-35,0,-5,-5,0,17,8.6206896552,17.76384535,-9.143155695,0.0,-1.306165099,-1.306165099
2020,Illinois,Henderson County,6535,-174,62,92,-30,1,-144,-143,-1,51,9.362730293,13.893083661,-4.530353368,0.1510117789,-21.74569616,-21.59468439
2020,Illinois,Henry County,48411,-522,479,614,-135,-2,-384,-386,-1,722,9.8413872452,12.615055884,-2.773668639,-0.041091387,-7.889546351,-7.930637738
2020,Illinois,Iroquois County,26711,-382,292,341,-49,0,-331,-331,-2,468,10.854211583,12.675637499,-1.821425916,0.0,-12.30391792,-12.30391792
2020,Illinois,Jackson County,56675,-169,605,509,96,121,-387,-266,1,3587,10.659008624,8.9676618011,1.691346823,2.1318017248,-6.81824188,-4.686440155
2020,Illinois,Jasper County,9465,-153,116,97,19,2,-172,-170,-2,54,12.157417597,10.166116439,1.9913011581,0.2096106482,-18.02651575,-17.8169051
2020,Illinois,Jefferson County,37235,-400,423,467,-44,10,-367,-357,1,2143,11.299585949,12.474956591,-1.175370642,0.2671296915,-9.803659677,-9.536529985
2020,Illinois,Jersey County,21616,-51,211,220,-9,5,-48,-43,1,795,9.7497862902,10.165653952,-0.415867662,0.2310375898,-2.217960862,-1.986923272
2020,Illinois,Jo Daviess County,21239,15,156,267,-111,-3,130,127,-1,167,7.3475731814,12.575654099,-5.228080918,-0.141299484,6.1229776511,5.9816781669
2020,Illinois,Johnson County,12358,-22,100,154,-54,1,32,33,-1,1272,8.0847279489,12.450481041,-4.365753092,0.0808472795,2.5871129436,2.6679602231
2020,Illinois,Kane County,531010,-1283,6211,3815,2396,-24,-3664,-3688,9,6819,11.682464923,7.1757532895,4.5067116335,-0.045142354,-6.891732648,-6.936875002
2020,Illinois,Kankakee County,108594,-975,1205,1280,-75,14,-914,-900,0,6270,11.046786119,11.734345421,-0.687559302,0.128344403,-8.379056027,-8.250711624
2020,Illinois,Kendall County,130638,1738,1482,660,822,62,854,916,0,208,11.420292982,5.0859604374,6.3343325448,0.4777720411,6.580924566,7.058696607
2020,Illinois,Knox County,49053,-616,530,617,-87,54,-580,-526,-3,3931,10.737221693,12.499746764,-1.76252507,1.0939810782,-11.75016714,-10.65618606
2020,Illinois,Lake County,693593,-3541,6927,5168,1759,542,-5843,-5301,1,18830,9.9616962927,7.4320840826,2.52961221,0.7794484467,-8.402799399,-7.623350952
2020,Illinois,LaSalle County,107571,-946,1059,1270,-211,8,-743,-735,0,3384,9.8015623265,11.754470401,-1.952908074,0.074043908,-6.876827959,-6.802784051
2020,Illinois,Lawrence County,15467,-198,143,220,-77,-1,-120,-121,0,2419,9.1866889374,14.133367596,-4.946678659,-0.06424258,-7.709109598,-7.773352178
2020,Illinois,Lee County,33647,-414,326,428,-102,0,-311,-311,-1,3033,9.6295858687,12.642523779,-3.01293791,0.0,-9.186506764,-9.186506764
2020,Illinois,Livingston County,35414,-143,427,389,38,4,-185,-181,0,2310,12.033083936,10.962224007,1.0708599287,0.1127220978,-5.213397021,-5.100674924
2020,Illinois,Logan County,28383,-250,287,317,-30,9,-227,-218,-2,4142,10.067349516,11.119685702,-1.052336186,0.3157008559,-7.962677143,-7.646976287
2020,Illinois,McDonough County,29295,-497,246,308,-62,55,-487,-432,-3,3326,8.3267046897,10.425305059,-2.098600369,1.8616616176,-16.48416741,-14.6225058
2020,Illinois,McHenry County,305888,-1551,2957,2389,568,-28,-2092,-2120,1,1648,9.6424908735,7.7902978346,1.8521930389,-0.091305291,-6.821809573,-6.913114864
2020,Illinois,McLean County,171256,-16,1752,1318,434,323,-781,-458,8,10506,10.229820628,7.6957212257,2.5340994021,1.8859772048,-4.560211136,-2.674233931
2020,Illinois,Macon County,103015,-997,1234,1245,-11,20,-1003,-983,-3,4009,11.921150381,12.027416714,-0.106266332,0.1932115135,-9.689557401,-9.496345887
2020,Illinois,Macoupin County,44567,-512,451,603,-152,4,-363,-359,-1,863,10.06179863,13.452914798,-3.391116168,0.0892398992,-8.098520849,-8.00928095
2020,Illinois,Madison County,262635,-974,2754,3027,-273,41,-754,-713,12,3950,10.466627648,11.504169169,-1.037541521,0.155821254,-2.865590867,-2.709769613
2020,Illinois,Marion County,37045,-264,455,418,37,10,-311,-301,0,759,12.238749765,11.243510773,0.9952389918,0.2689835113,-8.365387202,-8.09640369
2020,Illinois,Marshall County,11309,-154,122,139,-17,1,-138,-137,0,255,10.714913051,12.207974706,-1.493061655,0.0878271562,-12.12014755,-12.03232039
2020,Illinois,Mason County,13173,-214,127,178,-51,0,-163,-163,0,206,9.563253012,13.403614458,-3.840361446,0.0,-12.27409639,-12.27409639
2020,Illinois,Massac County,13636,-136,136,182,-46,0,-90,-90,0,292,9.924109749,13.280793929,-3.35668418,0.0,-6.567425569,-6.567425569
2020,Illinois,Menard County,12068,-130,104,148,-44,0,-87,-87,1,154,8.5716640567,12.198137311,-3.626473255,0.0,-7.170526663,-7.170526663
2020,Illinois,Mercer County,15225,-265,139,179,-40,2,-227,-225,0,185,9.0509523034,11.655542894,-2.604590591,0.1302295295,-14.7810516,-14.65082207
2020,Illinois,Monroe County,34739,1,383,348,35,4,-38,-34,0,343,11.025231372,10.017703701,1.007527671,0.1151460195,-1.093887186,-0.978741166
2020,Illinois,Montgomery County,28045,-356,287,391,-104,0,-252,-252,0,2451,10.16901109,13.853948907,-3.684937817,0.0,-8.928887787,-8.928887787
2020,Illinois,Morgan County,33400,-279,318,386,-68,29,-241,-212,1,3328,9.481357802,11.508817961,-2.027460159,0.8646521266,-7.185557328,-6.320905201
2020,Illinois,Moultrie County,14347,-117,160,152,8,2,-126,-124,-1,395,11.106868904,10.551525459,0.5553434452,0.1388358613,-8.746659262,-8.607823401
2020,Illinois,Ogle County,50306,-354,526,520,6,14,-374,-360,0,526,10.419349088,10.300497197,0.1188518907,0.2773210784,-7.408434523,-7.131113444
2020,Illinois,Peoria County,177652,-1707,2411,1920,491,187,-2374,-2187,-11,4811,13.506586632,10.755971105,2.7506155273,1.047586769,-13.29931011,-12.25172334
2020,Illinois,Perry County,20664,-271,173,244,-71,6,-205,-199,-1,2472,8.3175076324,11.731051227,-3.413543595,0.2884684728,-9.856006154,-9.567537681
2020,Illinois,Piatt County,16355,-36,180,189,-9,-1,-25,-26,-1,72,10.993709155,11.543394613,-0.549685458,-0.061076162,-1.526904049,-1.587980211
2020,Illinois,Pike County,15239,-335,203,187,16,0,-349,-349,-2,488,13.176256775,12.137734073,1.0385227015,0.0,-22.65277643,-22.65277643
2020,Illinois,Pope County,4142,-34,27,35,-8,0,-27,-27,1,272,6.4919451791,8.4154844915,-1.923539312,0.0,-6.491945179,-6.491945179
2020,Illinois,Pulaski County,5201,-108,42,67,-25,2,-84,-82,-1,21,7.9923882017,12.749762131,-4.75737393,0.3805899144,-15.9847764,-15.60418649
2020,Illinois,Putnam County,5716,-29,37,65,-28,1,-3,-2,1,2,6.4566791728,11.342814763,-4.88613559,0.1745048425,-0.523514528,-0.349009685
2020,Illinois,Randolph County,31351,-374,292,422,-130,12,-256,-244,0,4313,9.2586720781,13.38068362,-4.122011542,0.3804933731,-8.117191959,-7.736698586
2020,Illinois,Richland County,15507,-12,165,196,-31,1,19,20,-1,364,10.636240572,12.634564559,-1.998323986,0.0644620641,1.2247792174,1.2892412815
2020,Illinois,Rock Island County,140907,-868,1686,1536,150,181,-1199,-1018,0,4586,11.928598213,10.867335027,1.0612631862,1.2805909113,-8.483030402,-7.20243949
2020,Illinois,St. Clair County,258046,-1843,2985,2926,59,82,-1984,-1902,0,4561,11.526542906,11.29871509,0.2278278162,0.3166420497,-7.661193007,-7.344550957
2020,Illinois,Saline County,23182,-358,270,343,-73,0,-284,-284,-1,883,11.557724412,14.682590643,-3.12486623,0.0,-12.15701383,-12.15701383
2020,Illinois,Sangamon County,193882,-1000,2166,2315,-149,139,-992,-853,2,4017,11.143007069,11.909538949,-0.766531881,0.7150867879,-5.103353191,-4.388266403
2020,Illinois,Schuyler County,6738,-91,61,77,-16,16,-90,-74,-1,463,8.9924080489,11.351072455,-2.358664406,2.3586644063,-13.26748729,-10.90882288
2020,Illinois,Scott County,4950,-24,41,53,-12,5,-16,-11,-1,43,8.2627972592,10.681176945,-2.418379686,1.0076582023,-3.224506247,-2.216848045
2020,Illinois,Shelby County,21299,-326,235,276,-41,0,-284,-284,-1,205,10.949585314,12.859938496,-1.910353182,0.0,-13.23269034,-13.23269034
2020,Illinois,Stark County,5262,-50,51,68,-17,1,-34,-33,0,92,9.6463022508,12.861736334,-3.215434084,0.1891431814,-6.430868167,-6.241724986
2020,Illinois,Stephenson County,43831,-540,471,597,-126,17,-430,-413,-1,836,10.680029931,13.537108002,-2.857078071,0.3854787873,-9.750345797,-9.36486701
2020,Illinois,Tazewell County,130777,-1071,1339,1556,-217,33,-889,-856,2,2565,10.197049024,11.849595431,-1.652546406,0.2513089005,-6.770109472,-6.518800571
2020,Illinois,Union County,16498,-195,178,239,-61,3,-136,-133,-1,565,10.725799162,14.401494381,-3.675695219,0.180771896,-8.194992618,-8.014220722
2020,Illinois,Vermilion County,74855,-881,880,981,-101,13,-790,-777,-3,2906,11.687285429,13.028667052,-1.341381623,0.1726530802,-10.49199487,-10.31934179
2020,Illinois,Wabash County,11190,-180,135,134,1,2,-182,-180,-1,88,11.968085106,11.879432624,0.0886524823,0.1773049645,-16.13475177,-15.95744681
2020,Illinois,Warren County,16696,-120,196,189,7,19,-146,-127,0,978,11.697302459,11.279541657,0.4177608021,1.1339221771,-8.71329673,-7.579374552
2020,Illinois,Washington County,13764,-162,146,147,-1,1,-162,-161,0,246,10.545323221,10.617551463,-0.072228241,0.0722282412,-11.70097508,-11.62874684
2020,Illinois,Wayne County,16031,-165,200,224,-24,4,-145,-141,0,76,12.41195271,13.901387036,-1.489434325,0.2482390542,-8.998665715,-8.750426661
2020,Illinois,White County,13364,-210,121,199,-78,2,-134,-132,0,391,8.9835919519,14.774667756,-5.791075804,0.1484891232,-9.948771253,-9.800282129
2020,Illinois,Whiteside County,54656,-559,580,647,-67,4,-495,-491,-1,1011,10.557836008,11.777448098,-1.219612091,0.0728126621,-9.010566938,-8.937754275
2020,Illinois,Will County,688726,-1450,7169,5185,1984,66,-3511,-3445,11,8743,10.398128366,7.520476437,2.8776519289,0.0957283404,-5.092457622,-4.996729282
2020,Illinois,Williamson County,66415,-218,702,849,-147,25,-99,-74,3,1997,10.552582527,12.762311346,-2.20972882,0.375804221,-1.488184715,-1.112380494
2020,Illinois,Winnebago County,281295,-1170,3440,2972,468,187,-1829,-1642,4,4742,12.203774656,10.543493685,1.6602809706,0.6634028665,-6.488576699,-5.825173833
2020,Illinois,Woodford County,38091,-262,405,430,-25,0,-236,-236,-1,1005,10.595991837,11.250065407,-0.65407357,0.0,-6.174454503,-6.174454503
2020,Indiana,Indiana,6754953,23943,80976,67236,13740,8743,1323,10066,137,190123,12.008931064,9.9712567801,2.037674284,1.2966074429,0.1962040086,1.4928114514
2020,Indiana,Adams County,35839,151,631,290,341,5,-194,-189,-1,421,17.643686999,8.1088260377,9.5348609616,0.1398073455,-5.424525005,-5.284717659
2020,Indiana,Allen County,382187,3181,5286,3415,1871,393,897,1290,20,6125,13.888724673,8.9727572377,4.9159674353,1.0325896323,2.3568267181,3.3894163504
2020,Indiana,Bartholomew County,84447,384,1051,790,261,418,-298,120,3,1148,12.474037149,9.3762981425,3.0977390066,4.9611299033,-3.536882084,1.4242478191
2020,Indiana,Benton County,8741,-22,112,92,20,1,-42,-41,-1,92,12.797074954,10.511882998,2.2851919561,0.1142595978,-4.798903108,-4.68464351
2020,Indiana,Blackford County,11782,-5,139,171,-32,3,25,28,-1,163,11.795154652,14.510585939,-2.715431287,0.2545716831,2.1214306929,2.376002376
2020,Indiana,Boone County,69347,1432,776,524,252,57,1128,1185,-5,574,11.306843846,7.6350337311,3.671810115,0.8305284784,16.435721467,17.266249945
2020,Indiana,Brown County,15112,46,117,175,-58,-2,108,106,-2,163,7.753992975,11.59785274,-3.843859765,-0.132546888,7.1575319769,7.0249850885
2020,Indiana,Carroll County,20228,17,198,214,-16,16,18,34,-1,106,9.792527016,10.58384233,-0.791315314,0.7913153144,0.8902297287,1.6815450432
2020,Indiana,Cass County,37388,-222,402,439,-37,82,-267,-185,0,1052,10.720285874,11.706978853,-0.986692978,2.1867249793,-7.120189872,-4.933464892
2020,Indiana,Clark County,119266,1075,1396,1299,97,65,912,977,1,1328,11.757918276,10.940928252,0.8169900235,0.5474675415,7.681390736,8.2288582775
2020,Indiana,Clay County,26246,-55,324,303,21,1,-77,-76,0,341,12.33181723,11.53253278,0.7992844501,0.0380611643,-2.93070965,-2.892648486
2020,Indiana,Clinton County,32206,-92,421,343,78,1,-172,-171,1,831,13.053454049,10.63499938,2.4184546695,0.0310058291,-5.333002604,-5.301996775
2020,Indiana,Crawford County,10629,36,118,128,-10,0,46,46,0,62,11.120535294,12.062953539,-0.942418245,0.0,4.335123928,4.335123928
2020,Indiana,Daviess County,33505,66,573,346,227,10,-170,-160,-1,581,17.118785851,10.336998088,6.7817877629,0.2987571702,-5.078871893,-4.780114723
2020,Indiana,Dearborn County,49824,251,532,497,35,6,209,215,1,530,10.704548427,10.00030182,0.704246607,0.1207279898,4.2053583106,4.3260863004
2020,Indiana,Decatur County,26584,112,315,297,18,11,81,92,2,377,11.87424608,11.195717732,0.6785283474,0.4146562123,3.0533775633,3.4680337756
2020,Indiana,DeKalb County,43670,109,541,431,110,-2,0,-2,1,615,12.403847256,9.8818080728,2.5220391833,-0.045855258,0.0,-0.045855258
2020,Indiana,Delaware County,113454,-315,1064,1266,-202,86,-207,-121,8,8601,9.3652491165,11.143238141,-1.777989024,0.7569656241,-1.821998653,-1.065033029
2020,Indiana,Dubois County,42542,-36,503,446,57,41,-134,-93,0,894,11.818609023,10.479323308,1.3392857143,0.9633458647,-3.148496241,-2.185150376
2020,Indiana,Elkhart County,206161,-107,3098,1817,1281,150,-1539,-1389,1,3691,15.023191871,8.8112135665,6.2119783041,0.7273979279,-7.46310274,-6.735704812
2020,Indiana,Fayette County,22892,-146,271,309,-38,5,-112,-107,-1,392,11.800566079,13.455258001,-1.654691922,0.2177226214,-4.876986719,-4.659264098
2020,Indiana,Floyd County,78936,335,853,817,36,51,248,299,0,1329,10.829202029,10.372166539,0.4570354901,0.6474669443,3.1484667094,3.7959336537
2020,Indiana,Fountain County,16511,86,200,193,7,5,74,79,0,172,12.144765606,11.71969881,0.4250667962,0.3036191402,4.4935632742,4.7971824144
2020,Indiana,Franklin County,22761,-2,264,231,33,4,-39,-35,0,187,11.598277831,10.148493103,1.4497847289,0.1757314823,-1.713381952,-1.53765047
2020,Indiana,Fulton County,20018,-24,241,224,17,7,-47,-40,-1,224,12.031952072,11.183225162,0.8487269096,0.3494757863,-2.34648028,-1.997004493
2020,Indiana,Gibson County,33825,116,412,412,0,37,77,114,2,738,12.201261587,12.201261587,0.0,1.0957443658,2.2803328694,3.3760772352
2020,Indiana,Grant County,65225,-611,765,873,-108,14,-517,-503,0,4798,11.67395335,13.322040882,-1.648087532,0.2136409763,-7.889456055,-7.675815078
2020,Indiana,Greene County,32203,86,360,443,-83,18,152,170,-1,281,11.194029851,13.774875622,-2.580845771,0.5597014925,4.7263681592,5.2860696517
2020,Indiana,Hamilton County,344238,6283,3760,2124,1636,475,4173,4648,-1,1871,11.023273472,6.2269768233,4.7962966492,1.3925677924,12.234074521,13.626642314
2020,Indiana,Hancock County,79553,1394,802,700,102,16,1281,1297,-5,649,10.170437253,8.8769402455,1.2934970072,0.2029014913,16.244800649,16.447702141
2020,Indiana,Harrison County,40682,130,414,395,19,13,97,110,1,461,10.192776424,9.7249919984,0.4677844252,0.3200630278,2.388162592,2.7082256198
2020,Indiana,Hendricks County,173251,3327,1647,1262,385,151,2802,2953,-11,4067,9.5986012967,7.3548481096,2.2437531871,0.8800174838,16.329860858,17.209878342
2020,Indiana,Henry County,48033,8,480,577,-97,2,102,104,1,3557,9.9939619813,12.013575132,-2.01961315,0.0416415083,2.123716921,2.1653584293
2020,Indiana,Howard County,82732,72,995,1016,-21,46,43,89,4,1281,12.032020896,12.285963045,-0.25394215,0.5562542324,0.5199767824,1.0762310148
2020,Indiana,Huntington County,36395,-149,419,420,-1,10,-159,-149,1,1339,11.489052496,11.516472669,-0.027420173,0.2742017302,-4.35980751,-4.08560578
2020,Indiana,Jackson County,44222,43,606,484,122,68,-149,-81,2,595,13.710252146,10.950102374,2.7601497721,1.5384441352,-3.37100259,-1.832558455
2020,Indiana,Jasper County,33440,-76,359,365,-6,1,-72,-71,1,932,10.723460183,10.902682359,-0.179222176,0.0298703626,-2.150666109,-2.120795746
2020,Indiana,Jay County,20416,-30,288,243,45,-6,-70,-76,1,243,14.096226323,11.89369096,2.2025353629,-0.293671382,-3.42616612,-3.719837502
2020,Indiana,Jefferson County,32110,-155,367,378,-11,17,-163,-146,2,2044,11.401941748,11.74368932,-0.341747573,0.5281553398,-5.06407767,-4.53592233
2020,Indiana,Jennings County,27515,-147,313,342,-29,7,-127,-120,2,298,11.345306921,12.396469543,-1.051162622,0.2537289088,-4.603367345,-4.349638436
2020,Indiana,Johnson County,160607,2275,1857,1409,448,180,1648,1828,-1,2418,11.644859989,8.8355453551,2.8093146338,1.1287424868,10.334264546,11.463007033
2020,Indiana,Knox County,36522,-81,398,422,-24,12,-70,-58,1,1882,10.885470085,11.541880342,-0.656410256,0.3282051282,-1.914529915,-1.586324786
2020,Indiana,Kosciusko County,78988,-450,991,786,205,83,-736,-653,-2,1574,12.51057276,9.9226137124,2.5879590471,1.0478078093,-9.291404189,-8.243596379
2020,Indiana,LaGrange County,40119,348,781,283,498,-1,-152,-153,3,325,19.55188384,7.0847415196,12.467142321,-0.025034422,-3.805232194,-3.830266617
2020,Indiana,Lake County,487536,1292,5722,5384,338,87,850,937,17,6490,11.752141141,11.057939165,0.6942019758,0.1786851239,1.7457741995,1.9244593235
2020,Indiana,LaPorte County,109663,-381,1249,1310,-61,37,-362,-325,5,6387,11.369687811,11.924972805,-0.555284993,0.336812209,-3.295297828,-2.958485619
2020,Indiana,Lawrence County,45496,77,514,603,-89,-1,168,167,-1,653,11.307265028,13.265137766,-1.957872738,-0.02199857,3.6957597756,3.6737612055
2020,Indiana,Madison County,129681,265,1377,1554,-177,40,396,436,6,6213,10.629223804,11.995507474,-1.36628367,0.3087646711,3.0567702443,3.3655349155
2020,Indiana,Marion County,966183,2354,13959,8808,5151,3045,-5880,-2835,38,18370,14.465195035,9.1274043892,5.3377906459,3.1554207953,-6.093226363,-2.937805568
2020,Indiana,Marshall County,46108,-89,525,507,18,22,-130,-108,1,671,11.375331781,10.985320405,0.3900113753,0.4766805698,-2.816748822,-2.340068252
2020,Indiana,Martin County,10079,-100,103,115,-12,-1,-85,-86,-2,133,10.168822194,11.353539342,-1.184717149,-0.098726429,-8.391746471,-8.4904729
2020,Indiana,Miami County,35328,-160,352,389,-37,16,-140,-124,1,3343,9.9412562133,10.986217804,-1.044961591,0.4518752824,-3.953908721,-3.502033439
2020,Indiana,Monroe County,148219,41,1234,1029,205,656,-829,-173,9,15006,8.326669973,6.9433901153,1.3832798578,4.4264955448,-5.593848791,-1.167353246
2020,Indiana,Montgomery County,38365,90,431,420,11,21,57,78,1,1175,11.247390397,10.960334029,0.2870563674,0.5480167015,1.487473904,2.0354906054
2020,Indiana,Morgan County,70707,304,747,728,19,39,244,283,2,590,10.587484941,10.318191482,0.269293459,0.552760258,3.4582949472,4.0110552052
2020,Indiana,Newton County,13907,-65,152,158,-6,24,-84,-60,1,169,10.904264859,11.334696366,-0.430431508,1.7217260303,-6.026041106,-4.304315076
2020,Indiana,Noble County,47832,-75,628,495,133,34,-242,-208,0,823,13.119000616,10.340613543,2.7783870732,0.7102643646,-5.055411066,-4.345146701
2020,Indiana,Ohio County,5892,-16,56,82,-26,3,8,11,-1,52,9.4915254237,13.898305085,-4.406779661,0.5084745763,1.3559322034,1.8644067797
2020,Indiana,Orange County,19651,-6,264,251,13,6,-25,-19,0,258,13.432380177,12.770937214,0.6614429633,0.3052813677,-1.272005699,-0.966724331
2020,Indiana,Owen County,20833,-48,237,281,-44,2,-7,-5,1,197,11.363091528,13.472695018,-2.10960349,0.0958910677,-0.335618737,-0.239727669
2020,Indiana,Parke County,16871,-22,187,193,-6,0,-17,-17,1,1603,11.076886625,11.432294752,-0.355408127,0.0,-1.006989693,-1.006989693
2020,Indiana,Perry County,19154,-30,206,204,2,7,-40,-33,1,1583,10.746517815,10.642182691,0.1043351244,0.3651729355,-2.086702488,-1.721529553
2020,Indiana,Pike County,12378,-5,152,160,-8,3,-2,1,2,213,12.277371673,12.92354913,-0.646177456,0.2423165462,-0.161544364,0.0807721821
2020,Indiana,Porter County,170980,381,1656,1798,-142,31,488,519,4,3421,9.6961464259,10.527579272,-0.831432846,0.1815099874,2.857318512,3.0388284994
2020,Indiana,Posey County,25275,-133,276,290,-14,-1,-119,-120,1,242,10.891225855,11.44367934,-0.552453485,-0.039460963,-4.695854626,-4.735315589
2020,Indiana,Pulaski County,12388,9,119,145,-26,10,24,34,1,193,9.6095611095,11.709129083,-2.099567974,0.8075261437,1.9380627448,2.7455888884
2020,Indiana,Putnam County,37469,-97,376,378,-2,25,-121,-96,1,4827,10.021989738,10.075298194,-0.053308456,0.6663557007,-3.225161591,-2.558805891
2020,Indiana,Randolph County,24191,-342,265,294,-29,15,-324,-309,-4,329,10.877596256,12.067974715,-1.190378458,0.6157129956,-13.29940071,-12.68368771
2020,Indiana,Ripley County,28448,-17,394,327,67,0,-83,-83,-1,449,13.845694305,11.491223446,2.354470859,0.0,-2.916732557,-2.916732557
2020,Indiana,Rush County,16649,44,186,197,-11,6,48,54,1,178,11.186624166,11.848198713,-0.661574547,0.360858844,2.8868707524,3.2477295964
2020,Indiana,St. Joseph County,271484,-211,3508,2640,868,434,-1517,-1083,4,11614,12.91655237,9.720552525,3.1959998454,1.5979999227,-5.585635674,-3.987635752
2020,Indiana,Scott County,23788,-67,264,331,-67,11,-11,0,0,312,11.08242554,13.89501081,-2.81258527,0.4617677308,-0.461767731,0.0
2020,Indiana,Shelby County,44871,100,488,477,11,37,51,88,1,683,10.887753508,10.642332835,0.2454206733,0.8255059013,1.1378594855,1.9633653868
2020,Indiana,Spencer County,20225,-48,182,250,-68,-1,21,20,0,368,8.9880981777,12.346288706,-3.358190528,-0.049385155,1.0370882513,0.9877030964
2020,Indiana,Starke County,23049,38,270,315,-45,1,81,82,1,16,11.723838472,13.67781155,-1.953973079,0.043421624,3.5171515415,3.5605731654
2020,Indiana,Steuben County,34831,72,381,379,2,23,47,70,0,1311,10.949849116,10.892369593,0.0574795229,0.6610145136,1.3507687886,2.0117833022
2020,Indiana,Sullivan County,20578,-23,211,226,-15,-2,-7,-9,1,2260,10.247941912,10.976468588,-0.728526676,-0.09713689,-0.339979116,-0.437116006
2020,Indiana,Switzerland County,10724,-91,113,124,-11,9,-90,-81,1,107,10.492594828,11.513997864,-1.021403036,0.8356933934,-8.356933934,-7.52124054
2020,Indiana,Tippecanoe County,196115,1234,2142,1304,838,1150,-769,381,15,16552,10.956633827,6.6701449631,4.2864888643,5.8824131193,-3.933544077,1.9488690421
2020,Indiana,Tipton County,15227,94,145,168,-23,11,106,117,0,205,9.5520421607,11.067193676,-1.515151515,0.7246376812,6.9828722003,7.7075098814
2020,Indiana,Union County,7119,-16,70,70,0,7,-23,-16,0,67,9.8218044058,9.8218044058,0.0,0.9821804406,-3.227164305,-2.244983864
2020,Indiana,Vanderburgh County,182447,886,2069,2032,37,116,727,843,6,7069,11.367882025,11.164589789,0.2032922353,0.6373486297,3.9944177051,4.6317663348
2020,Indiana,Vermillion County,15329,-164,172,215,-43,9,-129,-120,-1,209,11.160859127,13.951073908,-2.790214782,0.5839984427,-8.370644345,-7.786645902
2020,Indiana,Vigo County,106608,-350,1115,1254,-139,108,-323,-215,4,9595,10.441736981,11.743442308,-1.301705328,1.0113969452,-3.024826049,-2.013429104
2020,Indiana,Wabash County,30784,-244,303,427,-124,7,-128,-121,1,1843,9.8039215686,13.816087491,-4.012165922,0.2264932376,-4.14159063,-3.915097392
2020,Indiana,Warren County,8194,-68,75,95,-20,2,-50,-48,0,84,9.1152163345,11.54594069,-2.430724356,0.2430724356,-6.07681089,-5.833738454
2020,Indiana,Warrick County,63269,418,612,675,-63,25,458,483,-2,727,9.7050428164,10.704091342,-0.999048525,0.3964478275,7.2629241992,7.6593720266
2020,Indiana,Washington County,28213,150,301,324,-23,0,174,174,-1,261,10.697277703,11.51467766,-0.817399957,0.0,6.183808373,6.183808373
2020,Indiana,Wayne County,65778,-165,770,935,-165,67,-68,-1,1,2705,11.691377988,14.196673272,-2.505295283,1.0173017211,-1.032485329,-0.015183608
2020,Indiana,Wells County,28142,11,335,267,68,11,-68,-57,0,472,11.906242781,9.4894532014,2.4167895794,0.3909512555,-2.416789579,-2.025838324
2020,Indiana,White County,24165,-32,287,298,-11,26,-48,-22,1,307,11.868822629,12.323725239,-0.454902609,1.0752243497,-1.985029569,-0.909805219
2020,Indiana,Whitley County,34378,510,356,339,17,9,488,497,-4,436,10.432845881,9.9346481845,0.4981976966,0.2637517217,14.301204466,14.564956188
2020,Iowa,Iowa,3163561,3965,37068,30857,6211,5511,-7799,-2288,42,96247,11.724523051,9.7599980516,1.9645249991,1.7431166109,-2.466805743,-0.723689132
2020,Iowa,Adair County,7059,-43,98,96,2,2,-46,-44,-1,154,13.84083045,13.558364522,0.2824659275,0.2824659275,-6.496716334,-6.214250406
2020,Iowa,Adams County,3588,-14,36,39,-3,0,-12,-12,1,69,10.013908206,10.848400556,-0.83449235,0.0,-3.337969402,-3.337969402
2020,Iowa,Allamakee County,13642,-29,174,192,-18,25,-35,-10,-1,215,12.741185516,14.05923919,-1.318053674,1.8306301029,-2.562882144,-0.732252041
2020,Iowa,Appanoose County,12430,-95,143,172,-29,5,-71,-66,0,118,11.460629132,13.784812663,-2.32418353,0.4007212983,-5.690242436,-5.289521138
2020,Iowa,Audubon County,5481,-10,58,74,-16,1,4,5,1,116,10.572366023,13.488880787,-2.916514765,0.1822821728,0.7291286912,0.911410864
2020,Iowa,Benton County,25414,-130,284,259,25,7,-161,-154,-1,311,11.146434318,10.165234114,0.9812002041,0.2747360571,-6.318929314,-6.044193257
2020,Iowa,Black Hawk County,130786,-303,1594,1282,312,280,-895,-615,0,4256,12.173747017,9.7909307876,2.3828162291,2.138424821,-6.835322196,-4.696897375
2020,Iowa,Boone County,26277,-61,262,318,-56,7,-13,-6,1,722,9.9591371282,12.087807659,-2.128670531,0.2660838164,-0.494155659,-0.228071843
2020,Iowa,Bremer County,25311,141,264,239,25,47,69,116,0,1581,10.459380757,9.4689090945,0.9904716626,1.8620867257,2.7337017888,4.5957885145
2020,Iowa,Buchanan County,21287,139,274,203,71,3,66,69,-1,310,12.913868269,9.5675739366,3.3462943325,0.1413927183,3.1106398021,3.2520325203
2020,Iowa,Buena Vista County,19772,82,288,147,141,90,-148,-58,-1,796,14.596320511,7.4502052608,7.1461152501,4.5613501596,-7.500886929,-2.93953677
2020,Iowa,Butler County,14333,-71,152,192,-40,7,-38,-31,0,211,10.578696454,13.362563942,-2.783867488,0.4871768104,-2.644674114,-2.157497303
2020,Iowa,Calhoun County,9473,-143,103,142,-39,7,-110,-103,-1,723,10.791555346,14.877678244,-4.086122898,0.733406674,-11.52496202,-10.79155535
2020,Iowa,Carroll County,19914,-204,225,242,-17,5,-191,-186,-1,398,11.241007194,12.090327738,-0.849320544,0.2498001599,-9.542366107,-9.292565947
2020,Iowa,Cass County,12817,-5,136,184,-48,13,30,43,0,291,10.608838098,14.353133898,-3.744295799,1.0140801123,2.3401848746,3.3542649869
2020,Iowa,Cedar County,18485,-56,172,195,-23,1,-36,-35,2,319,9.2907686491,10.533138875,-1.242370226,0.0540160968,-1.944579485,-1.890563388
2020,Iowa,Cerro Gordo County,42103,-374,462,541,-79,34,-327,-293,-2,1132,10.924568456,12.792622369,-1.868053913,0.8039725703,-7.732324427,-6.928351856
2020,Iowa,Cherokee County,11190,-41,114,170,-56,8,6,14,1,361,10.169037955,15.164354846,-4.99531689,0.7136166986,0.535212524,1.2488292226
2020,Iowa,Chickasaw County,11834,-109,139,131,8,21,-138,-117,0,90,11.691971233,11.019052025,0.6729192076,1.76641292,-11.60785633,-9.841443412
2020,Iowa,Clarke County,9353,-29,121,111,10,39,-78,-39,0,156,12.917000267,11.849479584,1.0675206832,4.1633306645,-8.326661329,-4.163330665
2020,Iowa,Clay County,15976,-118,186,191,-5,10,-123,-113,0,215,11.599625819,11.911443717,-0.311817898,0.6236357967,-7.670720299,-7.047084503
2020,Iowa,Clayton County,17321,-176,176,210,-34,10,-150,-140,-2,255,10.109713367,12.062726176,-1.953012809,0.5744155322,-8.616232983,-8.041817451
2020,Iowa,Clinton County,46392,-167,516,529,-13,37,-192,-155,1,633,11.102623963,11.382341234,-0.27971727,0.796118385,-4.131208917,-3.335090532
2020,Iowa,Crawford County,16834,-69,217,157,60,123,-250,-127,-2,535,12.864214364,9.3072887334,3.5569256306,7.2916975428,-14.82052346,-7.528825918
2020,Iowa,Dallas County,96963,3332,1309,538,771,181,2387,2568,-7,692,13.736004281,5.6455082531,8.0904960282,1.8993252673,25.048007807,26.947333074
2020,Iowa,Davis County,9051,45,158,84,74,3,-32,-29,0,92,17.50013845,9.3038710749,8.1962673755,0.3322811098,-3.544331838,-3.212050728
2020,Iowa,Decatur County,7769,-83,90,78,12,6,-99,-93,-2,652,11.522949875,9.9865565585,1.5363933167,0.7681966583,-12.67524486,-11.9070482
2020,Iowa,Delaware County,16937,-120,189,190,-1,6,-124,-118,-1,218,11.119609343,11.178443255,-0.058833912,0.3530034712,-7.295405071,-6.9424016
2020,Iowa,Des Moines County,38708,-343,445,475,-30,22,-332,-310,-3,630,11.445620443,12.217235304,-0.771614861,0.5658508983,-8.539204465,-7.973353567
2020,Iowa,Dickinson County,17549,259,152,186,-34,17,278,295,-2,180,8.7258532105,10.677688797,-1.951835587,0.9759177933,15.959126267,16.93504406
2020,Iowa,Dubuque County,97590,158,1196,970,226,128,-198,-70,2,4139,12.265282891,9.9475956559,2.3176872353,1.3126724164,-2.030540144,-0.717867728
2020,Iowa,Emmet County,9095,-129,106,113,-7,7,-129,-122,0,431,11.572684098,12.336917954,-0.764233856,0.7642338556,-14.0837382,-13.31950434
2020,Iowa,Fayette County,19258,-317,202,233,-31,14,-298,-284,-2,832,10.403522777,12.000103005,-1.596580228,0.7210362321,-15.34777123,-14.62673499
2020,Iowa,Floyd County,15480,-175,171,176,-5,12,-181,-169,-1,228,10.984422675,11.305604625,-0.32118195,0.770836679,-11.62678657,-10.8559499
2020,Iowa,Franklin County,9971,-111,108,114,-6,6,-111,-105,0,185,10.771455643,11.369869845,-0.598414202,0.5984142024,-11.07066274,-10.47224854
2020,Iowa,Fremont County,6729,-188,64,96,-32,2,-157,-155,-1,131,9.3800381064,14.07005716,-4.690019053,0.2931261908,-23.01040598,-22.71727979
2020,Iowa,Greene County,8795,-86,90,110,-20,1,-67,-66,0,88,10.183299389,12.446254809,-2.26295542,0.113147771,-7.580900656,-7.467752885
2020,Iowa,Grundy County,12217,-10,127,140,-13,0,2,2,1,145,10.39109802,11.454753723,-1.063655703,0.0,0.1636393389,0.1636393389
2020,Iowa,Guthrie County,10737,-4,97,129,-32,6,22,28,0,168,9.0324983704,12.012291647,-2.979793277,0.5587112394,2.0486078778,2.6073191172
2020,Iowa,Hamilton County,14716,-81,176,178,-2,8,-87,-79,0,198,11.926947447,12.062480941,-0.135533494,0.5421339749,-5.895706977,-5.353573002
2020,Iowa,Hancock County,10507,-157,110,119,-9,7,-154,-147,-1,184,10.391573379,11.241793019,-0.85021964,0.6612819423,-14.54820273,-13.88692079
2020,Iowa,Hardin County,16575,-234,160,234,-74,22,-180,-158,-2,769,9.5854301462,14.018691589,-4.433261443,1.3179966451,-10.78360891,-9.465612269
2020,Iowa,Harrison County,13928,-106,157,190,-33,0,-72,-72,-1,281,11.229525785,13.589871969,-2.360346184,0.0,-5.14984622,-5.14984622
2020,Iowa,Henry County,19697,-138,202,211,-9,13,-142,-129,0,1576,10.219568957,10.674896287,-0.45532733,0.6576950319,-7.184053425,-6.526358393
2020,Iowa,Howard County,9176,30,119,124,-5,-1,36,35,0,190,12.98984827,13.535640214,-0.545791944,-0.109158389,3.9297019976,3.8205436088
2020,Iowa,Humboldt County,9473,-26,105,124,-19,12,-17,-5,-2,104,11.068943707,13.071895425,-2.002951718,1.2650221379,-1.792114695,-0.527092557
2020,Iowa,Ida County,6833,11,68,108,-40,0,50,50,1,107,9.9597217137,15.818381545,-5.858659832,0.0,7.3233247895,7.3233247895
2020,Iowa,Iowa County,16138,-8,165,214,-49,-2,43,41,0,283,10.221781688,13.257341098,-3.03555941,-0.123900384,2.663858258,2.5399578739
2020,Iowa,Jackson County,19205,-170,211,242,-31,1,-140,-139,0,192,10.938310005,12.54536029,-1.607050285,0.0518403318,-7.257646449,-7.205806117
2020,Iowa,Jasper County,37148,-23,400,401,-1,9,-34,-25,3,1809,10.764407487,10.791318505,-0.026911019,0.2421991684,-0.914974636,-0.672775468
2020,Iowa,Jefferson County,18347,167,141,191,-50,158,60,218,-1,1704,7.7203164782,10.458017357,-2.737700879,8.651134777,3.2852410546,11.936375832
2020,Iowa,Johnson County,153740,1260,1719,835,884,868,-501,367,9,8388,11.227222259,5.4535954542,5.7736268043,5.6691267716,-3.272157273,2.3969694991
2020,Iowa,Jones County,20617,-17,198,230,-32,12,3,15,0,1196,9.5997672784,11.151244818,-1.55147754,0.5818040775,0.1454510194,0.7272550968
2020,Iowa,Keokuk County,10085,-107,105,114,-9,7,-105,-98,0,136,10.356561622,11.244266903,-0.887705282,0.6904374414,-10.35656162,-9.66612418
2020,Iowa,Kossuth County,14680,-89,173,178,-5,5,-89,-84,0,219,11.749125607,12.088695711,-0.339570104,0.3395701042,-6.044347856,-5.704777751
2020,Iowa,Lee County,33480,-161,328,462,-134,2,-29,-27,0,1271,9.7733943177,13.76618346,-3.992789142,0.0595938678,-0.864111083,-0.804517215
2020,Iowa,Linn County,227854,613,2674,1921,753,378,-528,-150,10,5133,11.751392566,8.4421933882,3.3091991782,1.6611916193,-2.320394643,-0.659203024
2020,Iowa,Louisa County,11011,-48,123,125,-2,45,-93,-48,2,117,11.146352515,11.327594019,-0.181241504,4.0779338469,-8.42772995,-4.349796103
2020,Iowa,Lucas County,8518,-43,100,96,4,0,-48,-48,1,63,11.710287488,11.241875988,0.4684114995,0.0,-5.620937994,-5.620937994
2020,Iowa,Lyon County,11756,-50,174,108,66,8,-124,-116,0,166,14.769544181,9.167303285,5.6022408964,0.6790595026,-10.52542229,-9.846362788
2020,Iowa,Madison County,16521,248,173,156,17,6,228,234,-3,148,10.550710496,9.513935476,1.0367750198,0.3659205952,13.904982619,14.270903214
2020,Iowa,Mahaska County,22370,-59,263,250,13,27,-101,-74,2,995,11.741333512,11.160963414,0.5803700975,1.2053840488,-4.509029219,-3.303645171
2020,Iowa,Marion County,33168,-112,336,365,-29,8,-92,-84,1,1326,10.113171202,10.986034192,-0.872862991,0.2407897905,-2.769082591,-2.5282928
2020,Iowa,Marshall County,39495,23,490,476,14,144,-135,9,0,1247,12.410247319,12.055668824,0.3545784948,3.6470930895,-3.419149771,0.2279433181
2020,Iowa,Mills County,14766,-358,135,151,-16,4,-344,-340,-2,537,9.0331214453,10.103713617,-1.070592171,0.2676480428,-23.01773168,-22.75008364
2020,Iowa,Mitchell County,10647,82,131,129,2,1,80,81,-1,214,12.351499151,12.162926645,0.1885725061,0.0942862531,7.5429002451,7.6371864982
2020,Iowa,Monona County,8598,-28,92,147,-55,-1,29,28,-1,193,10.68276823,17.069205759,-6.386437529,-0.116117046,3.3673943335,3.2512772875
2020,Iowa,Monroe County,7770,89,85,77,8,0,81,81,0,107,11.002524108,9.9669924277,1.0355316808,0.0,10.484758268,10.484758268
2020,Iowa,Montgomery County,9935,18,107,150,-43,6,54,60,1,188,10.7797703,15.111827524,-4.332057223,0.6044731009,5.4402579085,6.0447310095
2020,Iowa,Muscatine County,42394,-177,512,392,120,66,-362,-296,-1,553,12.052021421,9.2273289001,2.8246925204,1.5535808862,-8.52115577,-6.967574884
2020,Iowa,O'Brien County,13679,-117,160,181,-21,2,-98,-96,0,410,11.646951774,13.175614195,-1.52866242,0.1455868972,-7.133757962,-6.988171065
2020,Iowa,Osceola County,5987,26,63,75,-12,7,31,38,0,107,10.545698025,12.55440241,-2.008704386,1.171744225,5.1891529963,6.3608972213
2020,Iowa,Page County,15073,-56,131,206,-75,22,-3,19,0,1523,8.6749221906,13.641480697,-4.966558506,1.4568571618,-0.19866234,1.2581948215
2020,Iowa,Palo Alto County,8845,-28,98,123,-25,20,-23,-3,0,251,11.062196636,13.884185574,-2.821988938,2.2575911502,-2.596229823,-0.338638673
2020,Iowa,Plymouth County,25219,19,277,236,41,10,-32,-22,0,284,10.98792122,9.3615502092,1.6263710109,0.3966758563,-1.26936274,-0.872686884
2020,Iowa,Pocahontas County,6607,-25,71,85,-14,1,-12,-11,0,95,10.725885641,12.840849007,-2.114963366,0.1510688118,-1.812825742,-1.66175693
2020,Iowa,Polk County,494281,3250,6524,3966,2558,964,-309,655,37,9364,13.242505927,8.0502419538,5.1922639732,1.956740606,-0.627212497,1.3295281089
2020,Iowa,Pottawattamie County,93328,-77,1058,1042,16,82,-176,-94,1,1981,11.33168749,11.160319815,0.1713676747,0.8782593328,-1.885044422,-1.006785089
2020,Iowa,Poweshiek County,18381,-77,161,221,-60,29,-47,-18,1,1639,8.7407367192,11.99815413,-3.257417411,1.5744184153,-2.551643639,-0.977225223
2020,Iowa,Ringgold County,4801,-65,47,66,-19,3,-49,-46,0,177,9.7238026275,13.654701562,-3.930898935,0.6206682528,-10.13758146,-9.51691321
2020,Iowa,Sac County,9603,-72,108,119,-11,-1,-59,-60,-1,167,11.204481793,12.345679012,-1.14119722,-0.103745202,-6.120966905,-6.224712107
2020,Iowa,Scott County,173216,-184,2046,1571,475,219,-884,-665,6,3377,11.805571584,9.0647863919,2.7407851917,1.2636462252,-5.100745494,-3.837099268
2020,Iowa,Shelby County,11430,-49,126,138,-12,-2,-35,-37,0,200,11.000043651,12.047666856,-1.047623205,-0.174603867,-3.055567681,-3.230171548
2020,Iowa,Sioux County,35043,93,500,263,237,49,-195,-146,2,2242,14.287143,7.515037218,6.772105782,1.400140014,-5.57198577,-4.171845756
2020,Iowa,Story County,98237,796,826,564,262,566,-41,525,9,10514,8.4424411533,5.7645724098,2.6778687435,5.7850141559,-0.419055796,5.3659583602
2020,Iowa,Tama County,16801,-103,200,188,12,30,-143,-113,-2,296,11.867675419,11.155614894,0.7120605251,1.7801513129,-8.485387925,-6.705236612
2020,Iowa,Taylor County,6092,-96,65,69,-4,16,-106,-90,-2,53,10.586319218,11.237785016,-0.651465798,2.6058631922,-17.26384365,-14.65798046
2020,Iowa,Union County,12157,-67,121,139,-18,13,-61,-48,-1,456,9.9257618637,11.40232148,-1.476559616,1.0664041672,-5.003896477,-3.93749231
2020,Iowa,Van Buren County,7069,25,96,97,-1,0,27,27,-1,57,13.604478141,13.746191455,-0.141713314,0.0,3.8262594771,3.8262594771
2020,Iowa,Wapello County,34985,-166,435,405,30,139,-336,-197,1,913,12.404471313,11.548990533,0.8554807802,3.9637276149,-9.581384738,-5.617657123
2020,Iowa,Warren County,52265,717,578,463,115,7,598,605,-3,1440,11.135406934,8.9198847928,2.2155221408,0.1348578694,11.520715132,11.655573001
2020,Iowa,Washington County,21992,-38,285,226,59,29,-126,-97,0,292,12.948071419,10.267593476,2.6804779428,1.3175230567,-5.724410522,-4.406887465
2020,Iowa,Wayne County,6415,2,90,92,-2,1,4,5,-1,93,14.031805426,14.343623324,-0.311817898,0.1559089492,0.6236357967,0.7795447459
2020,Iowa,Webster County,35934,-48,429,442,-13,58,-94,-36,1,2742,11.930585683,12.292118583,-0.361532899,1.6129929362,-2.614160966,-1.001168029
2020,Iowa,Winnebago County,10277,-80,97,128,-31,7,-56,-49,0,486,9.4019579335,12.406707376,-3.004749443,0.6784918096,-5.427934477,-4.749442667
2020,Iowa,Winneshiek County,19862,-130,187,198,-11,11,-130,-119,0,1918,9.3842525217,9.9362673759,-0.552014854,0.5520148542,-6.523811913,-5.971797059
2020,Iowa,Woodbury County,103138,6,1421,968,453,200,-651,-451,4,2513,13.778057885,9.3857565327,4.3923013526,1.9392058952,-6.312115189,-4.372909294
2020,Iowa,Worth County,7359,-48,80,66,14,0,-62,-62,0,80,10.835703644,8.9394555059,1.8962481376,0.0,-8.397670324,-8.397670324
2020,Iowa,Wright County,12416,-135,158,174,-16,23,-140,-117,-2,205,12.656706853,13.938398686,-1.281691833,1.8424320103,-11.21480354,-9.37237153
2020,Kansas,Kansas,2913805,1170,35467,27169,8298,2483,-9663,-7180,52,79138,12.174501068,9.3261065076,2.84839456,0.8523214862,-3.316948257,-2.46462677
2020,Kansas,Allen County,12399,-5,157,166,-9,1,3,4,0,382,12.6597589,13.385477563,-0.725718663,0.080635407,0.241906221,0.322541628
2020,Kansas,Anderson County,7949,50,102,106,-4,0,55,55,-1,103,12.872286724,13.377082282,-0.504795558,0.0,6.9409389197,6.9409389197
2020,Kansas,Atchison County,16015,-123,180,178,2,-3,-123,-126,1,1386,11.196466893,11.072061705,0.1244051877,-0.186607782,-7.650919043,-7.837526825
2020,Kansas,Barber County,4358,-100,51,51,0,3,-102,-99,-1,40,11.569872958,11.569872958,0.0,0.6805807623,-23.13974592,-22.45916515
2020,Kansas,Barton County,25658,-280,309,317,-8,27,-299,-272,0,672,11.977672688,12.287774246,-0.310101558,1.0465927591,-11.59004574,-10.54345298
2020,Kansas,Bourbon County,14435,-64,195,160,35,3,-102,-99,0,409,13.478952098,11.059653003,2.4192990945,0.2073684938,-7.05052879,-6.843160296
2020,Kansas,Brown County,9482,-59,134,128,6,4,-69,-65,0,116,14.08820901,13.457393681,0.6308153288,0.4205435525,-7.254376281,-6.833832729
2020,Kansas,Butler County,66992,60,690,693,-3,17,46,63,0,2298,10.304351722,10.349153251,-0.044801529,0.2538753323,0.6869567815,0.9408321137
2020,Kansas,Chase County,2586,1,25,18,7,2,-7,-5,-1,145,9.6693096113,6.9619029201,2.7074066912,0.7735447689,-2.707406691,-1.933861922
2020,Kansas,Chautauqua County,3230,27,33,51,-18,0,46,46,-1,79,10.259598943,15.855743821,-5.596144878,0.0,14.301259133,14.301259133
2020,Kansas,Cherokee County,19681,-267,230,281,-51,6,-220,-214,-2,202,11.607661056,14.181533725,-2.573872669,0.3028085493,-11.10298014,-10.80017159
2020,Kansas,Cheyenne County,2600,-24,22,49,-27,-1,5,4,-1,49,8.4226646248,18.75957121,-10.33690658,-0.382848392,1.9142419602,1.5313935681
2020,Kansas,Clark County,1963,-43,24,20,4,0,-46,-46,-1,57,12.093726379,10.078105316,2.0156210632,0.0,-23.17964223,-23.17964223
2020,Kansas,Clay County,8025,16,88,109,-21,1,37,38,-1,140,10.976674567,13.59610827,-2.619433703,0.1247349383,4.6151927155,4.7399276537
2020,Kansas,Cloud County,8642,-137,104,133,-29,5,-112,-107,-1,498,11.939613111,15.268928305,-3.329315194,0.5740198611,-12.85804489,-12.28402503
2020,Kansas,Coffey County,8158,16,69,88,-19,0,35,35,0,130,8.4662576687,10.797546012,-2.331288344,0.0,4.2944785276,4.2944785276
2020,Kansas,Comanche County,1690,-14,14,15,-1,0,-14,-14,1,65,8.2498526812,8.8391278727,-0.589275192,0.0,-8.249852681,-8.249852681
2020,Kansas,Cowley County,34628,-156,372,447,-75,7,-88,-81,0,2014,10.718607734,12.879617357,-2.161009624,0.2016942315,-2.535584625,-2.333890394
2020,Kansas,Crawford County,38730,-4,434,380,54,41,-100,-59,1,1780,11.205204998,9.8110089848,1.3941960136,1.0585562326,-2.58184447,-1.523288237
2020,Kansas,Decatur County,2776,-40,29,40,-11,6,-35,-29,0,81,10.371959943,14.306151645,-3.934191702,2.1459227468,-12.51788269,-10.37195994
2020,Kansas,Dickinson County,18266,-115,179,208,-29,1,-86,-85,-1,307,9.7688760335,11.3515431,-1.582667067,0.0545747264,-4.693426474,-4.638851748
2020,Kansas,Doniphan County,7496,-88,88,74,14,-3,-99,-102,0,427,11.671087533,9.8143236074,1.8567639257,-0.397877984,-13.12997347,-13.52785146
2020,Kansas,Douglas County,122530,261,1101,754,347,211,-307,-96,10,8814,8.995134784,6.160155883,2.8349789011,1.7238632511,-2.50818018,-0.784316929
2020,Kansas,Edwards County,2750,-33,30,25,5,0,-37,-37,-1,35,10.844026749,9.0366889572,1.8073377914,0.0,-13.37429966,-13.37429966
2020,Kansas,Elk County,2507,0,23,34,-11,0,12,12,-1,40,9.1743119266,13.562026326,-4.3877144,0.0,4.7865975269,4.7865975269
2020,Kansas,Ellis County,28671,19,296,261,35,42,-59,-17,1,1037,10.327442737,9.1062924132,1.2211503236,1.4653803883,-2.058510546,-0.593130157
2020,Kansas,Ellsworth County,6034,-59,48,75,-27,4,-36,-32,0,978,7.9162200049,12.369093758,-4.452873753,0.6596850004,-5.937165004,-5.277480003
2020,Kansas,Finney County,35917,-434,608,223,385,58,-873,-815,-4,547,16.826257818,6.1714728511,10.654784967,1.6051364366,-24.16007085,-22.55493441
2020,Kansas,Ford County,33094,-252,562,240,322,95,-666,-571,-3,708,16.917519567,7.224563516,9.6929560506,2.8597230584,-20.04816376,-17.1884407
2020,Kansas,Franklin County,25703,85,293,262,31,9,43,52,2,479,11.41832778,10.210245319,1.2080824614,0.3507336178,1.6757272851,2.0264609029
2020,Kansas,Geary County,32218,226,874,195,679,39,-489,-450,-3,842,27.22317396,6.0738202772,21.149353683,1.2147640554,-15.23127239,-14.01650833
2020,Kansas,Gove County,2621,-44,41,43,-2,2,-44,-42,0,56,15.512674991,16.269390844,-0.756715853,0.7567158532,-16.64774877,-15.89103292
2020,Kansas,Graham County,2389,-52,23,42,-19,2,-35,-33,0,40,9.5238095238,17.391304348,-7.867494824,0.8281573499,-14.49275362,-13.66459627
2020,Kansas,Grant County,7077,-59,119,34,85,-5,-140,-145,1,79,16.745233237,4.7843523535,11.960880884,-0.703581228,-19.7002744,-20.40385563
2020,Kansas,Gray County,5954,-42,75,45,30,13,-85,-72,0,78,12.552301255,7.5313807531,5.0209205021,2.1757322176,-14.22594142,-12.05020921
2020,Kansas,Greeley County,1196,-15,12,11,1,1,-19,-18,2,26,9.9709181554,9.1400083091,0.8309098463,0.8309098463,-15.78728708,-14.95637723
2020,Kansas,Greenwood County,5868,-133,54,71,-17,0,-114,-114,-2,90,9.0993344005,11.963939675,-2.864605274,0.0,-19.20970596,-19.20970596
2020,Kansas,Hamilton County,2425,-90,27,15,12,10,-110,-100,-2,0,10.931174089,6.0728744939,4.8582995951,4.048582996,-44.53441296,-40.48582996
2020,Kansas,Harper County,5336,-106,66,94,-28,0,-75,-75,-3,129,12.247170161,17.442939321,-5.195769159,0.0,-13.91723882,-13.91723882
2020,Kansas,Harvey County,34291,-151,385,367,18,43,-212,-169,0,1317,11.20277014,10.679004263,0.5237658767,1.2512184831,-6.168798103,-4.91757962
2020,Kansas,Haskell County,3923,-64,64,26,38,6,-108,-102,0,33,16.18204804,6.5739570164,9.608091024,1.5170670038,-27.30720607,-25.79013906
2020,Kansas,Hodgeman County,1779,16,13,31,-18,6,28,34,0,14,7.3404856014,17.504234896,-10.16374929,3.3879164314,15.81027668,19.198193111
2020,Kansas,Jackson County,13171,7,164,142,22,1,-17,-16,1,133,12.454907917,10.784127587,1.6707803304,0.0759445605,-1.291057528,-1.215112968
2020,Kansas,Jefferson County,19032,-133,194,156,38,0,-171,-171,0,235,10.157865801,8.1681807472,1.9896850538,0.0,-8.953582742,-8.953582742
2020,Kansas,Jewell County,2833,-25,25,40,-15,0,-10,-10,0,27,8.7858021437,14.05728343,-5.271481286,0.0,-3.514320857,-3.514320857
2020,Kansas,Johnson County,607220,4272,7020,4438,2582,515,1139,1654,36,5161,11.601694971,7.3345188437,4.2671761276,0.8511214972,1.8823832724,2.7335047696
2020,Kansas,Kearny County,3745,-62,56,25,31,0,-93,-93,0,81,14.830508475,6.6207627119,8.2097457627,0.0,-24.62923729,-24.62923729
2020,Kansas,Kingman County,6974,-82,65,94,-29,0,-53,-53,0,190,9.2658588738,13.399857448,-4.133998574,0.0,-7.555238774,-7.555238774
2020,Kansas,Kiowa County,2456,-14,38,24,14,1,-30,-29,1,149,15.428339423,9.7442143727,5.6841250508,0.4060089322,-12.18026797,-11.77425903
2020,Kansas,Labette County,19586,-118,250,235,15,1,-133,-132,-1,480,12.725884449,11.962331382,0.7635530669,0.0509035378,-6.770170527,-6.719266989
2020,Kansas,Lane County,1518,-9,18,17,1,0,-9,-9,-1,3,11.822660099,11.165845649,0.6568144499,0.0,-5.911330049,-5.911330049
2020,Kansas,Leavenworth County,82246,335,991,694,297,14,18,32,6,6507,12.073807392,8.4553202117,3.61848718,0.1705684193,0.2193022533,0.3898706726
2020,Kansas,Lincoln County,2986,22,24,41,-17,0,38,38,1,50,8.0672268908,13.781512605,-5.714285714,0.0,12.773109244,12.773109244
2020,Kansas,Linn County,9654,-60,94,128,-34,0,-27,-27,1,63,9.7067327551,13.217678645,-3.51094589,0.0,-2.788104089,-2.788104089
2020,Kansas,Logan County,2732,-44,46,19,27,1,-72,-71,0,41,16.702977487,6.8990559187,9.8039215686,0.3631082062,-26.14379085,-25.78068264
2020,Kansas,Lyon County,33045,-179,401,299,102,20,-302,-282,1,1452,12.102189561,9.0238271288,3.0783624319,0.6036004768,-9.1143672,-8.510766724
2020,Kansas,McPherson County,28448,-136,294,356,-62,2,-76,-74,0,928,10.310001403,12.484219386,-2.174217983,0.070136064,-2.665170431,-2.595034367
2020,Kansas,Marion County,11652,-179,108,151,-43,6,-140,-134,-2,727,9.1981433377,12.860367074,-3.662223736,0.5110079632,-11.92351914,-11.41251118
2020,Kansas,Marshall County,9652,-39,114,110,4,3,-47,-44,1,164,11.787209843,11.373623533,0.4135863103,0.3101897327,-4.859639146,-4.549449413
2020,Kansas,Meade County,4029,6,53,38,15,5,-14,-9,0,119,13.164431197,9.4386487829,3.7257824143,1.2419274714,-3.47739692,-2.235469449
2020,Kansas,Miami County,34334,90,374,320,54,1,35,36,0,644,10.907288052,9.3324389746,1.574849077,0.0291638718,1.0207355128,1.0498993846
2020,Kansas,Mitchell County,5879,-88,72,104,-32,1,-56,-55,-1,246,12.156002026,17.558669593,-5.402667567,0.1688333615,-9.454668242,-9.285834881
2020,Kansas,Montgomery County,31502,-294,344,371,-27,37,-302,-265,-2,1113,10.869221776,11.7223293,-0.853107523,1.1690732725,-9.542165629,-8.373092357
2020,Kansas,Morris County,5559,-64,66,73,-7,5,-63,-58,1,66,11.804686103,13.056698265,-1.252012162,0.8942944017,-11.26810946,-10.37381506
2020,Kansas,Morton County,2538,2,20,25,-5,1,5,6,1,83,7.8833267639,9.8541584549,-1.970831691,0.3941663382,1.970831691,2.3649980292
2020,Kansas,Nemaha County,10121,-49,146,94,52,0,-101,-101,0,259,14.390616529,9.2651914642,5.1254250653,0.0,-9.955152531,-9.955152531
2020,Kansas,Neosho County,15929,30,161,184,-23,24,27,51,2,451,10.11687822,11.562146538,-1.445268317,1.5081060701,1.6966193289,3.204725399
2020,Kansas,Ness County,2768,-14,35,38,-3,13,-23,-10,-1,70,12.612612613,13.693693694,-1.081081081,4.6846846847,-8.288288288,-3.603603604
2020,Kansas,Norton County,5328,-44,56,68,-12,3,-36,-33,1,818,10.46728972,12.710280374,-2.242990654,0.5607476636,-6.728971963,-6.168224299
2020,Kansas,Osage County,15770,-136,166,230,-64,0,-72,-72,0,194,10.481121354,14.522035611,-4.040914257,0.0,-4.546028539,-4.546028539
2020,Kansas,Osborne County,3439,1,41,40,1,1,0,1,-1,100,11.923803984,11.632979497,0.2908244874,0.2908244874,0.0,0.2908244874
2020,Kansas,Ottawa County,5712,-1,59,66,-7,0,7,7,-1,98,10.328227571,11.553610503,-1.225382932,0.0,1.2253829322,1.2253829322
2020,Kansas,Pawnee County,6366,-18,51,81,-30,0,11,11,1,1023,8.0,12.705882353,-4.705882353,0.0,1.7254901961,1.7254901961
2020,Kansas,Phillips County,5181,-67,61,66,-5,1,-62,-61,-1,68,11.698149391,12.657014095,-0.958864704,0.1917729408,-11.88992233,-11.69814939
2020,Kansas,Pottawatomie County,24722,254,371,210,161,3,88,91,2,299,15.084366741,8.5383207969,6.5460459443,0.1219760114,3.5779630006,3.699939012
2020,Kansas,Pratt County,9127,13,111,91,20,3,-9,-6,-1,381,12.170385396,9.9775231621,2.1928622334,0.328929335,-0.986788005,-0.65785867
2020,Kansas,Rawlins County,2511,18,37,23,14,3,1,4,0,40,14.788169464,9.1926458833,5.5955235811,1.1990407674,0.3996802558,1.5987210232
2020,Kansas,Reno County,61793,-170,620,749,-129,19,-59,-40,-1,3113,10.019716216,12.104463622,-2.084747406,0.3070558195,-0.953489124,-0.646433304
2020,Kansas,Republic County,4536,-27,41,65,-24,4,-8,-4,1,103,9.0119793384,14.287284317,-5.275304979,0.8792174964,-1.758434993,-0.879217496
2020,Kansas,Rice County,9362,-150,108,98,10,3,-162,-159,-1,651,11.444314931,10.384656141,1.0596587899,0.317897637,-17.1664724,-16.84857476
2020,Kansas,Riley County,73202,440,852,389,463,203,-230,-27,4,9232,11.674111425,5.3300813899,6.3440300348,2.781507769,-3.151462004,-0.369954235
2020,Kansas,Rooks County,4827,-110,64,82,-18,0,-90,-90,-2,72,13.109381401,16.79639492,-3.687013519,0.0,-18.4350676,-18.4350676
2020,Kansas,Rush County,2947,-47,21,29,-8,0,-38,-38,-1,66,7.0695169163,9.7626662178,-2.693149301,0.0,-12.79245918,-12.79245918
2020,Kansas,Russell County,6804,-64,81,98,-17,-6,-41,-47,0,89,11.849034523,14.335868929,-2.486834406,-0.877706261,-5.99765945,-6.875365711
2020,Kansas,Saline County,53926,-214,627,526,101,2,-317,-315,0,1470,11.604019766,9.7347917014,1.8692280643,0.0370144171,-5.866785113,-5.829770696
2020,Kansas,Scott County,4790,-60,66,63,3,-3,-61,-64,1,105,13.692946058,13.070539419,0.622406639,-0.622406639,-12.65560166,-13.2780083
2020,Kansas,Sedgwick County,519907,3328,6669,4863,1806,415,1075,1490,32,7238,12.868480616,9.3836289154,3.4848517008,0.8007826444,2.0743164886,2.875099133
2020,Kansas,Seward County,21038,-383,363,115,248,55,-680,-625,-6,476,17.098848301,5.4169905085,11.681857792,2.590734591,-32.0309004,-29.44016581
2020,Kansas,Shawnee County,175999,-736,2081,1946,135,77,-949,-872,1,4389,11.799259499,11.03381018,0.7654493188,0.4365896114,-5.380825211,-4.9442356
2020,Kansas,Sheridan County,2520,3,23,20,3,1,0,1,-1,33,9.1324200913,7.941234862,1.1911852293,0.3970617431,0.0,0.3970617431
2020,Kansas,Sherman County,5777,-155,65,77,-12,-3,-139,-142,-1,102,11.102570672,13.152276027,-2.049705355,-0.512426339,-23.74242036,-24.2548467
2020,Kansas,Smith County,3544,-27,26,41,-15,0,-11,-11,-1,56,7.3085031623,11.524947294,-4.216444132,0.0,-3.09205903,-3.09205903
2020,Kansas,Stafford County,4046,-35,40,58,-18,-1,-17,-18,1,69,9.843730774,14.273409622,-4.429678848,-0.246093269,-4.183585579,-4.429678848
2020,Kansas,Stanton County,1969,-18,18,17,1,6,-23,-17,-2,47,9.1001011122,8.5945399393,0.5055611729,3.0333670374,-11.62790698,-8.594539939
2020,Kansas,Stevens County,5388,-17,67,38,29,16,-63,-47,1,72,12.415454461,7.0416010377,5.3738534235,2.9648846475,-11.6742333,-8.709348652
2020,Kansas,Sumner County,22578,-232,249,276,-27,1,-206,-205,0,409,10.9720631,12.161804882,-1.189741782,0.0440645104,-9.077289151,-9.033224641
2020,Kansas,Thomas County,7702,-2,102,63,39,6,-48,-42,1,353,13.241594184,8.1786317019,5.0629624821,0.7789173049,-6.23133844,-5.452421135
2020,Kansas,Trego County,2758,-21,31,46,-15,1,-6,-5,-1,64,11.197399314,16.615495756,-5.418096442,0.3612064295,-2.167238577,-1.806032147
2020,Kansas,Wabaunsee County,6906,14,68,58,10,1,3,4,0,90,9.8565009422,8.4070155095,1.4494854327,0.1449485433,0.4348456298,0.5797941731
2020,Kansas,Wallace County,1536,18,31,10,21,0,-4,-4,1,19,20.30124427,6.5487884741,13.752455796,0.0,-2.61951539,-2.61951539
2020,Kansas,Washington County,5427,-22,76,88,-12,1,-11,-10,0,114,13.97572637,16.182420007,-2.206693637,0.1838911364,-2.022802501,-1.838911364
2020,Kansas,Wichita County,2074,-44,22,21,1,2,-47,-45,0,26,10.496183206,10.019083969,0.4770992366,0.9541984733,-22.42366412,-21.46946565
2020,Kansas,Wilson County,8362,-193,94,114,-20,0,-172,-172,-1,121,11.113081516,13.477566944,-2.364485429,0.0,-20.33457469,-20.33457469
2020,Kansas,Woodson County,3015,-81,21,45,-24,-1,-56,-57,0,39,6.8728522337,14.727540501,-7.854688267,-0.327278678,-18.32760596,-18.65488463
2020,Kansas,Wyandotte County,165265,-744,2572,1523,1049,366,-2153,-1787,-6,1335,15.527931561,9.1948055084,6.3331260528,2.2096512253,-12.99830352,-10.78865229
2020,Kentucky,Kentucky,4477251,4906,52831,49879,2952,2210,-308,1902,52,131670,11.80634299,11.146648407,0.6596945829,0.493877042,-0.068829923,0.4250471194
2020,Kentucky,Adair County,19555,83,182,233,-51,2,134,136,-2,1487,9.3268762651,11.940451482,-2.613575217,0.1024931458,6.8670407666,6.9695339124
2020,Kentucky,Allen County,21303,-17,247,265,-18,-1,1,0,1,197,11.589986627,12.434601037,-0.84461441,-0.046923023,0.0469230228,0.0
2020,Kentucky,Anderson County,22833,133,241,214,27,7,97,104,2,108,10.585729032,9.3997759866,1.185953045,0.307469308,4.2606461248,4.5681154328
2020,Kentucky,Ballard County,7769,-48,74,107,-33,-1,-14,-15,0,127,9.4957012704,13.730270756,-4.234569485,-0.128320287,-1.796484024,-1.924804312
2020,Kentucky,Barren County,44300,115,558,563,-5,5,113,118,2,702,12.612307171,12.725320676,-0.113013505,0.1130135051,2.5541052156,2.6671187207
2020,Kentucky,Bath County,12481,-51,183,167,16,1,-69,-68,1,103,14.632391157,13.353056411,1.2793347459,0.0799584216,-5.517131092,-5.43717267
2020,Kentucky,Bell County,25482,-544,317,403,-86,-1,-453,-454,-4,919,12.30876757,15.648054671,-3.339287101,-0.03882892,-17.58950066,-17.62832958
2020,Kentucky,Boone County,135396,1726,1668,1081,587,88,1050,1138,1,834,12.398444991,8.0352032587,4.3632417325,0.6541146039,7.8047765232,8.4588911271
2020,Kentucky,Bourbon County,19901,127,209,250,-41,-7,177,170,-2,236,10.535601764,12.602394455,-2.066792691,-0.352867045,8.9224952741,8.5696282294
2020,Kentucky,Boyd County,46516,-323,476,647,-171,-5,-144,-149,-3,1911,10.197632692,13.861067966,-3.663435274,-0.10711799,-3.084998125,-3.192116116
2020,Kentucky,Boyle County,30367,367,309,360,-51,11,410,421,-3,3193,10.237381351,11.927046234,-1.689664883,0.3644375238,13.583580433,13.948017957
2020,Kentucky,Bracken County,8286,-44,99,102,-3,0,-43,-43,2,41,11.916225325,12.277323062,-0.361097737,0.0,-5.175734232,-5.175734232
2020,Kentucky,Breathitt County,12550,-62,162,202,-40,0,-22,-22,0,321,12.876559892,16.055957396,-3.179397504,0.0,-1.748668627,-1.748668627
2020,Kentucky,Breckinridge County,20537,66,235,219,16,-2,52,50,0,299,11.461178307,10.680842762,0.7803355443,-0.097541943,2.5360905189,2.4385485759
2020,Kentucky,Bullitt County,82182,379,775,731,44,-1,333,332,3,340,9.4520840321,8.9154495838,0.5366344483,-0.012196237,4.0613470744,4.049150837
2020,Kentucky,Butler County,12703,-158,160,167,-7,3,-153,-150,-1,203,12.517602879,13.065248005,-0.547645126,0.234705054,-11.96995775,-11.7352527
2020,Kentucky,Caldwell County,12687,-44,143,183,-40,-1,-2,-3,-1,148,11.251868754,14.39924463,-3.147375875,-0.078684397,-0.157368794,-0.236053191
2020,Kentucky,Calloway County,39300,227,339,445,-106,47,286,333,0,3238,8.6509384609,11.355951667,-2.705013206,1.199392648,7.2984318579,8.4978245059
2020,Kentucky,Campbell County,94020,179,1088,962,126,57,-8,49,4,3201,11.583032135,10.241614811,1.3414173245,0.6068316468,-0.085169354,0.5216622929
2020,Kentucky,Carlisle County,4692,-29,59,73,-14,0,-16,-16,1,60,12.535854669,15.510464252,-2.974609582,0.0,-3.399553809,-3.399553809
2020,Kentucky,Carroll County,10730,72,144,138,6,0,66,66,0,325,13.46549467,12.904432392,0.5610622779,0.0,6.171685057,6.171685057
2020,Kentucky,Carter County,26542,-224,289,391,-102,2,-124,-122,0,595,10.842650259,14.669467997,-3.826817738,0.0750356419,-4.6522098,-4.577174158
2020,Kentucky,Casey County,16066,-138,189,220,-31,-1,-105,-106,-1,477,11.713665944,13.634955067,-1.921289123,-0.061977068,-6.507592191,-6.569569259
2020,Kentucky,Christian County,71478,-99,1530,660,870,6,-968,-962,-7,6200,21.390374332,9.2272202999,12.163154032,0.0838838209,-13.53325644,-13.44937262
2020,Kentucky,Clark County,36463,183,420,421,-1,2,182,184,0,458,11.547502853,11.574996907,-0.027494054,0.0549881088,5.0039179028,5.0589060116
2020,Kentucky,Clay County,19631,-281,217,258,-41,2,-242,-240,0,1621,10.975393875,13.049085805,-2.07369193,0.1011557039,-12.23984017,-12.13868447
2020,Kentucky,Clinton County,10110,-90,112,134,-22,-1,-67,-68,0,136,11.029049729,13.195470212,-2.166420483,-0.098473658,-6.597735106,-6.696208764
2020,Kentucky,Crittenden County,8847,40,92,116,-24,0,64,64,0,210,10.422567124,13.141497678,-2.718930554,0.0,7.2504814773,7.2504814773
2020,Kentucky,Cumberland County,6523,-103,76,119,-43,0,-60,-60,0,86,11.559814435,18.100235759,-6.540421325,0.0,-9.12616929,-9.12616929
2020,Kentucky,Daviess County,101978,423,1308,1143,165,67,187,254,4,2741,12.852952592,11.231593894,1.6213586986,0.6583698958,1.8375398584,2.4959097542
2020,Kentucky,Edmonson County,12235,86,114,163,-49,-1,138,137,-2,354,9.3503937008,13.369422572,-4.019028871,-0.082020997,11.318897638,11.23687664
2020,Kentucky,Elliott County,7372,-113,61,84,-23,-2,-88,-90,0,1032,8.2116174194,11.307801037,-3.096183617,-0.269233358,-11.84626775,-12.11550111
2020,Kentucky,Estill County,14109,-34,145,194,-49,0,16,16,-1,118,10.264760017,13.733540988,-3.468780971,0.0,1.1326631743,1.1326631743
2020,Kentucky,Fayette County,324735,813,3839,2545,1294,421,-920,-499,18,13048,11.836764268,7.8469823034,3.9897819649,1.2980666207,-2.836630145,-1.538563524
2020,Kentucky,Fleming County,14603,29,199,183,16,0,13,13,0,22,13.640881516,12.544127223,1.0967542928,0.0,0.8911128629,0.8911128629
2020,Kentucky,Floyd County,34974,-541,415,589,-174,-1,-367,-368,1,668,11.774886862,16.711827377,-4.936940516,-0.028373221,-10.41297224,-10.44134546
2020,Kentucky,Franklin County,51118,231,544,576,-32,31,230,261,2,1878,10.666143816,11.293564041,-0.627420224,0.6078133425,4.5095828636,5.1173962061
2020,Kentucky,Fulton County,5952,-37,61,102,-41,0,5,5,-1,444,10.216899757,17.083996315,-6.867096558,0.0,0.8374507998,0.8374507998
2020,Kentucky,Gallatin County,8779,-63,100,82,18,2,-82,-80,-1,85,11.350093638,9.3070767834,2.0430168549,0.2270018728,-9.307076783,-9.080074911
2020,Kentucky,Garrard County,17719,35,182,196,-14,-1,49,48,1,109,10.281614552,11.07250798,-0.790893427,-0.056492388,2.7681269949,2.7116346072
2020,Kentucky,Grant County,25387,267,363,261,102,-3,169,166,-1,456,14.374245154,10.335201061,4.0390440929,-0.118795414,6.6921416833,6.5733462688
2020,Kentucky,Graves County,36818,-352,483,474,9,11,-369,-358,-3,463,13.056171271,12.812888577,0.2432826945,0.2973455155,-9.974590474,-9.677244959
2020,Kentucky,Grayson County,26480,45,314,326,-12,1,55,56,1,766,11.868090334,12.321647926,-0.453557592,0.037796466,2.0788056317,2.1166020977
2020,Kentucky,Green County,10995,46,107,150,-43,0,90,90,-1,113,9.752096245,13.67116296,-3.919066715,0.0,8.2026977762,8.2026977762
2020,Kentucky,Greenup County,34865,-299,354,522,-168,3,-134,-131,0,454,10.110097245,14.908109497,-4.798012252,0.0856787902,-3.826985963,-3.741307173
2020,Kentucky,Hancock County,8742,26,100,98,2,0,24,24,0,90,11.456065987,11.226944667,0.2291213197,0.0,2.7494558369,2.7494558369
2020,Kentucky,Hardin County,111309,339,1377,1041,336,16,-21,-5,8,3190,12.389834397,9.366606832,3.0232275654,0.1439632174,-0.188951723,-0.044988505
2020,Kentucky,Harlan County,25566,-394,293,436,-143,2,-252,-250,-1,627,11.372899119,16.923494935,-5.550595816,0.0776307107,-9.781469549,-9.703838839
2020,Kentucky,Harrison County,18920,82,232,243,-11,0,93,93,0,275,12.288786482,12.871444462,-0.58265798,0.0,4.9261083744,4.9261083744
2020,Kentucky,Hart County,19013,-1,254,218,36,0,-39,-39,2,227,13.358929182,11.465537644,1.8933915376,0.0,-2.051174166,-2.051174166
2020,Kentucky,Henderson County,44740,-536,497,572,-75,3,-464,-461,0,1164,11.042481337,12.70885176,-1.666370423,0.0666548169,-10.30927835,-10.24262353
2020,Kentucky,Henry County,16067,4,161,190,-29,2,32,34,-1,80,10.021786492,11.826953003,-1.805166511,0.1244942421,1.9919078743,2.1164021164
2020,Kentucky,Hickman County,4364,-1,37,70,-33,0,33,33,-1,212,8.4774888303,16.038492382,-7.561003551,0.0,7.5610035514,7.5610035514
2020,Kentucky,Hopkins County,44662,2,523,598,-75,15,60,75,2,1084,11.710440877,13.389758402,-1.679317525,0.3358635051,1.3434540203,1.6793175254
2020,Kentucky,Jackson County,13340,24,158,173,-15,0,39,39,0,110,11.854741897,12.980192077,-1.12545018,0.0,2.9261704682,2.9261704682
2020,Kentucky,Jefferson County,767452,-333,9433,8281,1152,980,-2492,-1512,27,17013,12.288656409,10.787910922,1.5007454875,1.2766758487,-3.246404301,-1.969728452
2020,Kentucky,Jessamine County,54057,45,619,492,127,19,-104,-85,3,1634,11.455644079,9.10529384,2.3503502392,0.3516272011,-1.924696259,-1.573069058
2020,Kentucky,Johnson County,22002,-186,223,321,-98,-3,-84,-87,-1,528,10.092781172,14.528173795,-4.435392623,-0.135777325,-3.801765105,-3.93754243
2020,Kentucky,Kenton County,167949,616,2180,1612,568,57,-12,45,3,2661,13.00397874,9.6157861144,3.3881926259,0.3400122882,-0.071581534,0.2684307538
2020,Kentucky,Knott County,14512,-349,134,204,-70,-3,-275,-278,-1,764,9.1240254656,13.890307425,-4.76628196,-0.204269227,-18.72467913,-18.92894835
2020,Kentucky,Knox County,31022,-129,396,470,-74,5,-63,-58,3,656,12.73864861,15.119103148,-2.380454538,0.1608415228,-2.026603188,-1.865761665
2020,Kentucky,Larue County,14431,38,157,171,-14,-1,52,51,1,313,10.893699695,11.865112406,-0.971412712,-0.069386622,3.6081043575,3.5387177352
2020,Kentucky,Laurel County,61238,396,713,737,-24,-4,424,420,0,695,11.680865007,12.074049803,-0.393184797,-0.065530799,6.9462647444,6.880733945
2020,Kentucky,Lawrence County,15436,41,214,223,-9,5,45,50,0,108,13.882131621,14.465959586,-0.583827965,0.3243488696,2.9191398268,3.2434886964
2020,Kentucky,Lee County,7268,-122,75,120,-45,0,-77,-77,0,990,10.233319689,16.373311502,-6.139991813,0.0,-10.50620821,-10.50620821
2020,Kentucky,Leslie County,9637,-243,96,178,-82,2,-162,-160,-1,227,9.8375774965,18.240508275,-8.402930778,0.2049495312,-16.60091203,-16.39596249
2020,Kentucky,Letcher County,21213,-347,228,342,-114,1,-232,-231,-2,243,10.660930961,15.991396442,-5.330465481,0.0467584691,-10.84796484,-10.80120637
2020,Kentucky,Lewis County,13262,-47,168,169,-1,0,-44,-44,-2,139,12.645365248,12.720635279,-0.075270031,0.0,-3.311881374,-3.311881374
2020,Kentucky,Lincoln County,24466,-53,317,317,0,-2,-52,-54,1,219,12.942737573,12.942737573,0.0,-0.08165765,-2.123098908,-2.204756558
2020,Kentucky,Livingston County,9041,-107,82,134,-52,0,-55,-55,0,69,9.0164385068,14.734179999,-5.717741492,0.0,-6.047611194,-6.047611194
2020,Kentucky,Logan County,27416,305,377,318,59,-2,249,247,-1,277,13.828011811,11.663946302,2.1640655088,-0.073358153,9.1330900288,9.059731876
2020,Kentucky,Lyon County,8133,-123,45,131,-86,-4,-33,-37,0,1123,5.4914881933,15.986332296,-10.4948441,-0.488132284,-4.027091342,-4.515223626
2020,Kentucky,McCracken County,65644,22,735,863,-128,-3,151,148,2,1190,11.198634833,13.14887328,-1.950238447,-0.045708714,2.3006719181,2.2549632045
2020,Kentucky,McCreary County,17071,-189,196,201,-5,10,-194,-184,0,1903,11.418251726,11.709533658,-0.291281932,0.5825638636,-11.30173895,-10.71917509
2020,Kentucky,McLean County,9075,-87,96,116,-20,0,-67,-67,0,82,10.528047376,12.72139058,-2.193343203,0.0,-7.347699731,-7.347699731
2020,Kentucky,Madison County,94265,1166,1004,843,161,26,979,1005,0,6480,10.717106808,8.9985269315,1.7185798766,0.2775346385,10.450246579,10.727781217
2020,Kentucky,Magoffin County,12017,-167,135,180,-45,0,-121,-121,-1,127,11.156563778,14.875418371,-3.718854593,0.0,-9.999586794,-9.999586794
2020,Kentucky,Marion County,19314,77,229,207,22,-2,56,54,1,504,11.880366268,10.739021037,1.141345231,-0.103758657,2.9052424062,2.8014837488
2020,Kentucky,Marshall County,31163,50,278,460,-182,1,233,234,-2,464,8.9279979446,14.772946239,-5.844948295,0.0321151005,7.4828184212,7.5149335217
2020,Kentucky,Martin County,11031,-227,102,151,-49,-1,-177,-178,0,1376,9.1524967473,13.5492844,-4.396787653,-0.08973036,-15.88227377,-15.97200413
2020,Kentucky,Mason County,17035,-14,210,221,-11,-1,-3,-4,1,298,12.322497359,12.967961507,-0.645464147,-0.058678559,-0.176035677,-0.234714235
2020,Kentucky,Meade County,28616,6,260,259,1,-2,6,4,1,212,9.0867787369,9.0518295879,0.034949149,-0.069898298,0.2096948939,0.139796596
2020,Kentucky,Menifee County,6502,19,60,92,-32,0,50,50,1,271,9.241432422,14.17019638,-4.928763958,0.0,7.701193685,7.701193685
2020,Kentucky,Mercer County,21889,-32,241,300,-59,1,24,25,2,128,11.002054325,13.69550331,-2.693448984,0.0456516777,1.0956402648,1.1412919425
2020,Kentucky,Metcalfe County,10058,-26,114,164,-50,0,25,25,-1,121,11.319630623,16.284380896,-4.964750273,0.0,2.4823751365,2.4823751365
2020,Kentucky,Monroe County,10549,-105,129,155,-26,0,-77,-77,-2,143,12.168089421,14.62057256,-2.452483139,0.0,-7.263123143,-7.263123143
2020,Kentucky,Montgomery County,28186,-11,345,319,26,-8,-30,-38,1,357,12.237731231,11.315467428,0.9222638029,-0.283773478,-1.064150542,-1.34792402
2020,Kentucky,Morgan County,13142,-155,115,164,-49,6,-112,-106,0,1811,8.6992700178,12.405915504,-3.706645486,0.4538749574,-8.472332539,-8.018457582
2020,Kentucky,Muhlenberg County,30457,-224,358,438,-80,-3,-143,-146,2,2065,11.711210704,14.328241028,-2.617030325,-0.098138637,-4.677941706,-4.776080343
2020,Kentucky,Nelson County,46450,229,551,453,98,0,128,128,3,496,11.891530252,9.7765212418,2.1150090104,0.0,2.7624607482,2.7624607482
2020,Kentucky,Nicholas County,7234,-14,81,109,-28,0,13,13,1,95,11.186300235,15.053169452,-3.866869217,0.0,1.7953321364,1.7953321364
2020,Kentucky,Ohio County,23899,-144,269,284,-15,0,-128,-128,-1,307,11.221893121,11.847649243,-0.625756122,0.0,-5.339785574,-5.339785574
2020,Kentucky,Oldham County,66999,181,571,454,117,-1,71,70,-6,4347,8.5340427599,6.7853860122,1.7486567476,-0.014945784,1.0611506759,1.0462048918
2020,Kentucky,Owen County,11017,133,104,121,-17,0,151,151,-1,0,9.4972832291,11.049723757,-1.552440528,0.0,13.789324688,13.789324688
2020,Kentucky,Owsley County,4331,-82,51,78,-27,0,-54,-54,-1,90,11.665141812,17.840805124,-6.175663312,0.0,-12.35132662,-12.35132662
2020,Kentucky,Pendleton County,14586,20,180,177,3,3,13,16,1,215,12.349066959,12.143249177,0.2058177827,0.2058177827,0.8918770582,1.0976948408
2020,Kentucky,Perry County,25456,-345,313,470,-157,15,-202,-187,-1,611,12.212966034,18.338958581,-6.125992547,0.5852859122,-7.881850284,-7.296564372
2020,Kentucky,Pike County,57057,-862,573,869,-296,8,-571,-563,-3,1443,9.967297523,15.116198163,-5.14890064,0.1391594768,-9.932507654,-9.793348177
2020,Kentucky,Powell County,12218,-85,162,170,-8,-1,-76,-77,0,188,13.213164227,13.865666164,-0.652501937,-0.081562742,-6.198768403,-6.280331145
2020,Kentucky,Pulaski County,65530,287,748,851,-103,13,376,389,1,962,11.439670268,13.014918982,-1.575248713,0.1988177988,5.7504224878,5.9492402866
2020,Kentucky,Robertson County,2136,-13,20,22,-2,0,-10,-10,-1,57,9.3348891482,10.268378063,-0.933488915,0.0,-4.667444574,-4.667444574
2020,Kentucky,Rockcastle County,16750,14,160,260,-100,-1,115,114,0,341,9.5562324554,15.52887774,-5.972645285,-0.059726453,6.8685420773,6.8088156244
2020,Kentucky,Rowan County,24682,163,254,224,30,5,126,131,2,2991,10.324993394,9.1055059857,1.2194874088,0.2032479015,5.1218471169,5.3250950184
2020,Kentucky,Russell County,17998,54,210,247,-37,-5,96,91,0,177,11.685493295,13.744365923,-2.058872628,-0.278226031,5.3419397919,5.0637137611
2020,Kentucky,Scott County,58470,1391,713,448,265,8,1121,1129,-3,1092,12.341084735,7.7542860605,4.5867986742,0.1384693939,19.403023825,19.541493219
2020,Kentucky,Shelby County,49611,589,570,389,181,33,374,407,1,1759,11.55799783,7.8878265895,3.6701712409,0.6691472428,7.5836687518,8.2528159946
2020,Kentucky,Simpson County,18635,105,218,205,13,4,86,90,2,327,11.731467779,11.031884838,0.6995829409,0.2152562895,4.6280102247,4.8432665142
2020,Kentucky,Spencer County,19585,283,189,174,15,-2,271,269,-1,113,9.7204721372,8.9490060946,0.7714660426,-0.102862139,13.937819837,13.834957698
2020,Kentucky,Taylor County,25707,-28,307,352,-45,20,-4,16,1,1337,11.935772326,13.685315501,-1.749543175,0.7775747444,-0.155514949,0.6220597955
2020,Kentucky,Todd County,12448,130,170,131,39,-4,97,93,-2,195,13.728498748,10.579019624,3.1494791246,-0.3230235,7.833319874,7.5102963741
2020,Kentucky,Trigg County,14776,110,165,188,-23,1,134,135,-2,78,11.208477685,12.770871544,-1.562393859,0.0679301678,9.1026424835,9.1705726513
2020,Kentucky,Trimble County,8481,-48,92,109,-17,-2,-31,-33,2,41,10.817166373,12.815990594,-1.998824221,-0.235155791,-3.644914756,-3.880070547
2020,Kentucky,Union County,14443,-54,151,172,-21,2,-36,-34,1,1660,10.435383552,11.886662059,-1.451278507,0.1382170007,-2.487906012,-2.349689012
2020,Kentucky,Warren County,134510,1751,1728,1086,642,254,850,1104,5,6496,12.930792572,8.126643943,4.8041486293,1.9007067786,6.3606329204,8.261339699
2020,Kentucky,Washington County,12147,49,158,146,12,0,37,37,0,205,13.033615178,12.043720355,0.9898948237,0.0,3.0521757063,3.0521757063
2020,Kentucky,Wayne County,20209,-69,213,253,-40,-2,-29,-31,2,331,10.521895917,12.497838812,-1.975942895,-0.098797145,-1.432558599,-1.531355744
2020,Kentucky,Webster County,12923,-22,175,148,27,2,-50,-48,-1,393,13.5302304,11.442709139,2.0875212618,0.1546312046,-3.865780114,-3.71114891
2020,Kentucky,Whitley County,36451,89,511,482,29,14,45,59,1,1895,14.035955118,13.239394064,0.7965610537,0.3845467156,1.2360430143,1.6205897299
2020,Kentucky,Wolfe County,7106,-45,80,128,-48,0,3,3,0,132,11.22255734,17.956091744,-6.733534404,0.0,0.4208459003,0.4208459003
2020,Kentucky,Woodford County,26765,111,266,266,0,-6,119,113,-2,519,9.9590033509,9.9590033509,0.0,-0.224639173,4.4553436043,4.230704431
2020,Louisiana,Louisiana,4645318,-12967,57616,50108,7508,4928,-25334,-20406,-69,129720,12.385739159,10.771740798,1.6139983617,1.059374524,-5.446062133,-4.386687609
2020,Louisiana,Acadia Parish,61918,-289,802,753,49,33,-371,-338,0,1050,12.9224572,12.132930514,0.7895266868,0.5317220544,-5.977844914,-5.44612286
2020,Louisiana,Allen Parish,25440,-154,297,269,28,18,-198,-180,-2,4181,11.639299291,10.541991613,1.0973076772,0.7054120782,-7.75953286,-7.054120782
2020,Louisiana,Ascension Parish,128665,1867,1680,1029,651,91,1125,1216,0,788,13.152589612,8.0559611372,5.0966284746,0.7124319373,8.8075376865,9.5199696238
2020,Louisiana,Assumption Parish,21621,-300,231,240,-9,10,-299,-289,-2,199,10.610445088,11.023839052,-0.413393964,0.4593266272,-13.73386615,-13.27453953
2020,Louisiana,Avoyelles Parish,39966,-172,497,490,7,12,-191,-179,0,3348,12.408868471,12.234095676,0.1747727954,0.2996105063,-4.768800559,-4.469190053
2020,Louisiana,Beauregard Parish,37881,232,513,449,64,30,136,166,2,1294,13.584006355,11.889315504,1.6946908513,0.7943863366,3.601218059,4.3956043956
2020,Louisiana,Bienville Parish,12983,-251,155,213,-58,5,-196,-191,-2,319,11.824388755,16.248998741,-4.424609986,0.3814318953,-14.9521303,-14.5706984
2020,Louisiana,Bossier Parish,127275,-102,1635,1207,428,100,-633,-533,3,2560,12.841053673,9.4796035374,3.3614501359,0.7853855458,-4.971490505,-4.186104959
2020,Louisiana,Caddo Parish,237479,-2952,2918,2925,-7,103,-3032,-2929,-16,6246,12.211504258,12.240798477,-0.029294219,0.4310435019,-12.68858153,-12.25753803
2020,Louisiana,Calcasieu Parish,203310,-728,2969,2214,755,173,-1655,-1482,-1,3792,14.577216532,10.870312362,3.7069041704,0.8493965847,-8.125730334,-7.276333749
2020,Louisiana,Caldwell Parish,9839,-107,122,137,-15,5,-96,-91,-1,584,12.332575183,13.848875411,-1.516300227,0.5054334091,-9.704321456,-9.198888046
2020,Louisiana,Cameron Parish,7003,22,74,77,-3,-3,29,26,-1,20,10.583524027,11.012585812,-0.429061785,-0.429061785,4.147597254,3.7185354691
2020,Louisiana,Catahoula Parish,9226,-233,99,127,-28,1,-205,-204,-1,866,10.596735349,13.593791812,-2.997056462,0.1070377308,-21.94273481,-21.83569708
2020,Louisiana,Claiborne Parish,15508,-210,118,209,-91,1,-118,-117,-2,2923,7.5578043938,13.386280664,-5.82847627,0.0640491898,-7.557804394,-7.493755204
2020,Louisiana,Concordia Parish,18914,-400,243,256,-13,-2,-381,-383,-4,1480,12.713194517,13.393324265,-0.680129748,-0.104635346,-19.93303338,-20.03766872
2020,Louisiana,De Soto Parish,27650,210,316,316,0,0,210,210,0,215,11.472136504,11.472136504,0.0,0.0,7.623888183,7.623888183
2020,Louisiana,East Baton Rouge Parish,439729,-1742,5610,4199,1411,862,-4013,-3151,-2,11126,12.732637313,9.5301861099,3.2024512029,1.9564230595,-9.108034498,-7.151611439
2020,Louisiana,East Carroll Parish,6589,-240,69,76,-7,-2,-228,-230,-3,1067,10.284692205,11.328066776,-1.043374571,-0.29810702,-33.98420033,-34.28230735
2020,Louisiana,East Feliciana Parish,18882,-221,172,246,-74,4,-150,-146,-1,2417,9.0562063973,12.952481243,-3.896274845,0.2106094511,-7.897854416,-7.687244965
2020,Louisiana,Evangeline Parish,33276,-120,480,422,58,62,-240,-178,0,1379,14.398848092,12.658987281,1.7398608111,1.8598512119,-7.199424046,-5.339572834
2020,Louisiana,Franklin Parish,19723,-273,245,294,-49,1,-222,-221,-3,732,12.336665072,14.803998087,-2.467333014,0.050353735,-11.17852917,-11.12817543
2020,Louisiana,Grant Parish,22254,-98,242,209,33,9,-140,-131,0,2960,10.850558221,9.3709366453,1.4796215756,0.403533157,-6.277182442,-5.873649285
2020,Louisiana,Iberia Parish,68991,-647,888,836,52,41,-736,-695,-4,944,12.811172266,12.060968484,0.7502037813,0.5915068276,-10.6182689,-10.02676208
2020,Louisiana,Iberville Parish,32070,-479,377,339,38,0,-514,-514,-3,3988,11.668394745,10.492270075,1.1761246692,0.0,-15.90863368,-15.90863368
2020,Louisiana,Jackson Parish,15574,-187,133,242,-109,1,-79,-78,0,1037,8.4889101644,15.445986916,-6.957076751,0.0638263922,-5.042284985,-4.978458593
2020,Louisiana,Jefferson Parish,432346,-1750,5467,4679,788,1474,-4000,-2526,-12,3311,12.619425189,10.800492128,1.8189330619,3.4024204736,-9.233162751,-5.830742277
2020,Louisiana,Jefferson Davis Parish,31208,-236,398,432,-34,9,-212,-203,1,567,12.705101194,13.790461597,-1.085360403,0.2873012833,-6.767541339,-6.480240056
2020,Louisiana,Lafayette Parish,246518,1720,3157,2188,969,260,471,731,20,5160,12.851199635,8.9066914165,3.9445082187,1.0583819782,1.9172996605,2.9756816387
2020,Louisiana,Lafourche Parish,97596,-22,1116,984,132,74,-233,-159,5,1627,11.433606196,10.081244173,1.3523620232,0.7581423463,-2.387123874,-1.628981528
2020,Louisiana,LaSalle Parish,15021,111,176,191,-15,7,119,126,0,1240,11.760382212,12.762687515,-1.002305302,0.4677424744,7.9516220641,8.4193645384
2020,Louisiana,Lincoln Parish,46552,-299,502,452,50,91,-439,-348,-1,4904,10.749119407,9.6784899843,1.070629423,1.9485455499,-9.400126334,-7.451580784
2020,Louisiana,Livingston Parish,143737,2176,1775,1269,506,55,1622,1677,-7,1189,12.44312964,8.8959614158,3.5471682241,0.3855617635,11.370566916,11.756128679
2020,Louisiana,Madison Parish,10635,-359,137,157,-20,0,-335,-335,-4,1600,12.668176985,14.517545887,-1.849368903,0.0,-30.97692912,-30.97692912
2020,Louisiana,Morehouse Parish,24227,-612,293,363,-70,0,-538,-538,-4,768,11.943097053,14.79639669,-2.853299637,0.0,-21.92964578,-21.92964578
2020,Louisiana,Natchitoches Parish,37655,-524,440,424,16,21,-557,-536,-4,2196,11.604293589,11.182319276,0.4219743123,0.5538412849,-14.68998075,-14.13613946
2020,Louisiana,Orleans Parish,389476,-1696,4445,3961,484,561,-2741,-2180,0,13521,11.387975118,10.147979627,1.2399954909,1.4372675008,-7.022371158,-5.585103657
2020,Louisiana,Ouachita Parish,152439,-962,1985,1777,208,86,-1256,-1170,0,5546,12.980643474,11.62045514,1.3601883338,0.5623855611,-8.213444939,-7.651059377
2020,Louisiana,Plaquemines Parish,23113,-151,257,206,51,24,-225,-201,-1,272,11.083079975,8.8837139099,2.1993660651,1.0349957953,-9.703085581,-8.668089786
2020,Louisiana,Pointe Coupee Parish,21529,-206,254,270,-16,2,-192,-190,0,116,11.741863905,12.481508876,-0.73964497,0.0924556213,-8.875739645,-8.783284024
2020,Louisiana,Rapides Parish,128567,-1233,1662,1533,129,50,-1410,-1360,-2,4501,12.865420119,11.866840579,0.99857954,0.3870463333,-10.9147066,-10.52766027
2020,Louisiana,Red River Parish,8286,-94,98,145,-47,10,-56,-46,-1,164,11.760470419,17.400696028,-5.640225609,1.2000480019,-6.720268811,-5.520220809
2020,Louisiana,Richland Parish,20014,-133,274,266,8,0,-142,-142,1,1037,13.645078559,13.246682105,0.3983964543,0.0,-7.071537063,-7.071537063
2020,Louisiana,Sabine Parish,23803,-92,269,257,12,0,-105,-105,1,438,11.279298922,10.776133171,0.5031657512,0.0,-4.402700323,-4.402700323
2020,Louisiana,St. Bernard Parish,47647,455,556,438,118,61,274,335,2,293,11.725134175,9.2367064182,2.4884277565,1.2863906199,5.7782136041,7.064604224
2020,Louisiana,St. Charles Parish,52987,-96,576,494,82,36,-216,-180,2,592,10.860752333,9.3146035637,1.5461487697,0.6787970208,-4.072782125,-3.393985104
2020,Louisiana,St. Helena Parish,10081,-64,115,109,6,-1,-68,-69,-1,121,11.371502027,10.778206269,0.5932957579,-0.098882626,-6.72401859,-6.822901216
2020,Louisiana,St. James Parish,20727,-318,238,255,-17,0,-298,-298,-3,204,11.395192952,12.209135306,-0.813942354,0.0,-14.26793067,-14.26793067
2020,Louisiana,St. John the Baptist Parish,42516,-308,493,449,44,27,-380,-353,1,471,11.553784861,10.522615421,1.0311694399,0.6327630654,-8.905554254,-8.272791188
2020,Louisiana,St. Landry Parish,81440,-756,1119,1083,36,15,-804,-789,-3,1105,13.676697059,13.236696082,0.4400009778,0.1833337407,-9.826688504,-9.643354763
2020,Louisiana,St. Martin Parish,52954,-543,649,584,65,31,-636,-605,-3,701,12.193403538,10.972184385,1.2212191525,0.5824275958,-11.94915971,-11.36673211
2020,Louisiana,St. Mary Parish,48330,-964,602,595,7,26,-991,-965,-6,868,12.333032861,12.189625502,0.1434073588,0.5326559043,-20.30238466,-19.76972876
2020,Louisiana,St. Tammany Parish,263446,2143,2892,2656,236,215,1692,1907,0,1277,11.02241262,10.122934965,0.899477655,0.8194393891,6.4487974251,7.2682368142
2020,Louisiana,Tangipahoa Parish,136765,1920,1874,1503,371,63,1485,1548,1,3646,13.799197379,11.0673392,2.731858179,0.4639004455,10.934796215,11.398696661
2020,Louisiana,Tensas Parish,4178,-141,38,67,-29,0,-111,-111,-1,16,8.9443332941,15.770271861,-6.825938567,0.0,-26.12686831,-26.12686831
2020,Louisiana,Terrebonne Parish,109859,-756,1437,1207,230,54,-1037,-983,-3,1479,13.035550677,10.94913686,2.0864138175,0.4898536789,-9.407004908,-8.917151229
2020,Louisiana,Union Parish,22170,102,232,266,-34,15,121,136,0,476,10.488720105,12.02586012,-1.537140015,0.6781500068,5.4704100547,6.1485600615
2020,Louisiana,Vermilion Parish,59378,-195,732,653,79,15,-292,-277,3,537,12.307588839,10.979310809,1.3282780304,0.2522046893,-4.909584619,-4.65737993
2020,Louisiana,Vernon Parish,47894,-500,809,399,410,60,-963,-903,-7,3373,16.8037554,8.2876370887,8.5161183117,1.2462612164,-20.00249252,-18.75623131
2020,Louisiana,Washington Parish,45773,-385,513,682,-169,6,-223,-217,1,1583,11.160544321,14.837214868,-3.676670546,0.1305326821,-4.851464685,-4.720932003
2020,Louisiana,Webster Parish,37943,-380,420,581,-161,5,-224,-219,0,1231,11.014082291,15.236147169,-4.222064878,0.1311200273,-5.874177222,-5.743057195
2020,Louisiana,West Baton Rouge Parish,26792,242,351,240,111,0,129,129,2,556,13.160361441,8.9985377376,4.1618237036,0.0,4.836714034,4.836714034
2020,Louisiana,West Carroll Parish,10646,-260,115,159,-44,7,-221,-214,-2,434,10.6718634,14.755011136,-4.083147736,0.6495916852,-20.50853749,-19.85894581
2020,Louisiana,West Feliciana Parish,15465,-105,124,136,-12,16,-108,-92,-1,5320,7.9909779281,8.7642983728,-0.773320445,1.0310939262,-6.959884002,-5.928790076
2020,Louisiana,Winn Parish,13839,-122,141,224,-83,-2,-37,-39,0,1765,10.143884892,16.115107914,-5.971223022,-0.143884892,-2.661870504,-2.805755396
2020,Maine,Maine,1350141,4371,12209,15562,-3353,1605,6114,7719,5,36221,9.0574206641,11.544891504,-2.48747084,1.190692126,4.5357580425,5.7264501684
2020,Maine,Androscoggin County,108547,186,1211,1176,35,158,-10,148,3,3165,11.166024305,10.84330684,0.3227174655,1.4568388441,-0.09220499,1.364633854
2020,Maine,Aroostook County,66804,-288,613,942,-329,55,-16,39,2,2192,9.1563601601,14.070621975,-4.914261815,0.8215331302,-0.238991456,0.5825416741
2020,Maine,Cumberland County,298111,2059,2737,2958,-221,740,1531,2271,9,9327,9.21296008,9.9568636889,-0.743903609,2.4908989621,5.1534679877,7.6443669498
2020,Maine,Franklin County,29986,-60,232,364,-132,5,67,72,0,1024,7.7292110874,12.126865672,-4.397654584,0.1665778252,2.2321428571,2.3987206823
2020,Maine,Hancock County,55088,-10,418,715,-297,56,232,288,-1,927,7.5871707839,12.978055288,-5.390884504,1.0164630715,4.2110612964,5.2275243679
2020,Maine,Kennebec County,122955,714,1141,1503,-362,72,1007,1079,-3,3749,9.3068402421,12.259580091,-2.952739849,0.5872852738,8.2138370936,8.8011223674
2020,Maine,Knox County,39951,159,305,481,-176,17,319,336,-1,1414,7.6495742573,12.063754812,-4.414180555,0.4263697127,8.000702256,8.4270719687
2020,Maine,Lincoln County,34775,90,292,454,-162,18,236,254,-2,510,8.4077166715,13.072271811,-4.66455514,0.5182839044,6.7952778578,7.3135617622
2020,Maine,Oxford County,58132,237,471,775,-304,15,530,545,-4,938,8.1187999345,13.358959553,-5.240159618,0.2585605075,9.1358045972,9.3943651047
2020,Maine,Penobscot County,151655,-168,1350,1728,-378,120,83,203,7,7264,8.8968557853,11.387975405,-2.49111962,0.7908316254,0.5469918742,1.3378234996
2020,Maine,Piscataquis County,16996,116,140,247,-107,107,118,225,-2,250,8.2654386586,14.582595348,-6.317156689,6.3171566891,6.9665840123,13.283740701
2020,Maine,Sagadahoc County,36044,-13,305,445,-140,5,123,128,-1,273,8.4603542253,12.343795509,-3.883441284,0.1386943316,3.4118805564,3.550574888
2020,Maine,Somerset County,50635,-94,475,585,-110,-1,16,15,1,722,9.3721636873,11.542559489,-2.170395801,-0.019730871,0.3156939347,0.2959630638
2020,Maine,Waldo County,39923,168,346,485,-139,27,282,309,-2,574,8.6849569517,12.174000351,-3.4890434,0.6777278546,7.078490926,7.7562187806
2020,Maine,Washington County,31473,187,302,447,-145,71,264,335,-3,341,9.6241176564,14.244968849,-4.620851193,2.2626236874,8.4131359646,10.675759652
2020,Maine,York County,209066,1088,1871,2257,-386,140,1332,1472,2,3551,8.9726743461,10.823797969,-1.851123622,0.6713919874,6.3878151946,7.059207182
2020,Maryland,Maryland,6055802,848,69753,55635,14118,13078,-26379,-13301,31,140092,11.519181792,9.1877005862,2.3314812056,2.1597330505,-4.356292869,-2.196559818
2020,Maryland,Allegany County,70057,-470,650,931,-281,33,-225,-192,3,7600,9.2471404996,13.244750469,-3.99760997,0.46947021,-3.20093325,-2.73146304
2020,Maryland,Anne Arundel County,582777,2882,6775,5025,1750,317,779,1096,36,14228,11.65418966,8.6438823675,3.0103072922,0.5452956638,1.3400167889,1.8853124527
2020,Maryland,Baltimore County,826017,-2486,9563,9067,496,1500,-4509,-3009,27,21400,11.559848173,10.96027851,0.5995696637,1.8132147088,-5.450523415,-3.637308706
2020,Maryland,Calvert County,93072,412,888,830,58,16,341,357,-3,642,9.5621648397,8.9376090281,0.6245558116,0.1722912584,3.6719574441,3.8442487024
2020,Maryland,Caroline County,33492,-17,425,381,44,45,-109,-64,3,441,12.686377815,11.372964583,1.3134132326,1.3432635334,-3.253682781,-1.910419247
2020,Maryland,Carroll County,169092,318,1713,1704,9,47,266,313,-4,3367,10.14011472,10.086839161,0.0532755589,0.2782168078,1.5745887423,1.8528055501
2020,Maryland,Cecil County,103419,327,1152,1096,56,16,250,266,5,1357,11.156790679,10.614446688,0.5423439914,0.1549554261,2.4211785329,2.576133959
2020,Maryland,Charles County,164436,703,1847,1297,550,101,50,151,2,1407,11.256395333,7.9044638586,3.3519314743,0.6155365071,0.3047210431,0.9202575502
2020,Maryland,Dorchester County,31853,-11,355,407,-52,13,29,42,-1,499,11.143023055,12.775240517,-1.632217462,0.4080543654,0.9102751228,1.3183294882
2020,Maryland,Frederick County,265161,4552,2994,2013,981,387,3195,3582,-11,4367,11.389010404,7.6573406623,3.7316697415,1.4721265953,12.153603287,13.625729882
2020,Maryland,Garrett County,28852,-197,262,378,-116,0,-81,-81,0,528,9.049930053,13.056769313,-4.00683926,0.0,-2.797879139,-2.797879139
2020,Maryland,Harford County,256805,1211,2659,2401,258,156,796,952,1,2755,10.378630716,9.3716029891,1.0070277264,0.6089004858,3.1069537606,3.7158542464
2020,Maryland,Howard County,328200,2249,3370,2067,1303,689,255,944,2,1690,10.303431471,6.3196417952,3.9837896755,2.1065472651,0.7796365059,2.886183771
2020,Maryland,Kent County,19192,-234,147,321,-174,6,-65,-59,-1,1502,7.6130301932,16.624372054,-9.011341861,0.3107359263,-3.366305868,-3.055569941
2020,Maryland,Montgomery County,1051816,687,11964,6906,5058,4680,-9065,-4385,14,8907,11.378328962,6.5679321142,4.8103968482,4.4509009984,-8.621243066,-4.170342068
2020,Maryland,Prince George's County,909612,-1950,11802,7791,4011,3520,-9475,-5955,-6,20003,12.960870296,8.5560193589,4.4048509368,3.865638319,-10.40537587,-6.539737554
2020,Maryland,Queen Anne's County,51167,582,500,437,63,35,487,522,-3,436,9.8278166523,8.5895117541,1.2383048982,0.6879471657,9.5722934193,10.260240585
2020,Maryland,St. Mary's County,114687,923,1344,949,395,62,462,524,4,2789,11.766199316,8.3081273446,3.4580719717,0.5427859804,4.044631015,4.5874169953
2020,Maryland,Somerset County,25453,-156,223,295,-72,25,-108,-83,-1,5318,8.7344796522,11.554580706,-2.820101054,0.9792017547,-4.23015158,-3.250949826
2020,Maryland,Talbot County,36972,-214,323,538,-215,13,-12,1,0,371,8.7111302894,14.509560668,-5.798430378,0.3506027671,-0.323633323,0.0269694436
2020,Maryland,Washington County,151146,80,1667,1641,26,102,-53,49,5,8316,11.031990788,10.859926145,0.1720646434,0.6750228317,-0.350747158,0.324275674
2020,Maryland,Wicomico County,103990,-15,1253,1140,113,191,-324,-133,5,4876,12.048366547,10.961801966,1.0865645809,1.8365826102,-3.115459506,-1.278876896
2020,Maryland,Worcester County,52403,142,409,754,-345,33,457,490,-3,723,7.8154857449,14.408010395,-6.59252465,0.6305893144,8.7327065658,9.3632958801
2020,Maryland,Baltimore city,586131,-8470,7468,7266,202,1091,-9720,-8629,-43,26570,12.649779967,12.307619341,0.3421606258,1.8480061521,-16.46436279,-14.61635663
2020,Massachusetts,Massachusetts,6893574,-1309,68502,63072,5430,25247,-32164,-6917,178,247482,9.9361371617,9.1485218397,0.787615322,3.6620486252,-4.665351605,-1.00330298
2020,Massachusetts,Barnstable County,213164,241,1459,3077,-1618,277,1593,1870,-11,4112,6.8483666481,14.443059751,-7.594693103,1.300203949,7.4773461758,8.7775501247
2020,Massachusetts,Berkshire County,124571,-646,975,1494,-519,174,-303,-129,2,5794,7.8066200138,11.962143898,-4.155523884,1.3931814178,-2.426057297,-1.032875879
2020,Massachusetts,Bristol County,566765,1669,5442,5745,-303,951,997,1948,24,14999,9.6160217553,10.151423187,-0.535401432,1.6804183553,1.7617004208,3.4421187761
2020,Massachusetts,Dukes County,17461,0,166,148,18,31,-50,-19,1,119,9.5069010939,8.4760323006,1.0308687933,1.775385144,-2.863524426,-1.088139282
2020,Massachusetts,Essex County,791263,1538,8291,7321,970,3052,-2518,534,34,19420,10.488378153,9.261297366,1.2270807875,3.8608768694,-3.18534992,0.675526949
2020,Massachusetts,Franklin County,70267,-9,461,774,-313,104,202,306,-2,1496,6.5602698107,11.014422632,-4.454152822,1.4799741005,2.8745650797,4.3545391802
2020,Massachusetts,Hampden County,463986,-1763,4843,4654,189,961,-2925,-1964,12,14454,10.41802234,10.011454877,0.4065674628,2.0672557234,-6.292115495,-4.224859772
2020,Massachusetts,Hampshire County,161401,-195,932,1404,-472,432,-159,273,4,23014,5.770951433,8.6935791973,-2.922627764,2.6749474453,-0.984529268,1.6904181773
2020,Massachusetts,Middlesex County,1609379,-1884,16438,13015,3423,7426,-12784,-5358,51,54996,10.207902648,8.0822395038,2.1256631442,4.611502924,-7.938789844,-3.32728692
2020,Massachusetts,Nantucket County,11376,46,158,61,97,33,-84,-51,0,55,13.917026337,5.3730291553,8.5439971814,2.9067206906,-7.398925394,-4.492204704
2020,Massachusetts,Norfolk County,709409,2245,7058,6404,654,2243,-689,1554,37,16580,9.9648941495,9.0415389818,0.9233551677,3.1667976165,-0.9727702,2.1940274169
2020,Massachusetts,Plymouth County,523738,1897,5023,5223,-200,1142,933,2075,22,11383,9.6080736128,9.9906367668,-0.382563154,2.1844356094,1.7846571134,3.9690927228
2020,Massachusetts,Suffolk County,801582,-4333,8976,5967,3009,6332,-13632,-7300,-42,53252,11.167672475,7.4239640883,3.7437083864,7.8780862422,-16.96052932,-9.082443078
2020,Massachusetts,Worcester County,829212,-115,8280,7785,495,2089,-2745,-656,46,27808,9.9846913458,9.3877804501,0.5969108957,2.5190845678,-3.31014224,-0.791057672
2020,Michigan,Michigan,9966555,-18240,108474,103445,5029,7753,-31206,-23453,184,218618,10.873850642,10.369724354,0.5041262872,0.7771905159,-3.128209369,-2.351018853
2020,Michigan,Alcona County,10505,52,82,180,-98,1,150,151,-1,127,7.8251741578,17.177211566,-9.352037408,0.0954289531,14.314342972,14.409771925
2020,Michigan,Alger County,9015,-63,57,114,-57,4,-9,-5,-1,1021,6.3007793069,12.601558614,-6.300779307,0.4421599514,-0.994859891,-0.552699939
2020,Michigan,Allegan County,118927,882,1423,1021,402,38,437,475,5,955,12.009857705,8.6170518036,3.3928059011,0.3207129956,3.6881994497,4.0089124454
2020,Michigan,Alpena County,28238,-153,233,365,-132,3,-24,-21,0,513,8.228999276,12.890921613,-4.661922337,0.1059527804,-0.847622243,-0.741669463
2020,Michigan,Antrim County,23449,90,186,300,-114,4,204,208,-4,226,7.9473594257,12.818321654,-4.870962229,0.1709109554,8.716458725,8.8873696804
2020,Michigan,Arenac County,14953,9,137,218,-81,-1,92,91,-1,207,9.1647991437,14.583403017,-5.418603873,-0.066896344,6.1544636586,6.0875673144
2020,Michigan,Baraga County,8164,-81,70,125,-55,0,-26,-26,0,1011,8.5319032238,15.235541471,-6.703638247,0.0,-3.168992626,-3.168992626
2020,Michigan,Barry County,62061,580,658,628,30,11,541,552,-2,601,10.652247819,10.166583024,0.4856647942,0.1780770912,8.7581551213,8.9362322125
2020,Michigan,Bay County,102387,-577,921,1242,-321,3,-261,-258,2,1438,8.9700074507,12.096361839,-3.126354388,0.0292182653,-2.541989082,-2.512770817
2020,Michigan,Benzie County,17852,85,141,230,-89,0,176,176,-2,252,7.9171228839,12.914455768,-4.997332884,0.0,9.8823661529,9.8823661529
2020,Michigan,Berrien County,153025,-327,1644,1818,-174,154,-312,-158,5,3512,10.731876087,11.867731586,-1.135855498,1.005297395,-2.036706411,-1.031409016
2020,Michigan,Branch County,43424,-20,568,449,119,22,-162,-140,1,1868,13.077312704,10.337523599,2.7397891053,0.5065156329,-3.729796933,-3.2232813
2020,Michigan,Calhoun County,133580,-226,1508,1489,19,82,-331,-249,4,4294,11.279573351,11.137456711,0.1421166404,0.6133455005,-2.475821472,-1.862475971
2020,Michigan,Cass County,51584,-263,463,582,-119,1,-145,-144,0,491,8.9528284557,11.253879398,-2.301050942,0.0193365625,-2.803801568,-2.784465006
2020,Michigan,Charlevoix County,26105,-97,240,319,-79,12,-30,-18,0,279,9.1765920431,12.197220257,-3.020628214,0.4588296022,-1.147074005,-0.688244403
2020,Michigan,Cheboygan County,25365,34,178,393,-215,0,250,250,-1,391,7.0222502762,15.504181789,-8.481931513,0.0,9.862711062,9.862711062
2020,Michigan,Chippewa County,36958,-329,313,402,-89,-1,-239,-240,0,4619,8.4315442117,10.829012055,-2.397467843,-0.026937841,-6.438143983,-6.465081824
2020,Michigan,Clare County,30771,-113,301,437,-136,0,23,23,0,391,9.7640094072,14.175654854,-4.411645446,0.0,0.7460870976,0.7460870976
2020,Michigan,Clinton County,79753,138,819,634,185,25,-75,-50,3,628,10.278098489,7.9564278902,2.3216705989,0.3137392701,-0.94121781,-0.62747854
2020,Michigan,Crawford County,13981,-31,104,187,-83,1,51,52,0,197,7.4304290358,13.360482978,-5.930053942,0.071446433,3.6437680849,3.7152145179
2020,Michigan,Delta County,35612,-132,329,460,-131,2,-4,-2,1,633,9.2213689108,12.893099389,-3.671730478,0.0560569539,-0.112113908,-0.056056954
2020,Michigan,Dickinson County,25112,-224,255,334,-79,1,-145,-144,-1,433,10.1094196,13.241357437,-3.131937837,0.0396447827,-5.748493498,-5.708848716
2020,Michigan,Eaton County,110148,29,1090,1079,11,52,-38,14,4,1811,9.8970794536,9.7972006701,0.0998787835,0.4721542492,-0.345035797,0.1271184517
2020,Michigan,Emmet County,33342,5,279,341,-62,5,61,66,1,505,8.3684518364,10.2281078,-1.859655964,0.1499722551,1.8296615126,1.9796337678
2020,Michigan,Genesee County,404794,-908,4486,4916,-430,79,-573,-494,16,5677,11.069764687,12.130843335,-1.061078648,0.1949423563,-1.413948989,-1.219006633
2020,Michigan,Gladwin County,25424,-6,263,410,-147,-1,143,142,-1,289,10.343335824,16.124591969,-5.781256145,-0.039328273,5.6239430527,5.5846147796
2020,Michigan,Gogebic County,13842,-129,128,219,-91,2,-39,-37,-1,372,9.2043289109,15.748031496,-6.543702585,0.1438176392,-2.804443965,-2.660626326
2020,Michigan,Grand Traverse County,93592,560,870,953,-83,17,629,646,-3,1490,9.3235596708,10.213048697,-0.889489026,0.1821844993,6.7408264746,6.9230109739
2020,Michigan,Gratiot County,40283,-398,384,460,-76,3,-326,-323,1,5421,9.485697347,11.363074947,-1.8773776,0.0741070105,-8.05296181,-7.9788548
2020,Michigan,Hillsdale County,45658,110,502,521,-19,7,121,128,1,1681,11.008047716,11.424686972,-0.416639256,0.1534986733,2.6533342105,2.8068328838
2020,Michigan,Houghton County,35126,-583,372,372,0,44,-623,-579,-4,2768,10.503282276,10.503282276,0.0,1.24232371,-17.59017435,-16.34785064
2020,Michigan,Huron County,30653,-251,247,483,-236,4,-19,-15,0,524,8.0250824439,15.692772552,-7.667690108,0.1299608493,-0.617314034,-0.487353185
2020,Michigan,Ingham County,290609,-817,3014,2426,588,615,-2031,-1416,11,17368,10.356765487,8.3362684375,2.0204970491,2.1132749749,-6.978961746,-4.865686771
2020,Michigan,Ionia County,64553,-101,673,602,71,12,-187,-175,3,5069,10.417392247,9.3183805831,1.0990116635,0.1857484502,-2.894580015,-2.708831565
2020,Michigan,Iosco County,25140,-104,260,421,-161,7,51,58,-1,400,10.320736742,16.711654493,-6.390917752,0.2778659892,2.024452207,2.3023181963
2020,Michigan,Iron County,11066,13,79,189,-110,0,126,126,-3,355,7.1431800714,17.089380171,-9.946200099,0.0,11.392920114,11.392920114
2020,Michigan,Isabella County,69504,-131,597,503,94,48,-273,-225,0,4730,8.5813467108,7.2301798921,1.3511668188,0.6899575245,-3.924133421,-3.234175896
2020,Michigan,Jackson County,156920,-1437,1701,1744,-43,26,-1420,-1394,0,7634,10.790511201,11.063287205,-0.272776003,0.1649343276,-9.007951738,-8.84301741
2020,Michigan,Kalamazoo County,265988,457,3044,2383,661,256,-477,-221,17,8156,11.453964957,8.9667537755,2.4872111815,0.9632769478,-1.794855875,-0.831578928
2020,Michigan,Kalkaska County,18003,19,192,182,10,1,8,9,0,138,10.67051991,10.114763665,0.5557562453,0.0555756245,0.4446049962,0.5001806208
2020,Michigan,Kent County,658708,1908,8596,5226,3370,699,-2193,-1494,32,11305,13.06871566,7.9452196414,5.1234960183,1.0627073344,-3.334073225,-2.271365891
2020,Michigan,Keweenaw County,2119,34,12,26,-14,1,47,48,0,10,5.7088487155,12.369172217,-6.660323501,0.475737393,22.359657469,22.835394862
2020,Michigan,Lake County,11587,-165,87,177,-90,1,-75,-74,-1,110,7.4553322764,15.167744976,-7.7124127,0.0856934744,-6.427010583,-6.341317109
2020,Michigan,Lapeer County,87635,-173,815,968,-153,43,-63,-20,0,1487,9.2907668018,11.034923023,-1.744156222,0.4901876963,-0.718181974,-0.227994277
2020,Michigan,Leelanau County,21743,51,143,240,-97,3,146,149,-1,284,6.5845516289,11.050995741,-4.466444112,0.1381374468,6.7226890756,6.8608265224
2020,Michigan,Lenawee County,97808,-711,1012,1093,-81,54,-684,-630,0,4956,10.309330861,11.134484814,-0.825153952,0.5501026349,-6.967966709,-6.417864074
2020,Michigan,Livingston County,192335,277,1710,1766,-56,35,296,331,2,1398,8.8971443289,9.1885127981,-0.291368469,0.1821052933,1.5400904803,1.7221957736
2020,Michigan,Luce County,6126,-140,47,90,-43,1,-98,-97,0,1105,7.5855390575,14.525500323,-6.939961265,0.161394448,-15.81665591,-15.65526146
2020,Michigan,Mackinac County,10839,32,95,151,-56,11,78,89,-1,95,8.7776032523,13.95176938,-5.174166128,1.0163540608,7.2068742493,8.2232283101
2020,Michigan,Macomb County,870791,-1598,9123,9161,-38,422,-2016,-1594,34,7392,10.46707741,10.510675891,-0.043598481,0.4841726041,-2.313014147,-1.828841542
2020,Michigan,Manistee County,24738,119,198,326,-128,18,231,249,-2,1326,8.02317807,13.209879045,-5.186700975,0.7293798245,9.360374415,10.08975424
2020,Michigan,Marquette County,65834,-855,571,727,-156,13,-711,-698,-1,3876,8.6173720788,10.971680388,-2.354308309,0.1961923591,-10.73021287,-10.53402051
2020,Michigan,Mason County,29164,10,244,333,-89,7,92,99,0,442,8.3679138516,11.420144724,-3.052230872,0.2400631023,3.1551150588,3.3951781611
2020,Michigan,Mecosta County,43907,324,413,384,29,14,282,296,-1,3344,9.4410789805,8.7781460738,0.6629329066,0.3200365756,6.446451023,6.7664875986
2020,Michigan,Menominee County,22608,-164,190,257,-67,2,-99,-97,0,382,8.373732922,11.326575584,-2.952842662,0.0881445571,-4.363155575,-4.275011018
2020,Michigan,Midland County,83441,29,836,803,33,39,-46,-7,3,1275,10.020796749,9.6252389828,0.3955577664,0.4674773603,-0.551383553,-0.083906193
2020,Michigan,Missaukee County,15152,73,178,176,2,3,67,70,1,194,11.775991532,11.64367702,0.1323145116,0.1984717674,4.4325361384,4.6310079058
2020,Michigan,Monroe County,150568,156,1440,1611,-171,-7,334,327,0,1463,9.5687421091,10.705030235,-1.136288125,-0.046514719,2.2194165725,2.1729018539
2020,Michigan,Montcalm County,63476,-232,711,670,41,-1,-275,-276,3,2923,11.180651654,10.535916467,0.6447351868,-0.015725248,-4.324443326,-4.340168575
2020,Michigan,Montmorency County,9337,33,82,181,-99,1,132,133,-1,156,8.7978112762,19.419559037,-10.62174776,0.1072903814,14.162330347,14.269620729
2020,Michigan,Muskegon County,173883,238,2027,1909,118,60,51,111,9,4681,11.665247117,10.986165144,0.6790819733,0.3452959186,0.2935015308,0.6387974494
2020,Michigan,Newaygo County,49348,321,499,576,-77,9,392,401,-3,557,10.144853875,11.710292249,-1.565438374,0.1829733164,7.9695044473,8.1524777637
2020,Michigan,Oakland County,1253459,-4267,13035,11862,1173,2175,-7641,-5466,26,13859,10.381552932,9.4473326338,0.9342202984,1.7322499139,-6.085573146,-4.353323232
2020,Michigan,Oceana County,26819,257,268,280,-12,52,218,270,-1,303,10.041025833,10.490624005,-0.449598172,1.9482587437,8.167700118,10.115958862
2020,Michigan,Ogemaw County,20923,-10,175,306,-131,2,119,121,0,244,8.3620030581,14.621559633,-6.259556575,0.0955657492,5.6861620795,5.7817278287
2020,Michigan,Ontonagon County,5656,-57,23,118,-95,0,39,39,-1,83,4.0460902454,20.758202129,-16.71211188,0.0,6.8607617205,6.8607617205
2020,Michigan,Osceola County,23466,72,293,277,16,4,53,57,-1,454,12.505335041,11.822449851,0.6828851899,0.1707212975,2.2620571916,2.4327784891
2020,Michigan,Oscoda County,8368,50,93,117,-24,1,74,75,-1,65,11.147069399,14.02373247,-2.876663071,0.1198609613,8.8697111351,8.9895720964
2020,Michigan,Otsego County,24765,101,229,315,-86,0,188,188,-1,347,9.2658156143,12.745554229,-3.479738615,0.0,7.6068704607,7.6068704607
2020,Michigan,Ottawa County,294635,3175,3119,2141,978,255,1937,2192,5,8957,10.643325741,7.3059828185,3.3373429222,0.8701660994,6.609849939,7.4800160384
2020,Michigan,Presque Isle County,12665,63,93,196,-103,4,163,167,-1,230,7.3613804567,15.514307199,-8.152926742,0.3166185143,12.902204456,13.218822971
2020,Michigan,Roscommon County,23986,0,159,406,-247,5,244,249,-2,277,6.628866839,16.926540482,-10.29767364,0.208454932,10.172600684,10.381055616
2020,Michigan,Saginaw County,189868,-616,2132,2276,-144,71,-548,-477,5,6736,11.210668013,11.967861349,-0.757193337,0.3733383813,-2.881541309,-2.508202928
2020,Michigan,St. Clair County,159293,-46,1529,1877,-348,42,260,302,0,1998,9.597278365,11.78161641,-2.184338045,0.2636270054,1.6319767004,1.8956037058
2020,Michigan,St. Joseph County,60848,22,755,625,130,27,-137,-110,2,764,12.410210891,10.273353387,2.1368575045,0.4438088663,-2.251919062,-1.808110196
2020,Michigan,Sanilac County,40747,-473,384,525,-141,18,-349,-331,-1,564,9.369624361,12.810033306,-3.440408945,0.4392011419,-8.515622141,-8.076420999
2020,Michigan,Schoolcraft County,8104,23,70,120,-50,0,74,74,-1,140,8.6499845536,14.828544949,-6.178560395,0.0,9.1442693852,9.1442693852
2020,Michigan,Shiawassee County,67738,-327,674,797,-123,3,-206,-203,-1,822,9.926143016,11.73759048,-1.811447464,0.0441816455,-3.033806322,-2.989624677
2020,Michigan,Tuscola County,52289,-66,533,708,-175,9,101,110,-1,1079,10.18691946,13.531592829,-3.344673369,0.1720117733,1.9303543443,2.1023661175
2020,Michigan,Van Buren County,75474,-120,769,873,-104,37,-57,-20,4,877,10.180845712,11.557709111,-1.376863399,0.4898456324,-0.754627055,-0.264781423
2020,Michigan,Washtenaw County,366473,-1769,3455,2644,811,619,-3206,-2587,7,20772,9.4050073838,7.1973486318,2.207658752,1.6850071116,-8.727193538,-7.042186426
2020,Michigan,Wayne County,1740623,-9470,22477,19638,2839,1461,-13795,-12334,25,22422,12.87816024,11.251559852,1.626600388,0.8370775509,-7.903822597,-7.066745046
2020,Michigan,Wexford County,33743,89,369,362,7,1,81,82,0,389,10.950042287,10.742317907,0.2077243794,0.0296749113,2.403667819,2.4333427304
2020,Minnesota,Minnesota,5657342,17289,66492,46882,19610,7360,-9757,-2397,76,129373,11.771209204,8.2996124328,3.4715967708,1.3029552388,-1.727300851,-0.424345612
2020,Minnesota,Aitkin County,15848,7,114,248,-134,1,141,142,-1,274,7.194925684,15.652119032,-8.457193348,0.0631133832,8.8989870302,8.9621004134
2020,Minnesota,Anoka County,359921,2383,4224,2430,1794,309,268,577,12,2937,11.774888879,6.7739062441,5.0009826345,0.8613732631,0.7470810179,1.608454281
2020,Minnesota,Becker County,34456,-5,398,399,-1,20,-24,-4,0,458,11.550125513,11.579145929,-0.029020416,0.5804083173,-0.696489981,-0.116081663
2020,Minnesota,Beltrami County,47442,237,660,426,234,19,-18,1,2,2004,13.94655932,9.0018701068,4.9446892136,0.4014918592,-0.380360709,0.0211311505
2020,Minnesota,Benton County,40958,20,535,365,170,64,-215,-151,1,1049,13.065351177,8.913744261,4.1516069161,1.5629578978,-5.250561688,-3.68760379
2020,Minnesota,Big Stone County,4923,-44,67,73,-6,0,-37,-37,-1,137,13.549039434,14.762386249,-1.213346815,0.0,-7.482305359,-7.482305359
2020,Minnesota,Blue Earth County,68241,367,724,497,227,94,41,135,5,4150,10.638063402,7.3026484958,3.3354149065,1.3811850274,0.6024317673,1.9836167946
2020,Minnesota,Brown County,24846,-119,257,309,-52,5,-71,-66,-1,1111,10.319005842,12.406898075,-2.087892233,0.2007588685,-2.850775933,-2.650017065
2020,Minnesota,Carlton County,35769,-144,367,393,-26,5,-124,-119,1,1992,10.239669652,10.96509584,-0.725426188,0.1395050361,-3.459724896,-3.32021986
2020,Minnesota,Carver County,106565,1437,1154,618,536,42,857,899,2,856,10.902580624,5.8386436963,5.0639369275,0.3968010279,8.0966304979,8.4934315258
2020,Minnesota,Cass County,29928,306,275,347,-72,1,381,382,-4,223,9.2359361881,11.654072208,-2.41813602,0.0335852225,12.795969773,12.829554996
2020,Minnesota,Chippewa County,11758,2,147,141,6,18,-22,-4,0,237,12.503189589,11.99285532,0.5103342689,1.5310028068,-1.871225653,-0.340222846
2020,Minnesota,Chisago County,56794,251,593,456,137,19,93,112,2,1676,10.464367329,8.0467984859,2.4175688434,0.3352832702,1.6411233754,1.9764066457
2020,Minnesota,Clay County,64690,249,839,420,419,94,-266,-172,2,2917,12.994555916,6.5050220319,6.4895338842,1.4558858833,-4.119847287,-2.663961404
2020,Minnesota,Clearwater County,9017,174,106,87,19,3,153,156,-1,115,11.870100784,9.7424412094,2.1276595745,0.3359462486,17.133258679,17.469204927
2020,Minnesota,Cook County,5417,1,37,49,-12,11,3,14,-1,51,6.8309794148,9.0464321979,-2.215452783,2.0308317179,0.5538631958,2.5846949137
2020,Minnesota,Cottonwood County,11242,10,137,152,-15,2,24,26,-1,244,12.191866156,13.526742013,-1.334875857,0.1779834475,2.1358013705,2.313784818
2020,Minnesota,Crow Wing County,65644,453,639,743,-104,18,541,559,-2,736,9.7680284328,11.357817098,-1.589788665,0.2751557305,8.2699583445,8.545114075
2020,Minnesota,Dakota County,431807,2354,5167,2995,2172,385,-221,164,18,2815,11.99869958,6.954926503,5.0437730767,0.8940389662,-0.513201588,0.3808373778
2020,Minnesota,Dodge County,20987,11,256,159,97,6,-92,-86,0,149,12.201224889,7.5781045206,4.6231203679,0.2859662083,-4.384815194,-4.098848986
2020,Minnesota,Douglas County,38328,258,415,473,-58,8,310,318,-2,522,10.864158748,12.382523103,-1.518364355,0.2094295662,8.115395691,8.3248252572
2020,Minnesota,Faribault County,13601,-70,143,160,-17,0,-53,-53,0,336,10.486946319,11.733646231,-1.246699912,0.0,-3.886770314,-3.886770314
2020,Minnesota,Fillmore County,21135,54,245,242,3,15,36,51,0,359,11.606973659,11.464847451,0.1421262081,0.7106310404,1.7055144969,2.4161455372
2020,Minnesota,Freeborn County,30364,-21,309,360,-51,24,7,31,-1,637,10.173006963,11.852046947,-1.679039984,0.7901364632,0.2304564684,1.0205929316
2020,Minnesota,Goodhue County,46318,-73,502,519,-17,2,-59,-57,1,857,10.829585046,11.196323981,-0.366738936,0.0431457572,-1.272799836,-1.229654079
2020,Minnesota,Grant County,6026,49,58,56,2,2,44,46,1,110,9.664250604,9.3310005832,0.3332500208,0.3332500208,7.3315004582,7.664750479
2020,Minnesota,Hennepin County,1268408,3249,15616,9617,5999,2749,-5547,-2798,48,25354,12.327284023,7.5916681896,4.7356158333,2.1700629981,-4.378806639,-2.208743641
2020,Minnesota,Houston County,18632,-35,182,172,10,5,-50,-45,0,257,9.7589747714,9.2227673664,0.536207405,0.2681037025,-2.681037025,-2.412933323
2020,Minnesota,Hubbard County,21783,179,202,205,-3,10,175,185,-3,154,9.3115449328,9.4498352041,-0.138290271,0.4609675709,8.0669324913,8.5279000622
2020,Minnesota,Isanti County,41429,982,466,357,109,8,868,876,-3,465,11.383067077,8.720504177,2.6625629,0.1954174606,21.20279447,21.39821193
2020,Minnesota,Itasca County,45268,43,433,520,-87,6,126,132,-2,1005,9.5698009791,11.492601638,-1.922800659,0.132606942,2.7847457814,2.9173527234
2020,Minnesota,Jackson County,9768,-31,96,110,-14,6,-21,-15,-2,110,9.8124393111,11.243420044,-1.430980733,0.6132774569,-2.146471099,-1.533193642
2020,Minnesota,Kanabec County,16416,59,169,190,-21,4,76,80,0,246,10.313367711,11.594910445,-1.281542733,0.2441033778,4.6379641778,4.8820675556
2020,Minnesota,Kandiyohi County,43130,-7,556,387,169,144,-320,-176,0,1047,12.890212944,8.9721446208,3.9180683228,3.338472417,-7.418827593,-4.080355176
2020,Minnesota,Kittson County,4214,-72,47,58,-11,1,-61,-60,-1,111,11.058823529,13.647058824,-2.588235294,0.2352941176,-14.35294118,-14.11764706
2020,Minnesota,Koochiching County,12059,-143,95,161,-66,2,-78,-76,-1,241,7.8314991138,13.272330077,-5.440830963,0.1648736656,-6.430072957,-6.265199291
2020,Minnesota,Lac qui Parle County,6527,-101,65,93,-28,4,-78,-74,1,154,9.8821740783,14.139110604,-4.256936526,0.6081337894,-11.85860889,-11.2504751
2020,Minnesota,Lake County,10639,14,95,126,-31,1,43,44,1,224,8.9352896915,11.851015801,-2.91572611,0.094055681,4.0443942814,4.1384499624
2020,Minnesota,Lake of the Woods County,3754,18,37,36,1,0,18,18,-1,53,9.8798397864,9.6128170895,0.2670226969,0.0,4.8064085447,4.8064085447
2020,Minnesota,Le Sueur County,28741,-115,317,265,52,15,-183,-168,1,270,11.007517753,9.2018681529,1.8056495998,0.5208604615,-6.35449763,-5.833637169
2020,Minnesota,Lincoln County,5568,-51,70,82,-12,0,-39,-39,0,135,12.514525789,14.659873067,-2.145347278,0.0,-6.972378654,-6.972378654
2020,Minnesota,Lyon County,25271,-308,340,236,104,83,-492,-409,-3,867,13.3726647,9.2822025565,4.0904621436,3.2645034415,-19.35103245,-16.08652901
2020,Minnesota,McLeod County,35710,-116,390,376,14,0,-131,-131,1,476,10.903600984,10.512189667,0.3914113174,0.0,-3.662491613,-3.662491613
2020,Minnesota,Mahnomen County,5473,-67,95,53,42,0,-107,-107,-2,79,17.252338146,9.6249886498,7.6273494961,0.0,-19.43158086,-19.43158086
2020,Minnesota,Marshall County,9321,-24,102,85,17,2,-41,-39,-2,76,10.928961749,9.1074681239,1.8214936248,0.2142933676,-4.393014036,-4.178720669
2020,Minnesota,Martin County,19484,-157,247,235,12,1,-169,-168,-1,348,12.626198083,12.012779553,0.6134185304,0.0511182109,-8.638977636,-8.587859425
2020,Minnesota,Meeker County,23341,175,280,233,47,4,124,128,0,354,12.041198099,10.01999699,2.0212011095,0.1720171157,5.3325305868,5.5045477025
2020,Minnesota,Mille Lacs County,26146,-20,294,302,-8,4,-15,-11,-1,523,11.240250803,11.546107968,-0.305857165,0.1529285824,-0.573482184,-0.420553601
2020,Minnesota,Morrison County,33187,-142,363,382,-19,1,-122,-121,-2,521,10.914667148,11.485958266,-0.571291118,0.0300679536,-3.668290336,-3.638222383
2020,Minnesota,Mower County,40150,110,535,416,119,98,-108,-10,1,632,13.34330964,10.375358524,2.9679511161,2.4441950368,-2.693602694,-0.249407657
2020,Minnesota,Murray County,8155,-42,86,89,-3,4,-42,-38,-1,163,10.518590998,10.885518591,-0.366927593,0.4892367906,-5.136986301,-4.647749511
2020,Minnesota,Nicollet County,34482,171,339,296,43,33,94,127,1,2870,9.8556539183,8.6055267251,1.2501271932,0.9593999389,2.7328361897,3.6922361287
2020,Minnesota,Nobles County,21400,-245,377,171,206,64,-513,-449,-2,385,17.516552445,7.9451736555,9.5713787896,2.9736322453,-23.83552097,-20.86188872
2020,Minnesota,Norman County,6338,-50,75,85,-10,4,-44,-40,0,149,11.786892975,13.358478705,-1.57158573,0.628634292,-6.914977212,-6.28634292
2020,Minnesota,Olmsted County,159298,1110,2049,1147,902,326,-127,199,9,2436,12.907655771,7.2255154558,5.6821403148,2.053633861,-0.800035277,1.2535985839
2020,Minnesota,Otter Tail County,58741,57,615,686,-71,20,109,129,-1,1186,10.474771131,11.684053651,-1.209282521,0.3406429636,1.8565041516,2.1971471152
2020,Minnesota,Pennington County,13874,-195,152,133,19,6,-218,-212,-2,327,10.879289983,9.5193787353,1.3599112479,0.4294456572,-15.60319221,-15.17374656
2020,Minnesota,Pine County,29359,-71,230,320,-90,2,16,18,1,1531,7.8245930361,10.886390311,-3.061797275,0.0680399394,0.5443195156,0.612359455
2020,Minnesota,Pipestone County,9121,-31,131,105,26,13,-69,-56,-1,205,14.338094456,11.492365786,2.8457286707,1.4228643354,-7.552126088,-6.129261752
2020,Minnesota,Polk County,30900,-430,394,325,69,19,-517,-498,-1,1196,12.662702876,10.445122931,2.2175799454,0.610637956,-16.61578017,-16.00514221
2020,Minnesota,Pope County,11277,61,125,138,-13,3,72,75,-1,184,11.114568977,12.270484151,-1.155915174,0.2667496554,6.4019917308,6.6687413862
2020,Minnesota,Ramsey County,547903,-1729,7283,4563,2720,1396,-5835,-4439,-10,17338,13.271558538,8.3149967883,4.9565617497,2.5438824274,-10.63291831,-8.089035885
2020,Minnesota,Red Lake County,4046,14,45,29,16,0,-1,-1,-1,34,11.141371627,7.1799950483,3.9613765784,0.0,-0.247586036,-0.247586036
2020,Minnesota,Redwood County,15079,-79,197,170,27,4,-110,-106,0,373,13.030393227,11.244501769,1.7858914575,0.2645765122,-7.275854086,-7.011277574
2020,Minnesota,Renville County,14403,-148,168,188,-20,5,-133,-128,0,342,11.604614216,12.986115908,-1.381501692,0.3453754231,-9.186986254,-8.841610831
2020,Minnesota,Rice County,67084,68,731,528,203,138,-275,-137,2,7328,10.902311708,7.8747203579,3.0275913497,2.0581655481,-4.101416853,-2.043251305
2020,Minnesota,Rock County,9301,-33,89,115,-26,0,-7,-7,0,260,9.5519184331,12.342366515,-2.790448082,0.0,-0.751274483,-0.751274483
2020,Minnesota,Roseau County,15117,-59,167,138,29,5,-93,-88,0,191,11.02564949,9.1110157462,1.9146337438,0.3301092662,-6.140032351,-5.809923085
2020,Minnesota,St. Louis County,198538,-674,1847,2225,-378,64,-369,-305,9,8803,9.2872407291,11.187932118,-1.900691389,0.3218101823,-1.855436832,-1.53362665
2020,Minnesota,Scott County,150689,1685,1704,776,928,99,651,750,7,1289,11.371636975,5.1786328009,6.1930041743,0.6606760919,4.3444458162,5.0051219081
2020,Minnesota,Sherburne County,98811,1387,1202,607,595,27,766,793,-1,2190,12.250617882,6.1864601116,6.06415777,0.2751802686,7.8069661375,8.0821464061
2020,Minnesota,Sibley County,14715,-153,168,137,31,10,-193,-183,-1,230,11.357874455,9.2620761924,2.0957982625,0.6760639557,-13.04803434,-12.37197039
2020,Minnesota,Stearns County,162038,962,2024,1143,881,494,-420,74,7,6843,12.528086063,7.0749023564,5.4531837061,3.0577443255,-2.599701653,0.4580426722
2020,Minnesota,Steele County,36596,-91,396,332,64,1,-156,-155,0,594,10.807417819,9.0607644338,1.7466533848,0.0272914591,-4.257467626,-4.230176166
2020,Minnesota,Stevens County,9765,-57,123,92,31,27,-115,-88,0,927,12.55935059,9.3939858069,3.1653647828,2.7569306172,-11.74248226,-8.985551641
2020,Minnesota,Swift County,9176,-118,113,103,10,12,-140,-128,0,150,12.236058473,11.15322144,1.082837033,1.2994044396,-15.15971846,-13.86031402
2020,Minnesota,Todd County,24732,7,308,225,83,5,-81,-76,0,346,12.455264169,9.0988131104,3.3564510585,0.2021958469,-3.27557272,-3.073376873
2020,Minnesota,Traverse County,3218,-42,33,33,0,3,-45,-42,0,100,10.188329731,10.188329731,0.0,0.9262117938,-13.89317691,-12.96696511
2020,Minnesota,Wabasha County,21642,94,223,206,17,5,73,78,-1,246,10.326464459,9.5392451956,0.7872192637,0.2315350776,3.3804121324,3.61194721
2020,Minnesota,Wadena County,13807,145,178,183,-5,1,149,150,0,482,12.960064072,13.324110816,-0.364046744,0.0728093487,10.848592959,10.921402308
2020,Minnesota,Waseca County,18550,-8,201,165,36,0,-46,-46,2,974,10.833243505,8.8929610866,1.9402824189,0.0,-2.479249757,-2.479249757
2020,Minnesota,Washington County,265476,2935,2729,1903,826,155,1959,2114,-5,3437,10.336788399,7.2081012543,3.1286871445,0.5871023092,7.420215637,8.0073179462
2020,Minnesota,Watonwan County,10792,-54,166,114,52,22,-128,-106,0,150,15.343377392,10.537018209,4.8063591829,2.0334596543,-11.83103799,-9.797578334
2020,Minnesota,Wilkin County,6161,-62,67,76,-9,0,-53,-53,0,152,10.820413437,12.273901809,-1.453488372,0.0,-8.559431525,-8.559431525
2020,Minnesota,Winona County,50485,-174,462,461,1,34,-211,-177,2,3913,9.1354899945,9.1157162066,0.0197737879,0.6723087875,-4.17226924,-3.499960452
2020,Minnesota,Wright County,140249,1707,1731,956,775,42,887,929,3,1105,12.417904452,6.8581840877,5.559720364,0.3013009746,6.3631896295,6.6644906041
2020,Minnesota,Yellow Medicine County,9580,-156,104,105,-1,2,-157,-155,0,290,10.768275005,10.871816111,-0.103541106,0.2070822116,-16.25595361,-16.0488714
2020,Mississippi,Mississippi,2966786,-11441,35901,33888,2013,787,-14205,-13418,-36,90657,12.077685953,11.400479696,0.6772062567,0.2647597238,-4.778795269,-4.514035545
2020,Mississippi,Adams County,30275,-461,324,436,-112,-8,-340,-348,-1,2313,10.621035551,14.29250463,-3.671469079,-0.262247791,-11.14553113,-11.40777893
2020,Mississippi,Alcorn County,36889,-154,414,505,-91,2,-66,-64,1,782,11.199480604,13.661202186,-2.461721582,0.054103771,-1.785424444,-1.731320673
2020,Mississippi,Amite County,12205,-81,127,164,-37,-1,-44,-45,1,113,10.371156751,13.39267486,-3.021518109,-0.081662652,-3.59315667,-3.674819321
2020,Mississippi,Attala County,18004,-169,230,271,-41,0,-126,-126,-2,345,12.715261077,14.981894574,-2.266633496,0.0,-6.965751721,-6.965751721
2020,Mississippi,Benton County,8351,73,85,104,-19,-2,94,92,0,78,10.223104216,12.508268687,-2.285164472,-0.240543629,11.305550544,11.065006916
2020,Mississippi,Bolivar County,30142,-572,405,426,-21,9,-558,-549,-2,1353,13.31010911,14.000262916,-0.690153806,0.2957802024,-18.33837255,-18.04259235
2020,Mississippi,Calhoun County,14241,-124,170,189,-19,0,-103,-103,-2,212,11.885618402,13.214011047,-1.328392645,0.0,-7.201286443,-7.201286443
2020,Mississippi,Carroll County,9732,-196,88,120,-32,0,-163,-163,-1,365,8.9521871821,12.207527976,-3.255340793,0.0,-16.58189217,-16.58189217
2020,Mississippi,Chickasaw County,16951,-75,228,209,19,0,-93,-93,-1,492,13.420843512,12.302439886,1.118403626,0.0,-5.474291432,-5.474291432
2020,Mississippi,Choctaw County,8063,-129,76,118,-42,1,-88,-87,0,122,9.3509689326,14.518609659,-5.167640726,0.1230390649,-10.82743771,-10.70439865
2020,Mississippi,Claiborne County,8911,-87,115,112,3,4,-95,-91,1,1292,12.842704785,12.507677704,0.3350270814,0.4467027751,-10.60919091,-10.16248813
2020,Mississippi,Clarke County,15299,-207,189,212,-23,0,-182,-182,-2,52,12.27073527,13.763999351,-1.493264081,0.0,-11.81626359,-11.81626359
2020,Mississippi,Clay County,19352,3,237,241,-4,4,2,6,1,303,12.247745536,12.454458541,-0.206713005,0.2067130048,0.1033565024,0.3100695072
2020,Mississippi,Coahoma County,21564,-531,329,310,19,-6,-541,-547,-3,758,15.071348405,14.200966582,0.8703818228,-0.274857418,-24.78297716,-25.05783458
2020,Mississippi,Copiah County,27933,-166,353,343,10,13,-188,-175,-1,987,12.59994289,12.243003998,0.3569388921,0.4640205597,-6.710451171,-6.246430611
2020,Mississippi,Covington County,18518,-44,226,240,-14,0,-29,-29,-1,237,12.189859763,12.944983819,-0.755124056,0.0,-1.564185545,-1.564185545
2020,Mississippi,DeSoto County,188275,2890,2129,1568,561,9,2329,2338,-9,627,11.39538618,8.3926564256,3.0027297543,0.0481721351,12.465878071,12.514050206
2020,Mississippi,Forrest County,75009,-26,1040,791,249,87,-365,-278,3,2823,13.862600304,10.543573885,3.3190264189,1.1596598331,-4.86523953,-3.705579697
2020,Mississippi,Franklin County,7657,-37,84,87,-3,2,-36,-34,0,67,10.943912449,11.334766465,-0.390854016,0.260569344,-4.690248192,-4.429678848
2020,Mississippi,George County,24425,-10,351,282,69,1,-82,-81,2,570,14.367580843,11.543184609,2.8243962341,0.0409332788,-3.356528858,-3.315595579
2020,Mississippi,Greene County,13477,-92,125,130,-5,5,-92,-87,0,2559,9.2435110552,9.6132514974,-0.369740442,0.3697404422,-6.803224137,-6.433483694
2020,Mississippi,Grenada County,20610,-122,254,271,-17,-2,-103,-105,0,226,12.287746118,13.110154322,-0.822408205,-0.096753906,-4.982826182,-5.079580088
2020,Mississippi,Hancock County,48000,327,473,536,-63,-14,404,390,0,558,9.887847146,11.20483313,-1.316985984,-0.292663552,8.445433926,8.1527703741
2020,Mississippi,Harrison County,208801,942,2624,2201,423,54,452,506,13,5136,12.595401526,10.56496904,2.0304324869,0.2592041473,2.1696347142,2.4288388614
2020,Mississippi,Hinds County,227966,-3953,2889,2340,549,117,-4594,-4477,-25,8010,12.564010568,10.176457158,2.3875534101,0.5088228579,-19.97890777,-19.47008491
2020,Mississippi,Holmes County,16726,-310,211,250,-39,0,-269,-269,-2,844,12.499259523,14.809549197,-2.310289675,0.0,-15.93507494,-15.93507494
2020,Mississippi,Humphreys County,7827,-229,92,126,-34,-2,-193,-195,0,83,11.584713215,15.866020273,-4.281307058,-0.251841592,-24.30271359,-24.55455518
2020,Mississippi,Issaquena County,1220,-104,10,16,-6,0,-97,-97,-1,280,7.8616352201,12.578616352,-4.716981132,0.0,-76.25786164,-76.25786164
2020,Mississippi,Itawamba County,23261,-90,261,299,-38,2,-56,-54,2,884,11.198832919,12.82931434,-1.630481421,0.0858148116,-2.402814726,-2.316999914
2020,Mississippi,Jackson County,143802,415,1562,1584,-22,118,312,430,7,1336,10.877853957,11.031063167,-0.153209211,0.8217584935,2.1727851693,2.9945436629
2020,Mississippi,Jasper County,16332,-36,195,212,-17,0,-20,-20,1,87,11.926605505,12.966360856,-1.039755352,0.0,-1.22324159,-1.22324159
2020,Mississippi,Jefferson County,6997,-25,81,78,3,0,-29,-29,1,365,11.555745774,11.127755189,0.4279905842,0.0,-4.137242314,-4.137242314
2020,Mississippi,Jefferson Davis County,10890,-199,116,165,-49,0,-148,-148,-2,110,10.555530279,15.014331862,-4.458801583,0.0,-13.4674007,-13.4674007
2020,Mississippi,Jones County,67993,-289,916,859,57,-11,-335,-346,0,1921,13.44340488,12.606861126,0.8365437534,-0.161438268,-4.916529077,-5.077967345
2020,Mississippi,Kemper County,9521,-259,85,111,-26,0,-231,-231,-2,832,8.807833791,11.501994715,-2.694160924,0.0,-23.9365836,-23.9365836
2020,Mississippi,Lafayette County,54408,169,520,428,92,26,44,70,7,4349,9.5722845546,7.878726518,1.6935580366,0.4786142277,0.8099625392,1.288576767
2020,Mississippi,Lamar County,64165,718,750,457,293,27,398,425,0,395,11.754380466,7.1623358305,4.5920446353,0.4231576968,6.2376579005,6.6608155973
2020,Mississippi,Lauderdale County,73751,-868,880,906,-26,7,-846,-839,-3,3727,11.862236301,12.212711465,-0.350475163,0.0943586978,-11.40392263,-11.30956393
2020,Mississippi,Lawrence County,12480,-127,139,159,-20,1,-106,-105,-2,0,11.081436601,12.67588791,-1.594451309,0.0797225655,-8.45059194,-8.370869375
2020,Mississippi,Leake County,22741,-89,320,290,30,-2,-118,-120,1,1688,14.044019223,12.727392421,1.3166268021,-0.08777512,-5.178732088,-5.266507209
2020,Mississippi,Lee County,85466,-208,1076,1050,26,77,-315,-238,4,1060,12.574500409,12.270655604,0.3038448054,0.8998480776,-3.681196681,-2.781348603
2020,Mississippi,Leflore County,27854,-348,389,365,24,2,-373,-371,-1,1264,13.878978165,13.022691594,0.8562865706,0.0713572142,-13.30812045,-13.23676324
2020,Mississippi,Lincoln County,33936,-175,393,440,-47,-2,-126,-128,0,648,11.550839861,12.932238012,-1.381398151,-0.0587829,-3.703322703,-3.762105603
2020,Mississippi,Lowndes County,58309,-312,794,678,116,45,-473,-428,0,1232,13.580774823,11.596681775,1.9840930471,0.7696912683,-8.090310442,-7.320619174
2020,Mississippi,Madison County,106871,537,1343,1174,169,56,304,360,8,1771,12.598203607,11.012874933,1.5853286743,0.5253160104,2.8517154851,3.3770314955
2020,Mississippi,Marion County,24441,-63,292,373,-81,0,18,18,0,808,11.931760139,15.241597712,-3.309837573,0.0,0.7355194606,0.7355194606
2020,Mississippi,Marshall County,35301,-1,406,486,-80,-4,82,78,1,1786,11.500927723,13.767120377,-2.266192655,-0.113309633,2.3228474711,2.2095378383
2020,Mississippi,Monroe County,35123,-168,385,463,-78,-2,-89,-91,1,399,10.935325361,13.150793876,-2.215468515,-0.056806885,-2.527906382,-2.584713267
2020,Mississippi,Montgomery County,9661,-105,117,145,-28,0,-77,-77,0,97,12.045091882,14.927677974,-2.882586092,0.0,-7.927111752,-7.927111752
2020,Mississippi,Neshoba County,28996,-151,433,405,28,1,-180,-179,0,367,14.894312299,13.931169702,0.9631425967,0.0343979499,-6.191630979,-6.157233029
2020,Mississippi,Newton County,20866,-121,259,290,-31,-1,-89,-90,0,553,12.376651614,13.858026904,-1.48137529,-0.0477863,-4.25298067,-4.30076697
2020,Mississippi,Noxubee County,10236,-189,152,137,15,1,-203,-202,-2,157,14.713711824,13.261700789,1.4520110353,0.0968007357,-19.65054934,-19.55374861
2020,Mississippi,Oktibbeha County,49789,246,513,388,125,76,42,118,3,4722,10.328997705,7.8121853985,2.5168123062,1.5302218822,0.8456489349,2.3758708171
2020,Mississippi,Panola County,33848,-254,485,456,29,-2,-280,-282,-1,316,14.275202355,13.421633554,0.8535688006,-0.058866814,-8.241353937,-8.300220751
2020,Mississippi,Pearl River County,55876,124,616,713,-97,-13,233,220,1,1236,11.036657469,12.774572688,-1.737915218,-0.232916473,4.1745798545,3.9416633819
2020,Mississippi,Perry County,11862,-136,140,136,4,0,-139,-139,-1,102,11.735121542,11.399832355,0.3352891869,0.0,-11.65129925,-11.65129925
2020,Mississippi,Pike County,38997,-287,521,553,-32,-1,-255,-256,1,945,13.311020554,14.128588035,-0.817567481,-0.025548984,-6.514990866,-6.54053985
2020,Mississippi,Pontotoc County,32461,181,449,290,159,3,19,22,0,233,13.870653836,8.9587741926,4.9118796435,0.0926769744,0.5869541712,0.6796311456
2020,Mississippi,Prentiss County,25013,-61,283,284,-1,3,-63,-60,0,722,11.300337413,11.340267934,-0.039930521,0.1197915627,-2.515622816,-2.395831254
2020,Mississippi,Quitman County,6760,-48,70,107,-37,0,-11,-11,0,142,10.318396226,15.77240566,-5.454009434,0.0,-1.621462264,-1.621462264
2020,Mississippi,Rankin County,155975,633,1715,1339,376,29,218,247,10,6357,11.017708638,8.6021643534,2.4155442844,0.1863052773,1.4005017394,1.5868070166
2020,Mississippi,Scott County,28061,-142,454,332,122,16,-280,-264,0,184,16.138205602,11.80150718,4.3366984217,0.568747334,-9.953078345,-9.384331011
2020,Mississippi,Sharkey County,4160,-152,57,50,7,1,-159,-158,-1,108,13.456090652,11.803588291,1.6525023607,0.2360717658,-37.53541076,-37.299339
2020,Mississippi,Simpson County,26629,-174,324,324,0,10,-183,-173,-1,545,12.127564007,12.127564007,0.0,0.3743075311,-6.849827819,-6.475520287
2020,Mississippi,Smith County,15779,-61,188,197,-9,0,-51,-51,-1,118,11.891584174,12.46086214,-0.569277966,0.0,-3.225908473,-3.225908473
2020,Mississippi,Stone County,18360,71,218,199,19,0,51,51,1,1276,11.896641109,10.859777893,1.0368632159,0.0,2.7831591585,2.7831591585
2020,Mississippi,Sunflower County,24740,-391,271,322,-51,2,-341,-339,-1,4053,10.868039542,12.913316356,-2.045276814,0.0802069339,-13.67528223,-13.59507529
2020,Mississippi,Tallahatchie County,13707,-224,155,157,-2,1,-220,-219,-3,2462,11.216441132,11.361169404,-0.144728273,0.0723641363,-15.92010999,-15.84774586
2020,Mississippi,Tate County,28539,235,352,318,34,-2,203,201,0,1066,12.384990236,11.18871277,1.196277466,-0.070369263,7.1424801647,7.072110902
2020,Mississippi,Tippah County,21748,-273,250,261,-11,-5,-256,-261,-1,324,11.423610318,11.926249172,-0.502638854,-0.228472206,-11.69777697,-11.92624917
2020,Mississippi,Tishomingo County,19275,-93,190,300,-110,-2,18,16,1,283,9.8336050514,15.526744818,-5.693139767,-0.103511632,0.9316046891,0.828093057
2020,Mississippi,Tunica County,9392,-210,155,100,55,4,-266,-262,-3,104,16.320943456,10.529640939,5.7913025166,0.4211856376,-28.0088449,-27.58765926
2020,Mississippi,Union County,28866,155,348,297,51,15,87,102,2,277,12.088160203,10.316619483,1.7715407194,0.5210413881,3.0220400507,3.5430814388
2020,Mississippi,Walthall County,14294,-22,160,190,-30,1,7,8,0,102,11.184900384,13.282069207,-2.097168822,0.0699056274,0.4893393918,0.5592450192
2020,Mississippi,Warren County,44841,-636,555,534,21,26,-681,-655,-2,522,12.289908988,11.824885405,0.4650235833,0.5757434841,-15.08005049,-14.504307
2020,Mississippi,Washington County,42837,-1136,573,671,-98,13,-1044,-1031,-7,595,13.201244096,15.459048497,-2.2578044,0.2995046654,-24.05252851,-23.75302385
2020,Mississippi,Wayne County,20317,131,265,216,49,0,83,83,-1,137,13.08545046,10.665876602,2.4195738587,0.0,4.0984618423,4.0984618423
2020,Mississippi,Webster County,9676,-26,118,144,-26,-1,0,-1,1,55,12.178759418,14.862214883,-2.683455465,-0.103209826,0.0,-0.103209826
2020,Mississippi,Wilkinson County,8351,-277,94,132,-38,-1,-236,-237,-2,1061,11.072501325,15.548618882,-4.476117557,-0.117792567,-27.79904588,-27.91683845
2020,Mississippi,Winston County,17845,-148,192,248,-56,-1,-91,-92,0,459,10.714883643,13.840058039,-3.125174396,-0.055806686,-5.078408393,-5.134215079
2020,Mississippi,Yalobusha County,11982,-122,139,191,-52,-1,-68,-69,-1,151,11.541974591,15.859835589,-4.317860998,-0.083035788,-5.646433613,-5.729469401
2020,Mississippi,Yazoo County,26982,-2716,309,287,22,2,-2720,-2718,-20,4577,10.903316867,10.127028934,0.7762879323,0.0705716302,-95.97741708,-95.90684545
2020,Missouri,Missouri,6151548,11073,71982,65045,6937,5360,-1267,4093,43,166664,11.711985895,10.583286413,1.1286994826,0.8721103109,-0.206149956,0.6659603549
2020,Missouri,Adair County,25399,-112,288,229,59,92,-264,-172,1,2916,11.314083677,8.9962679238,2.3178157533,3.6142211746,-10.37124337,-6.757022196
2020,Missouri,Andrew County,17586,-113,200,184,16,-1,-129,-130,1,192,11.336261868,10.429360918,0.9069009494,-0.056681309,-7.311888905,-7.368570214
2020,Missouri,Atchison County,5096,-13,44,84,-40,2,25,27,0,98,8.6232239098,16.462518373,-7.839294463,0.3919647232,4.8995590397,5.2915237629
2020,Missouri,Audrain County,24835,-127,306,297,9,0,-136,-136,0,1791,12.289896982,11.928429423,0.3614675583,0.0,-5.462176436,-5.462176436
2020,Missouri,Barry County,35818,29,402,415,-13,-11,53,42,0,296,11.227952574,11.591045568,-0.363092994,-0.307232533,1.4803022051,1.173069672
2020,Missouri,Barton County,11592,-89,127,146,-19,0,-71,-71,1,90,10.913934602,12.546727968,-1.632793366,0.0,-6.101490998,-6.101490998
2020,Missouri,Bates County,16242,29,174,203,-29,3,54,57,1,311,10.7225389,12.509628717,-1.787089817,0.1848713603,3.3276844862,3.5125558466
2020,Missouri,Benton County,19627,150,170,330,-160,-1,312,311,-1,244,8.6947626841,16.87806874,-8.183306056,-0.051145663,15.957446809,15.906301146
2020,Missouri,Bollinger County,12111,-31,141,141,0,1,-31,-30,-1,163,11.627427535,11.627427535,0.0,0.0824640251,-2.556384777,-2.473920752
2020,Missouri,Boone County,182991,1907,2059,1245,814,489,589,1078,15,9035,11.31085628,6.8392501545,4.4716061251,2.6862596992,3.235597061,5.9218567603
2020,Missouri,Buchanan County,86530,-682,1045,951,94,99,-872,-773,-3,4071,12.029330847,10.947266637,1.0820642102,1.1396208171,-10.03787225,-8.89825143
2020,Missouri,Butler County,42178,-396,518,592,-74,2,-322,-320,-2,864,12.223900321,13.970171795,-1.746271474,0.0471965263,-7.59864074,-7.551444214
2020,Missouri,Caldwell County,9051,12,100,104,-4,1,15,16,0,214,11.055831951,11.498065229,-0.442233278,0.1105583195,1.6583747927,1.7689331122
2020,Missouri,Callaway County,44887,125,491,454,37,11,76,87,1,3622,10.953831052,10.128389608,0.8254414439,0.2454015103,1.6955013441,1.9409028545
2020,Missouri,Camden County,46414,203,360,582,-222,-1,429,428,-3,774,7.7732793522,12.566801619,-4.793522267,-0.021592443,9.2631578947,9.2415654521
2020,Missouri,Cape Girardeau County,79512,541,879,811,68,115,354,469,4,3827,11.0926724,10.234536196,0.8581362039,1.4512597566,4.4673561202,5.9186158768
2020,Missouri,Carroll County,8554,-144,86,115,-29,2,-115,-113,-2,88,9.9698585671,13.331787619,-3.361929052,0.231857176,-13.33178762,-13.09993044
2020,Missouri,Carter County,5991,10,72,92,-20,0,32,32,-2,40,12.028065486,15.369194788,-3.341129302,0.0,5.3458068827,5.3458068827
2020,Missouri,Cass County,106806,1075,1155,1079,76,-4,1004,1000,-1,1045,10.868695804,10.15352621,0.715169594,-0.037640505,9.4477667418,9.4101262368
2020,Missouri,Cedar County,14322,21,194,224,-30,1,50,51,0,156,13.555532264,15.651748594,-2.09621633,0.0698738777,3.4936938825,3.5635677602
2020,Missouri,Chariton County,7360,-103,90,103,-13,0,-89,-89,-1,213,12.143290832,13.89732173,-1.754030898,0.0,-12.00836538,-12.00836538
2020,Missouri,Christian County,90655,1742,1062,759,303,55,1388,1443,-4,582,11.828388132,8.4536220262,3.3747661053,0.6125813062,15.459324601,16.071905908
2020,Missouri,Clark County,6830,26,73,73,0,3,23,26,0,90,10.708522811,10.708522811,0.0,0.4400762799,3.3739181458,3.8139944257
2020,Missouri,Clay County,253463,2941,3118,2000,1118,130,1687,1817,6,2657,12.373384128,7.9367441491,4.4366399794,0.5158883697,6.6946436898,7.2105320595
2020,Missouri,Clinton County,20553,119,227,243,-16,-1,135,134,1,424,11.076682851,11.857418206,-0.780735355,-0.04879596,6.5874545588,6.5386585991
2020,Missouri,Cole County,76191,-583,861,757,104,73,-756,-683,-4,4239,11.257477201,9.8976890138,1.3597881868,0.9544667081,-9.884614127,-8.930147419
2020,Missouri,Cooper County,17102,-461,204,198,6,2,-467,-465,-2,982,11.769796625,11.423626136,0.346170489,0.115390163,-26.94360306,-26.82821289
2020,Missouri,Crawford County,23739,-117,254,332,-78,-4,-34,-38,-1,332,10.673390062,13.951045278,-3.277655216,-0.168084883,-1.428721504,-1.596806387
2020,Missouri,Dade County,7568,21,70,115,-45,2,65,67,-1,133,9.2623221965,15.21667218,-5.954349983,0.264637777,8.6007277539,8.8653655309
2020,Missouri,Dallas County,17219,235,233,231,2,15,219,234,-1,199,13.624535859,13.507587054,0.1169488057,0.8771160425,12.80589422,13.683010262
2020,Missouri,Daviess County,8283,10,124,93,31,0,-20,-20,-1,152,14.979463639,11.234597729,3.7448659096,0.0,-2.416042522,-2.416042522
2020,Missouri,DeKalb County,10944,142,92,95,-3,1,145,146,-1,1851,8.4613262209,8.7372390325,-0.275912812,0.0919709372,13.335785892,13.427756829
2020,Missouri,Dent County,15481,-67,161,229,-68,6,-6,0,1,201,10.377388894,14.760385446,-4.382996552,0.3867349898,-0.38673499,0.0
2020,Missouri,Douglas County,13344,96,134,179,-45,-2,143,141,0,123,10.078219013,13.462695548,-3.384476534,-0.150421179,10.75511432,10.604693141
2020,Missouri,Dunklin County,28878,-295,365,452,-87,32,-241,-209,1,645,12.575149438,15.572513824,-2.997364386,1.1024788548,-8.303043875,-7.20056502
2020,Missouri,Franklin County,104469,609,1180,1173,7,18,581,599,3,858,11.328235627,11.26103423,0.0672013978,0.1728035943,5.5777160165,5.7505196108
2020,Missouri,Gasconade County,14566,-105,151,227,-76,0,-29,-29,0,250,10.329377159,15.528268974,-5.198891815,0.0,-1.983787666,-1.983787666
2020,Missouri,Gentry County,6484,-80,86,93,-7,0,-73,-73,0,177,13.182096873,14.255058246,-1.072961373,0.0,-11.18945432,-11.18945432
2020,Missouri,Greene County,294997,1498,3347,3048,299,242,946,1188,11,11284,11.374758707,10.358609064,1.0161496425,0.8224354966,3.214975123,4.0374106196
2020,Missouri,Grundy County,9595,-185,129,129,0,7,-191,-184,-1,350,13.316129032,13.316129032,0.0,0.7225806452,-19.71612903,-18.99354839
2020,Missouri,Harrison County,8321,-25,90,121,-31,0,5,5,1,145,10.799784004,14.519709606,-3.719925601,0.0,0.5999880002,0.5999880002
2020,Missouri,Henry County,22076,105,275,321,-46,-2,155,153,-2,233,12.486661975,14.575339978,-2.088678003,-0.090812087,7.0379367494,6.9471246623
2020,Missouri,Hickory County,9586,90,82,155,-73,-1,165,164,-1,75,8.5944869511,16.245676554,-7.651189603,-0.104810816,17.293784719,17.188973902
2020,Missouri,Holt County,4232,-155,47,69,-22,0,-133,-133,0,101,10.906137603,16.011138183,-5.10500058,0.0,-30.86204896,-30.86204896
2020,Missouri,Howard County,10001,19,106,90,16,1,3,4,-1,720,10.609017665,9.007656508,1.601361157,0.1000850723,0.3002552169,0.4003402892
2020,Missouri,Howell County,40262,178,485,555,-70,4,245,249,-1,608,12.072785204,13.815249048,-1.742463844,0.0995693625,6.0986234536,6.1981928161
2020,Missouri,Iron County,10098,-54,104,174,-70,1,15,16,0,276,10.271604938,17.185185185,-6.913580247,0.0987654321,1.4814814815,1.5802469136
2020,Missouri,Jackson County,705925,1575,8913,7121,1792,729,-979,-250,33,10935,12.640087926,10.098739608,2.5413483186,1.0338409176,-1.388381699,-0.354540781
2020,Missouri,Jasper County,121648,420,1548,1290,258,85,68,153,9,2488,12.747245508,10.62270459,2.124540918,0.6999456513,0.559956521,1.2599021723
2020,Missouri,Jefferson County,226543,1141,2496,2347,149,47,937,984,8,1984,11.045591831,10.386219562,0.6593722687,0.2079899103,4.1465222538,4.3545121641
2020,Missouri,Johnson County,54219,32,691,426,265,32,-267,-235,2,3734,12.748371861,7.8593435788,4.8890282826,0.5903732266,-4.925926609,-4.335553383
2020,Missouri,Knox County,3940,-17,62,43,19,0,-35,-35,-1,87,15.702165379,10.890211473,4.8119539065,0.0,-8.864125617,-8.864125617
2020,Missouri,Laclede County,35895,26,481,432,49,0,-24,-24,1,345,13.405049886,12.039462683,1.3655872025,0.0,-0.668859038,-0.668859038
2020,Missouri,Lafayette County,33006,232,398,383,15,1,217,218,-1,724,12.100942536,11.644876862,0.4560656735,0.0304043782,6.597750076,6.6281544542
2020,Missouri,Lawrence County,38175,-113,509,486,23,-5,-132,-137,1,534,13.313628814,12.712030655,0.6015981586,-0.130782208,-3.452650301,-3.58343251
2020,Missouri,Lewis County,9810,23,116,104,12,1,11,12,-1,788,11.838546716,10.61386947,1.2246772465,0.1020564372,1.1226208093,1.2246772465
2020,Missouri,Lincoln County,60119,1079,823,525,298,3,777,780,1,632,13.813476112,8.8117557213,5.0017203904,0.0503528898,13.041398468,13.091751357
2020,Missouri,Linn County,11830,-76,135,158,-23,3,-55,-52,-1,152,11.37512639,13.313110886,-1.937984496,0.2527805865,-4.634310752,-4.381530165
2020,Missouri,Livingston County,14413,-569,152,193,-41,4,-530,-526,-2,1257,10.34189488,13.131484946,-2.789590066,0.2721551284,-36.06055452,-35.78839939
2020,Missouri,McDonald County,22900,-12,329,240,89,40,-140,-100,-1,157,14.363048983,10.477604121,3.8854448616,1.7462673535,-6.111935737,-4.365668384
2020,Missouri,Macon County,15095,-16,171,196,-25,6,2,8,1,286,11.322253857,12.977554128,-1.655300271,0.3972720652,0.1324240217,0.5296960869
2020,Missouri,Madison County,12113,-5,127,174,-47,-3,44,41,1,165,10.48243985,14.361767983,-3.879328133,-0.247616689,3.631711444,3.3840947547
2020,Missouri,Maries County,8795,44,88,114,-26,3,68,71,-1,67,10.030776245,12.994414681,-2.963638436,0.3419582811,7.7510543714,8.0930126525
2020,Missouri,Marion County,28423,-120,350,327,23,12,-154,-142,-1,1367,12.288031457,11.480532247,0.8074992101,0.4213039357,-5.406733841,-4.985429906
2020,Missouri,Mercer County,3558,-61,43,34,9,2,-71,-69,-1,51,11.982722586,9.474710882,2.5080117041,0.5573359342,-19.78542567,-19.22808973
2020,Missouri,Miller County,25791,184,323,296,27,0,158,158,-1,271,12.568582435,11.517957897,1.0506245379,0.0,6.1480991478,6.1480991478
2020,Missouri,Mississippi County,12691,-517,150,198,-48,0,-466,-466,-3,1427,11.583458821,15.290165643,-3.706706823,0.0,-35.9859454,-35.9859454
2020,Missouri,Moniteau County,15585,-231,189,167,22,4,-256,-252,-1,883,12.03783319,10.63660393,1.4012292602,0.2547689564,-16.30521321,-16.05044425
2020,Missouri,Monroe County,8672,45,88,113,-25,0,70,70,0,128,10.173998497,13.064338979,-2.890340482,0.0,8.0929533499,8.0929533499
2020,Missouri,Montgomery County,11294,-178,135,168,-33,0,-143,-143,-2,394,11.859790916,14.758850918,-2.899060002,0.0,-12.56259334,-12.56259334
2020,Missouri,Morgan County,20716,-4,254,303,-49,0,46,46,-1,302,12.259870644,14.6249638,-2.365093156,0.0,2.2202915339,2.2202915339
2020,Missouri,New Madrid County,16693,-359,215,251,-36,0,-321,-321,-2,332,12.742628538,14.876277967,-2.13364943,0.0,-19.02504075,-19.02504075
2020,Missouri,Newton County,58451,122,723,652,71,10,40,50,1,880,12.382257236,11.166295599,1.2159616373,0.1712622024,0.6850488097,0.8563110122
2020,Missouri,Nodaway County,21743,-346,206,183,23,7,-374,-367,-2,3444,9.3995254609,8.3500638803,1.0494615806,0.3194013506,-17.06515788,-16.74575652
2020,Missouri,Oregon County,10411,-106,118,151,-33,1,-74,-73,0,121,11.27675841,14.430428135,-3.153669725,0.0955657492,-7.071865443,-6.976299694
2020,Missouri,Osage County,13535,-86,139,138,1,0,-88,-88,1,405,10.237148328,10.163499779,0.0736485491,0.0,-6.481072323,-6.481072323
2020,Missouri,Ozark County,9083,-72,70,130,-60,0,-12,-12,0,123,7.6762802939,14.255949117,-6.579668823,0.0,-1.315933765,-1.315933765
2020,Missouri,Pemiscot County,15600,-264,221,238,-17,-1,-245,-246,-1,202,14.047800661,15.128400712,-1.080600051,-0.063564709,-15.57335367,-15.63691838
2020,Missouri,Perry County,19194,30,216,226,-10,10,29,39,1,286,11.26231816,11.783721779,-0.521403619,0.5214036185,1.5120704938,2.0334741123
2020,Missouri,Pettis County,42490,73,587,438,149,37,-115,-78,2,851,13.826892953,10.317170551,3.5097224022,0.8715418046,-2.708846149,-1.837304345
2020,Missouri,Phelps County,44414,-179,440,484,-44,148,-284,-136,1,3012,9.886862831,10.875549114,-0.988686283,3.3255811341,-6.381520555,-3.05593942
2020,Missouri,Pike County,17552,-126,199,197,2,2,-129,-127,-1,1522,11.297189895,11.183650298,0.1135395969,0.1135395969,-7.323304002,-7.209764405
2020,Missouri,Platte County,106532,1806,1214,767,447,187,1175,1362,-3,869,11.493055884,7.2612634788,4.2317924055,1.7703471585,11.123839097,12.894186256
2020,Missouri,Polk County,32490,262,425,429,-4,-4,270,266,0,1514,13.133904014,13.257517229,-0.123613214,-0.123613214,8.3438919621,8.2202787478
2020,Missouri,Pulaski County,52709,75,725,340,385,25,-337,-312,2,10019,13.764559582,6.4551038038,7.3094557778,0.4746399856,-6.398147005,-5.92350702
2020,Missouri,Putnam County,4688,0,53,72,-19,0,19,19,0,57,11.305460751,15.358361775,-4.052901024,0.0,4.0529010239,4.0529010239
2020,Missouri,Ralls County,10299,7,91,95,-4,0,12,12,-1,54,8.8388130737,9.2273323297,-0.388519256,0.0,1.165557768,1.165557768
2020,Missouri,Randolph County,24409,-430,287,269,18,3,-449,-446,-2,2279,11.655295647,10.924301494,0.730994152,0.1218323587,-18.23424301,-18.11241066
2020,Missouri,Ray County,22915,-109,256,287,-31,2,-81,-79,1,311,11.145214306,12.494830101,-1.349615795,0.0870719868,-3.526415464,-3.439343477
2020,Missouri,Reynolds County,6198,-90,67,99,-32,0,-57,-57,-1,101,10.732019862,15.857760692,-5.12574083,0.0,-9.130225853,-9.130225853
2020,Missouri,Ripley County,13300,-43,154,221,-67,-2,27,25,-1,63,11.560259731,16.589723379,-5.029463649,-0.150133243,2.0267987839,1.8766655407
2020,Missouri,St. Charles County,406204,4579,4254,3274,980,326,3271,3597,2,5452,10.531931882,8.1056758299,2.4262560517,0.8071015029,8.0982485155,8.9053500184
2020,Missouri,St. Clair County,9689,239,92,152,-60,1,301,302,-3,207,9.6138774231,15.883797482,-6.269920059,0.1044986676,31.45409896,31.558597628
2020,Missouri,Ste. Genevieve County,17924,-33,209,202,7,1,-41,-40,0,277,11.649619576,11.25944093,0.3901786461,0.0557398066,-2.28533207,-2.229592263
2020,Missouri,St. Francois County,66485,-457,678,836,-158,-3,-296,-299,0,6279,10.16286059,12.531196834,-2.368336244,-0.04496841,-4.43688309,-4.481851499
2020,Missouri,St. Louis County,994020,-1447,11261,10827,434,1580,-3489,-1909,28,19110,11.320506241,10.884212865,0.4362933761,1.5883491573,-3.507436842,-1.919087684
2020,Missouri,Saline County,22858,31,256,259,-3,48,-15,33,1,1491,11.207179599,11.338513735,-0.131334136,2.1013461749,-0.65667068,1.4446754952
2020,Missouri,Schuyler County,4534,-98,65,48,17,0,-115,-115,0,47,14.182849662,10.473488981,3.7093606808,0.0,-25.09273402,-25.09273402
2020,Missouri,Scotland County,4871,-65,72,45,27,0,-90,-90,-2,76,14.683389416,9.1771183848,5.5062710309,0.0,-18.35423677,-18.35423677
2020,Missouri,Scott County,38288,-128,488,495,-7,-1,-121,-122,1,559,12.724238632,12.906758448,-0.182519816,-0.026074259,-3.154985398,-3.181059658
2020,Missouri,Shannon County,8203,26,88,106,-18,0,43,43,1,80,10.744810745,12.942612943,-2.197802198,0.0,5.2503052503,5.2503052503
2020,Missouri,Shelby County,5919,-4,73,59,14,0,-18,-18,0,198,12.32899848,9.9645330181,2.3644654619,0.0,-3.040027022,-3.040027022
2020,Missouri,Stoddard County,29001,-95,334,409,-75,1,-21,-20,0,689,11.498011946,14.079900855,-2.58188891,0.0344251855,-0.722928895,-0.688503709
2020,Missouri,Stone County,32465,463,260,432,-172,-1,643,642,-7,300,8.0661423674,13.40220578,-5.336063412,-0.031023624,19.948190547,19.917166923
2020,Missouri,Sullivan County,6033,-28,93,71,22,11,-62,-51,1,108,15.379527038,11.741359352,3.6381676865,1.8190838432,-10.25301803,-8.433934182
2020,Missouri,Taney County,56104,47,627,602,25,11,11,22,0,1756,11.180356809,10.734569057,0.4457877515,0.1961466107,0.1961466107,0.3922932214
2020,Missouri,Texas County,25112,-271,263,321,-58,0,-212,-212,-1,1698,10.416872958,12.714130112,-2.297257154,0.0,-8.396870977,-8.396870977
2020,Missouri,Vernon County,20388,-266,248,251,-3,3,-265,-262,-1,868,12.085181034,12.23137274,-0.146191706,0.1461917061,-12.9136007,-12.767409
2020,Missouri,Warren County,36594,878,441,332,109,11,764,775,-6,317,12.197483059,9.182685659,3.0147974001,0.3042456092,21.131240492,21.435486102
2020,Missouri,Washington County,24604,-139,269,313,-44,0,-97,-97,2,1047,10.90238515,12.685674914,-1.783289764,0.0,-3.931343344,-3.931343344
2020,Missouri,Wayne County,12769,-135,123,190,-67,-1,-68,-69,1,133,9.5820511822,14.801542477,-5.219491294,-0.077902855,-5.297394149,-5.375297005
2020,Missouri,Webster County,39859,215,616,410,206,11,-2,9,0,729,15.496270581,10.314076198,5.1821943826,0.2767191175,-0.050312567,0.2264065507
2020,Missouri,Worth County,1953,-36,21,23,-2,0,-34,-34,0,52,10.654490107,11.66920345,-1.014713343,0.0,-17.25012684,-17.25012684
2020,Missouri,Wright County,18325,-4,243,243,0,-2,-1,-3,-1,195,13.25912588,13.25912588,0.0,-0.109128608,-0.054564304,-0.163692912
2020,Missouri,St. Louis city,297645,-3242,3970,3348,622,593,-4439,-3846,-18,11656,13.2657903,11.18737177,2.0784185307,1.9815147728,-14.83295797,-12.8514432
2020,Montana,Montana,1080577,10454,11314,10756,558,990,8960,9950,-54,28900,10.521225647,10.002324824,0.518900823,0.9206304924,8.3321709211,9.2528014135
2020,Montana,Beaverhead County,9483,9,80,105,-25,10,25,35,-1,442,8.4401540328,11.077702168,-2.637548135,1.0550192541,2.6375481353,3.6925673894
2020,Montana,Big Horn County,13063,-185,211,143,68,7,-259,-252,-1,137,16.038919083,10.869978336,5.1689407472,0.5320968416,-19.68758314,-19.1554863
2020,Montana,Blaine County,6568,-136,104,69,35,1,-171,-170,-1,220,15.672091621,10.397830018,5.2742616034,0.1506931887,-25.76853526,-25.61784207
2020,Montana,Broadwater County,6444,241,61,61,0,0,243,243,-2,52,9.6465564956,9.6465564956,0.0,0.0,38.428085712,38.428085712
2020,Montana,Carbon County,10921,218,84,93,-9,7,223,230,-3,53,7.769145394,8.6015538291,-0.832408435,0.6474287828,20.625231225,21.272660007
2020,Montana,Carter County,1235,-10,20,15,5,0,-16,-16,1,11,16.129032258,12.096774194,4.0322580645,0.0,-12.90322581,-12.90322581
2020,Montana,Cascade County,81346,-47,1028,848,180,38,-266,-228,1,2447,12.633726396,10.421595315,2.2121310811,0.4670054504,-3.269038153,-2.802032703
2020,Montana,Chouteau County,5699,18,51,69,-18,0,36,36,0,135,8.9630931459,12.126537786,-3.16344464,0.0,6.3268892794,6.3268892794
2020,Montana,Custer County,11292,-69,109,157,-48,5,-26,-21,0,429,9.6234494327,13.861298724,-4.237849291,0.4414426345,-2.2955017,-1.854059065
2020,Montana,Daniels County,1638,-8,15,19,-4,0,-5,-5,1,41,9.1352009744,11.571254568,-2.436053593,0.0,-3.045066991,-3.045066991
2020,Montana,Dawson County,8555,-83,91,92,-1,2,-84,-82,0,498,10.585703484,10.702029896,-0.116326412,0.2326528238,-9.771418601,-9.538765777
2020,Montana,Deer Lodge County,9204,-3,73,129,-56,0,55,55,-2,852,7.9300418228,14.013361577,-6.083319754,0.0,5.9746890446,5.9746890446
2020,Montana,Fallon County,2826,-52,29,29,0,2,-53,-51,-1,34,10.168302945,10.168302945,0.0,0.7012622721,-18.58345021,-17.88218794
2020,Montana,Fergus County,11104,72,109,143,-34,11,97,108,-2,465,9.8482110589,12.920130105,-3.071919046,0.9938561619,8.7640043368,9.7578604987
2020,Montana,Flathead County,105851,1971,1114,1004,110,29,1842,1871,-10,992,10.623131535,9.5741688162,1.0489627189,0.2765447168,17.565357529,17.841902246
2020,Montana,Gallatin County,116806,2334,1130,681,449,223,1664,1887,-2,3273,9.7717897941,5.8890166812,3.8827731129,1.9284151541,14.389609042,16.318024196
2020,Montana,Garfield County,1268,-4,15,12,3,0,-7,-7,0,0,11.811023622,9.4488188976,2.3622047244,0.0,-5.511811024,-5.511811024
2020,Montana,Glacier County,13594,-107,206,152,54,5,-167,-162,1,690,15.094339623,11.137570984,3.9567686389,0.3663674666,-12.23667338,-11.87030592
2020,Montana,Golden Valley County,827,0,5,2,3,0,-3,-3,0,89,6.045949214,2.4183796856,3.6275695284,0.0,-3.627569528,-3.627569528
2020,Montana,Granite County,3317,-18,16,35,-19,1,0,1,0,40,4.8105832832,10.523150932,-5.712567649,0.3006614552,0.0,0.3006614552
2020,Montana,Hill County,16358,-136,288,176,112,16,-262,-246,-2,593,17.533179106,10.714720565,6.8184585413,0.9740655059,-15.95032266,-14.97625715
2020,Montana,Jefferson County,12360,149,82,152,-70,0,221,221,-2,230,6.674535021,12.372308819,-5.697773798,0.0,17.988685849,17.988685849
2020,Montana,Judith Basin County,1994,-16,19,19,0,0,-15,-15,-1,0,9.4905094905,9.4905094905,0.0,0.0,-7.492507493,-7.492507493
2020,Montana,Lake County,30986,400,299,370,-71,19,455,474,-3,584,9.7122068473,12.018449945,-2.306243098,0.6171636458,14.779445202,15.396608848
2020,Montana,Lewis and Clark County,70229,651,727,711,16,42,596,638,-3,1958,10.4000515,10.171164534,0.2288869656,0.6008282847,8.5260394687,9.1268677534
2020,Montana,Liberty County,2369,-17,26,24,2,0,-19,-19,0,403,10.935856993,10.094637224,0.8412197687,0.0,-7.991587802,-7.991587802
2020,Montana,Lincoln County,20343,244,176,311,-135,29,352,381,-2,209,8.7038227585,15.380050443,-6.676227684,1.4341526136,17.407645517,18.841798131
2020,Montana,McCone County,1648,-1,14,18,-4,0,3,3,0,19,8.4925690021,10.919017288,-2.426448286,0.0,1.8198362147,1.8198362147
2020,Montana,Madison County,8959,210,78,82,-4,21,194,215,-1,163,8.809577592,9.2613508019,-0.45177321,2.3718093517,21.911000678,24.282810029
2020,Montana,Meagher County,1831,-10,19,23,-4,3,-10,-7,1,174,10.348583878,12.527233115,-2.178649237,1.6339869281,-5.446623094,-3.812636166
2020,Montana,Mineral County,4544,122,43,58,-15,-1,140,139,-2,22,9.5917912112,12.93776489,-3.345973678,-0.223064912,31.229087665,31.006022753
2020,Montana,Missoula County,121630,1564,1057,973,84,237,1242,1479,1,3644,8.7465245598,8.0514365153,0.6950880445,1.9611412684,10.277373229,12.238514498
2020,Montana,Musselshell County,4669,43,45,73,-28,0,71,71,0,52,9.6826250672,15.707369554,-6.024744486,0.0,15.277030662,15.277030662
2020,Montana,Park County,16760,148,157,181,-24,4,169,173,-1,108,9.4090854609,10.847416996,-1.438331535,0.2397219226,10.128251229,10.367973151
2020,Montana,Petroleum County,500,3,2,6,-4,0,7,7,0,0,4.0120361083,12.036108325,-8.024072217,0.0,14.042126379,14.042126379
2020,Montana,Phillips County,3919,-36,44,45,-1,0,-34,-34,-1,127,11.176022352,11.43002286,-0.254000508,0.0,-8.636017272,-8.636017272
2020,Montana,Pondera County,5782,-76,55,61,-6,8,-77,-69,-1,645,9.4501718213,10.481099656,-1.030927835,1.3745704467,-13.23024055,-11.8556701
2020,Montana,Powder River County,1681,-7,18,16,2,0,-9,-9,0,35,10.685663402,9.4983674681,1.1872959335,0.0,-5.342831701,-5.342831701
2020,Montana,Powell County,6817,-37,52,91,-39,1,2,3,-1,1699,7.6073440129,13.312852023,-5.70550801,0.1462950772,0.2925901543,0.4388852315
2020,Montana,Prairie County,1067,3,19,9,10,0,-7,-7,0,21,17.832003754,8.4467386204,9.3852651337,0.0,-6.569685594,-6.569685594
2020,Montana,Ravalli County,45002,853,393,529,-136,28,967,995,-6,478,8.8165023387,11.867505693,-3.051003354,0.6281477493,21.6935312,22.321678949
2020,Montana,Richland County,11043,100,152,85,67,-2,36,34,-1,34,13.826980806,7.7321932139,6.0947875921,-0.181933958,3.2748112435,3.0928772855
2020,Montana,Roosevelt County,10964,-63,205,179,26,8,-97,-89,0,186,18.643990723,16.279387022,2.3646037015,0.7275703697,-8.821790733,-8.094220363
2020,Montana,Rosebud County,8836,-119,118,107,11,11,-140,-129,-1,65,13.265134057,12.028553763,1.2365802934,1.2365802934,-15.73829464,-14.50171435
2020,Montana,Sanders County,12157,211,98,148,-50,1,262,263,-2,188,8.1317678297,12.280628967,-4.148861138,0.0829772228,21.740032361,21.823009584
2020,Montana,Sheridan County,3261,-57,37,50,-13,0,-44,-44,0,85,11.247910017,15.199878401,-3.951968384,0.0,-13.37589299,-13.37589299
2020,Montana,Silver Bow County,35180,279,369,448,-79,59,301,360,-2,999,10.530671651,12.785205691,-2.254534039,1.683765928,8.5900600733,10.273826001
2020,Montana,Stillwater County,9888,217,92,89,3,8,207,215,-1,112,9.4074339179,9.1006697684,0.3067641495,0.818037732,21.166726315,21.984764047
2020,Montana,Sweet Grass County,3684,-33,27,40,-13,0,-20,-20,0,45,7.2963113093,10.809350088,-3.513038779,0.0,-5.404675044,-5.404675044
2020,Montana,Teton County,6249,99,73,70,3,13,82,95,1,461,11.775143157,11.291233164,0.4839099927,2.0969433019,13.226873135,15.323816437
2020,Montana,Toole County,4686,-23,55,50,5,0,-28,-28,0,668,11.708355508,10.643959553,1.0643959553,0.0,-5.96061735,-5.96061735
2020,Montana,Treasure County,695,-2,18,3,15,0,-16,-16,-1,0,25.862068966,4.3103448276,21.551724138,0.0,-22.98850575,-22.98850575
2020,Montana,Valley County,7359,-31,88,62,26,3,-60,-57,0,126,11.933012408,8.4073496508,3.5256627568,0.4068072412,-8.136144823,-7.729337582
2020,Montana,Wheatland County,2157,55,22,23,-1,0,57,57,-1,147,10.33106363,10.800657431,-0.469593801,0.0,26.766846678,26.766846678
2020,Montana,Wibaux County,939,-15,6,7,-1,0,-13,-13,-1,24,6.3391442155,7.3956682515,-1.056524036,0.0,-13.73481247,-13.73481247
2020,Montana,Yellowstone County,162990,1641,1790,1609,181,141,1319,1460,0,3696,11.037833871,9.9217177089,1.1161161624,0.8694606569,8.133465294,9.0029259509
2020,Nebraska,Nebraska,1937552,4981,25061,16824,8237,1837,-5123,-3286,30,50039,12.951009567,8.694297313,4.2567122544,0.9493238329,-2.647461076,-1.698137243
2020,Nebraska,Adams County,31321,12,391,330,61,54,-102,-48,-1,1261,12.48602906,10.538080792,1.9479482676,1.7244132205,-3.257224972,-1.532811752
2020,Nebraska,Antelope County,6264,-53,82,54,28,3,-83,-80,-1,53,13.035529767,8.5843732613,4.4511565058,0.4769096256,-13.19449964,-12.71759002
2020,Nebraska,Arthur County,466,-2,6,1,5,0,-8,-8,1,0,12.847965739,2.1413276231,10.706638116,0.0,-17.13062099,-17.13062099
2020,Nebraska,Banner County,786,29,9,1,8,1,20,21,0,0,11.66558652,1.29617628,10.36941024,1.29617628,25.923525599,27.219701879
2020,Nebraska,Blaine County,457,2,6,9,-3,0,4,4,1,0,13.157894737,19.736842105,-6.578947368,0.0,8.7719298246,8.7719298246
2020,Nebraska,Boone County,5096,-80,70,64,6,2,-86,-84,-2,98,13.629283489,12.46105919,1.1682242991,0.3894080997,-16.74454829,-16.35514019
2020,Nebraska,Box Butte County,10696,-90,129,109,20,4,-112,-108,-2,126,12.01005493,10.14803091,1.8620240201,0.372404804,-10.42733451,-10.05492971
2020,Nebraska,Boyd County,1860,-34,12,28,-16,1,-19,-18,0,28,6.3931806074,14.917421417,-8.52424081,0.5327650506,-10.12253596,-9.589770911
2020,Nebraska,Brown County,2981,15,33,33,0,3,12,15,0,26,11.098032621,11.098032621,0.0,1.0089120565,4.035648226,5.0445602825
2020,Nebraska,Buffalo County,50114,291,609,413,196,26,66,92,3,2156,12.187678237,8.2652070805,3.9224711568,0.5203278065,1.3208321242,1.8411599308
2020,Nebraska,Burt County,6477,-17,63,100,-37,0,21,21,-1,127,9.7139773341,15.419011641,-5.705034307,0.0,3.2379924447,3.2379924447
2020,Nebraska,Butler County,7960,-30,100,99,1,1,-31,-30,-1,166,12.539184953,12.413793103,0.1253918495,0.1253918495,-3.887147335,-3.761755486
2020,Nebraska,Cass County,26232,46,251,243,8,7,31,38,0,253,9.5768629097,9.2716242512,0.3052386585,0.2670838262,1.1827998016,1.4498836278
2020,Nebraska,Cedar County,8414,-6,112,101,11,1,-16,-15,-2,137,13.306403707,11.999524771,1.3068789355,0.118807176,-1.900914815,-1.782107639
2020,Nebraska,Chase County,3840,-61,49,56,-7,8,-63,-55,1,69,12.659863067,14.468414933,-1.808551867,2.0669164191,-16.2769668,-14.21005038
2020,Nebraska,Cherry County,5781,24,76,57,19,5,0,5,0,38,13.173860288,9.8803952158,3.2934650719,0.8667013347,0.0,0.8667013347
2020,Nebraska,Cheyenne County,9111,100,106,85,21,2,78,80,-1,70,11.698488026,9.3808630394,2.3176249862,0.2207261892,8.6083213773,8.8290475665
2020,Nebraska,Clay County,6216,-3,76,73,3,1,-6,-5,-1,72,12.223562525,11.741053478,0.482509047,0.160836349,-0.965018094,-0.804181745
2020,Nebraska,Colfax County,10587,-90,190,74,116,84,-288,-204,-2,51,17.870579383,6.9601203913,10.910458992,7.9006772009,-27.08803612,-19.18735892
2020,Nebraska,Cuming County,8798,-20,116,110,6,-2,-25,-27,1,93,13.169845595,12.488646685,0.6811989101,-0.227066303,-2.838328792,-3.065395095
2020,Nebraska,Custer County,10626,-170,125,114,11,1,-180,-179,-2,117,11.670245542,10.643263934,1.0269816077,0.0933619643,-16.80515358,-16.71179162
2020,Nebraska,Dakota County,20070,-30,342,136,206,18,-254,-236,0,253,17.027632562,6.7712223052,10.256410256,0.8961911875,-12.64625342,-11.75006224
2020,Nebraska,Dawes County,8361,-196,78,86,-8,2,-190,-188,0,978,9.2209481026,10.16668637,-0.945738267,0.2364345667,-22.46128384,-22.22484927
2020,Nebraska,Dawson County,23510,-61,396,217,179,84,-324,-240,0,296,16.822072598,9.218155944,7.6039166543,3.5683184299,-13.76351394,-10.19519551
2020,Nebraska,Deuel County,1793,-23,18,15,3,1,-28,-27,1,0,9.9750623441,8.3125519534,1.6625103907,0.5541701302,-15.51676365,-14.96259352
2020,Nebraska,Dixon County,5596,-40,68,53,15,9,-63,-54,-1,74,12.108262108,9.4373219373,2.6709401709,1.6025641026,-11.21794872,-9.615384615
2020,Nebraska,Dodge County,36222,-222,461,428,33,30,-286,-256,1,1068,12.6881898,11.779924586,0.9082652134,0.8256956486,-7.87163185,-7.045936201
2020,Nebraska,Douglas County,574332,3472,8194,4329,3865,671,-1100,-429,36,12040,14.31026413,7.5603042983,6.7499598321,1.1718558984,-1.921075243,-0.749219345
2020,Nebraska,Dundy County,1671,-15,20,25,-5,0,-10,-10,0,27,11.915400655,14.894250819,-2.978850164,0.0,-5.957700328,-5.957700328
2020,Nebraska,Fillmore County,5519,35,59,80,-21,0,56,56,0,194,10.724347905,14.541488685,-3.81714078,0.0,10.179042079,10.179042079
2020,Nebraska,Franklin County,2940,-5,36,36,0,0,-4,-4,-1,23,12.234494477,12.234494477,0.0,0.0,-1.359388275,-1.359388275
2020,Nebraska,Frontier County,2587,-44,27,16,11,0,-53,-53,-2,113,10.348792641,6.1326178612,4.2161747796,0.0,-20.31429667,-20.31429667
2020,Nebraska,Furnas County,4653,-37,62,48,14,0,-50,-50,-1,60,13.271968319,10.275072247,2.9968960719,0.0,-10.70320026,-10.70320026
2020,Nebraska,Gage County,21431,-111,209,278,-69,5,-48,-43,1,536,9.7270379075,12.938356643,-3.211318735,0.2327042562,-2.233960859,-2.001256603
2020,Nebraska,Garden County,1847,25,12,29,-17,0,42,42,0,21,6.5412919052,15.808122104,-9.266830199,0.0,22.894521668,22.894521668
2020,Nebraska,Garfield County,1956,-14,23,27,-4,0,-9,-9,-1,60,11.716760061,13.754457463,-2.037697402,0.0,-4.584819154,-4.584819154
2020,Nebraska,Gosper County,1986,8,23,23,0,0,10,10,-2,40,11.60443996,11.60443996,0.0,0.0,5.0454086781,5.0454086781
2020,Nebraska,Grant County,630,-1,6,8,-2,0,1,1,0,3,9.5162569389,12.688342585,-3.172085646,0.0,1.5860428232,1.5860428232
2020,Nebraska,Greeley County,2319,-49,26,32,-6,0,-42,-42,-1,57,11.094516748,13.654789844,-2.560273096,0.0,-17.92191167,-17.92191167
2020,Nebraska,Hall County,61028,-426,938,550,388,169,-979,-810,-4,820,15.316536307,8.9809114809,6.3356248265,2.7595891641,-15.98602244,-13.22643327
2020,Nebraska,Hamilton County,9237,-48,106,86,20,0,-67,-67,-1,126,11.445848181,9.2862541842,2.1595939963,0.0,-7.234639888,-7.234639888
2020,Nebraska,Harlan County,3311,-61,34,35,-1,0,-60,-60,0,45,10.175071076,10.474337872,-0.299266796,0.0,-17.95600778,-17.95600778
2020,Nebraska,Hayes County,916,5,10,7,3,1,1,2,0,0,10.946907499,7.662835249,3.2840722496,1.0946907499,1.0946907499,2.1893814997
2020,Nebraska,Hitchcock County,2773,14,25,42,-17,0,31,31,0,25,9.0383224873,15.184381779,-6.146059291,0.0,11.207519884,11.207519884
2020,Nebraska,Holt County,9956,-128,128,110,18,6,-150,-144,-2,99,12.774451098,10.978043912,1.7964071856,0.5988023952,-14.97005988,-14.37125749
2020,Nebraska,Hooker County,647,-21,5,9,-4,0,-17,-17,0,23,7.6045627376,13.688212928,-6.08365019,0.0,-25.85551331,-25.85551331
2020,Nebraska,Howard County,6488,65,78,79,-1,1,65,66,0,66,12.082720161,12.23762683,-0.154906669,0.1549066687,10.068933468,10.223840136
2020,Nebraska,Jefferson County,7099,79,84,95,-11,2,89,91,-1,99,11.898859693,13.4570437,-1.558184007,0.2833061832,12.607125151,12.890431334
2020,Nebraska,Johnson County,5057,7,35,58,-23,2,28,30,0,1056,6.9258929455,11.477194024,-4.551301078,0.3957653112,5.5407143564,5.9364796676
2020,Nebraska,Kearney County,6652,45,79,62,17,9,19,28,0,73,11.91643412,9.3521381703,2.5642959499,1.3575684441,2.8659778264,4.2235462705
2020,Nebraska,Keith County,7983,-38,82,92,-10,-3,-25,-28,0,30,10.24743814,11.497125719,-1.249687578,-0.374906273,-3.124218945,-3.499125219
2020,Nebraska,Keya Paha County,759,-25,5,8,-3,0,-23,-23,1,0,6.4808813999,10.36941024,-3.88852884,0.0,-29.81205444,-29.81205444
2020,Nebraska,Kimball County,3495,-102,34,52,-18,1,-83,-82,-2,50,9.5882684715,14.664410603,-5.076142132,0.2820078962,-23.40665539,-23.12464749
2020,Nebraska,Knox County,8304,-33,101,99,2,2,-36,-34,-1,204,12.138693588,11.898323418,0.2403701701,0.2403701701,-4.326663061,-4.086292891
2020,Nebraska,Lancaster County,320650,2247,3796,2313,1483,358,380,738,26,15272,11.880078804,7.2388362155,4.6412425886,1.1204078535,1.1892597328,2.3096675863
2020,Nebraska,Lincoln County,34347,-509,400,404,-4,9,-512,-503,-2,508,11.560192477,11.675794402,-0.115601925,0.2601043307,-14.79704637,-14.53694204
2020,Nebraska,Logan County,747,-3,7,4,3,2,-8,-6,0,0,9.3520374081,5.3440213761,4.0080160321,2.672010688,-10.68804275,-8.016032064
2020,Nebraska,Loup County,650,-9,7,10,-3,0,-6,-6,0,0,10.695187166,15.278838808,-4.583651642,0.0,-9.167303285,-9.167303285
2020,Nebraska,McPherson County,474,-19,2,4,-2,0,-16,-16,-1,0,4.1365046536,8.2730093071,-4.136504654,0.0,-33.09203723,-33.09203723
2020,Nebraska,Madison County,34813,-246,495,375,120,33,-397,-364,-2,1218,14.168765743,10.733913442,3.4348523014,0.9445843829,-11.36363636,-10.41905198
2020,Nebraska,Merrick County,7809,-9,86,92,-6,4,-8,-4,1,198,11.006591156,11.774492865,-0.767901709,0.5119344724,-1.023868945,-0.511934472
2020,Nebraska,Morrill County,4625,1,50,43,7,3,-9,-6,0,82,10.811979673,9.2983025192,1.5136771543,0.6487187804,-1.946156341,-1.297437561
2020,Nebraska,Nance County,3532,50,41,37,4,0,47,47,-1,142,11.690903906,10.550327916,1.1405759909,0.0,13.401767893,13.401767893
2020,Nebraska,Nemaha County,7044,101,78,74,4,3,94,97,0,502,11.153213698,10.581254022,0.5719596768,0.4289697576,13.441052406,13.870022163
2020,Nebraska,Nuckolls County,4134,-18,44,68,-24,2,4,6,0,46,10.620323437,16.41322713,-5.792903693,0.4827419744,0.9654839488,1.4482259232
2020,Nebraska,Otoe County,15965,-28,179,172,7,16,-51,-35,0,240,11.202202891,10.764127918,0.4380749734,1.0013142249,-3.191689092,-2.190374867
2020,Nebraska,Pawnee County,2601,-38,37,33,4,0,-40,-40,-2,31,14.122137405,12.595419847,1.5267175573,0.0,-15.26717557,-15.26717557
2020,Nebraska,Perkins County,2867,-17,29,27,2,0,-18,-18,-1,30,10.085202573,9.3896713615,0.695531212,0.0,-6.259780908,-6.259780908
2020,Nebraska,Phelps County,9006,15,115,100,15,7,-6,1,-1,244,12.779907762,11.112963272,1.6669444907,0.777907429,-0.666777796,0.1111296327
2020,Nebraska,Pierce County,7184,48,92,70,22,1,25,26,0,108,12.849162011,9.7765363128,3.0726256983,0.1396648045,3.4916201117,3.6312849162
2020,Nebraska,Platte County,33364,-49,459,298,161,50,-260,-210,0,439,13.747248304,8.9252287464,4.8220195576,1.4975216017,-7.787112329,-6.289590727
2020,Nebraska,Polk County,5201,47,57,61,-4,0,53,53,-2,96,11.009174312,11.781747948,-0.772573636,0.0,10.236600676,10.236600676
2020,Nebraska,Red Willow County,10627,-93,133,134,-1,2,-93,-91,-1,423,12.460767321,12.554457301,-0.09368998,0.1873799597,-8.713168127,-8.525788167
2020,Nebraska,Richardson County,7791,-63,86,116,-30,1,-34,-33,0,129,10.993927772,14.829018856,-3.835091083,0.1278363694,-4.346436561,-4.218600192
2020,Nebraska,Rock County,1377,7,17,14,3,0,5,5,-1,22,12.377138697,10.19293775,2.1842009465,0.0,3.6403349108,3.6403349108
2020,Nebraska,Saline County,13987,-207,188,132,56,44,-305,-261,-2,846,13.342322842,9.3680139101,3.9743089315,3.1226713034,-21.64578972,-18.52311841
2020,Nebraska,Sarpy County,188856,1963,2458,1186,1272,47,632,679,12,1101,13.083201818,6.3127247178,6.7704771004,0.2501669998,3.3639477417,3.6141147415
2020,Nebraska,Saunders County,21927,365,248,216,32,4,332,336,-3,345,11.40518292,9.933546414,1.4716365058,0.1839545632,15.268228747,15.452183311
2020,Nebraska,Scotts Bluff County,35299,-283,419,449,-30,11,-263,-252,-1,764,11.822632299,12.669121485,-0.846489186,0.3103793682,-7.420888531,-7.110509163
2020,Nebraska,Seward County,17186,-132,187,159,28,4,-163,-159,-1,1234,10.839322977,9.2163227452,1.6230002319,0.231857176,-9.448179921,-9.216322745
2020,Nebraska,Sheridan County,5150,-79,63,67,-4,4,-78,-74,-1,144,12.139897871,12.910685037,-0.770787166,0.7707871664,-15.03034974,-14.25956258
2020,Nebraska,Sherman County,2986,2,35,43,-8,0,9,9,1,55,11.725293132,14.405360134,-2.680067002,0.0,3.0150753769,3.0150753769
2020,Nebraska,Sioux County,1200,42,7,2,5,0,37,37,0,0,5.9372349449,1.6963528414,4.2408821035,0.0,31.382527566,31.382527566
2020,Nebraska,Stanton County,5880,-52,79,41,38,3,-94,-91,1,0,13.376227565,6.942092787,6.4341347782,0.5079580088,-15.91601761,-15.4080596
2020,Nebraska,Thayer County,4887,-89,49,80,-31,0,-57,-57,-1,66,9.9361249113,16.222244753,-6.286119842,0.0,-11.55834939,-11.55834939
2020,Nebraska,Thomas County,739,16,6,1,5,1,10,11,0,2,8.2079343365,1.3679890561,6.8399452804,1.3679890561,13.679890561,15.047879617
2020,Nebraska,Thurston County,7220,-14,138,93,45,0,-60,-60,1,52,19.095060191,12.868410129,6.2266500623,0.0,-8.302200083,-8.302200083
2020,Nebraska,Valley County,4103,-14,49,57,-8,1,-8,-7,1,38,11.922141119,13.868613139,-1.946472019,0.2433090024,-1.946472019,-1.703163017
2020,Nebraska,Washington County,20901,218,204,191,13,2,203,205,0,137,9.8114659484,9.1862254713,0.6252404771,0.0961908426,9.7633705271,9.8595613698
2020,Nebraska,Wayne County,9492,79,90,55,35,10,34,44,0,1105,9.5212906638,5.8185665168,3.7027241471,1.0579211849,3.5969320286,4.6548532134
2020,Nebraska,Webster County,3419,-46,42,59,-17,0,-29,-29,0,156,12.202208019,17.141196979,-4.93898896,0.0,-8.425334108,-8.425334108
2020,Nebraska,Wheeler County,790,10,14,4,10,0,-1,-1,1,0,17.834394904,5.0955414013,12.738853503,0.0,-1.27388535,-1.27388535
2020,Nebraska,York County,13511,-101,160,136,24,3,-126,-123,-2,764,11.798104929,10.02838919,1.7697157394,0.2212144674,-9.291007632,-9.069793164
2020,Nevada,Nevada,3138259,47488,35906,28170,7736,4562,35202,39764,-12,36323,11.528600761,9.0447469349,2.4838538264,1.4647545444,11.302562357,12.767316902
2020,Nevada,Churchill County,25363,315,348,302,46,26,244,270,-1,327,13.806510484,11.981511972,1.8249985122,1.0315208982,9.680426891,10.711947789
2020,Nevada,Clark County,2315963,40079,26886,19618,7268,4322,28502,32824,-13,22331,11.710320488,8.5447097867,3.1656107009,1.8824669028,12.414176692,14.296643595
2020,Nevada,Douglas County,49088,90,329,599,-270,2,359,361,-1,230,6.7083987521,12.213771588,-5.505372836,0.0407805395,7.320106845,7.3608873845
2020,Nevada,Elko County,53006,126,725,339,386,5,-268,-263,3,772,13.693972763,6.4031127817,7.2908599815,0.0944411915,-5.062047863,-4.967606671
2020,Nevada,Esmeralda County,886,16,4,4,0,3,14,17,-1,1,4.555808656,4.555808656,0.0,3.416856492,15.945330296,19.362186788
2020,Nevada,Eureka County,2065,-13,16,12,4,0,-15,-15,-2,1,7.7238715906,5.792903693,1.9309678977,0.0,-7.241129616,-7.241129616
2020,Nevada,Humboldt County,16962,78,251,123,128,19,-70,-51,1,154,14.831885599,7.2682148555,7.563670744,1.1227323761,-4.136382438,-3.013650062
2020,Nevada,Lander County,5514,-2,71,46,25,-2,-26,-28,1,16,12.873980054,8.3408884859,4.5330915684,-0.362647325,-4.714415231,-5.077062557
2020,Nevada,Lincoln County,5159,-20,55,61,-6,0,-14,-14,0,239,10.640355968,11.801122074,-1.160766106,0.0,-2.708454246,-2.708454246
2020,Nevada,Lyon County,58319,820,614,702,-88,-18,929,911,-3,361,10.602842391,12.12246801,-1.51962562,-0.310832513,16.04241137,15.731578856
2020,Nevada,Mineral County,4518,2,40,96,-56,3,56,59,-1,52,8.8554350232,21.253044056,-12.39760903,0.6641576267,12.397609033,13.061766659
2020,Nevada,Nye County,48054,1209,417,861,-444,-11,1672,1661,-8,1047,8.7882907091,18.145607435,-9.357316726,-0.231825414,35.237462987,35.005637573
2020,Nevada,Pershing County,6573,-55,50,58,-8,1,-47,-46,-1,1698,7.5751836982,8.7872130899,-1.212029392,0.151503674,-7.120672676,-6.969169002
2020,Nevada,Storey County,4207,14,22,36,-14,-1,30,29,-1,5,5.2380952381,8.5714285714,-3.333333333,-0.238095238,7.1428571429,6.9047619048
2020,Nevada,Washoe County,477082,4701,5388,4440,948,209,3531,3740,13,5290,11.34957339,9.3526551324,1.996918258,0.4402488565,7.4378885749,7.8781374314
2020,Nevada,White Pine County,9466,-12,93,87,6,3,-20,-17,-1,1110,9.8184121622,9.1849662162,0.6334459459,0.316722973,-2.111486486,-1.794763514
2020,Nevada,Carson City,56034,140,597,786,-189,1,325,326,3,2689,10.667572011,14.044743049,-3.377171039,0.0178686298,5.8073046959,5.8251733257
2020,New Hampshire,New Hampshire,1366275,5492,12016,13114,-1098,2313,4244,6557,33,40463,8.8124271651,9.6176905662,-0.805263401,1.696333558,3.1125117251,4.8088452831
2020,New Hampshire,Belknap County,61551,153,466,841,-375,30,501,531,-3,1032,7.5803788563,13.680469138,-6.100090281,0.4880072225,8.1497206159,8.6377278384
2020,New Hampshire,Carroll County,49167,422,323,624,-301,18,711,729,-6,399,6.597761255,12.74613939,-6.148378135,0.3676770978,14.523245363,14.890922461
2020,New Hampshire,Cheshire County,76228,348,643,755,-112,56,403,459,1,3924,8.4545191574,9.92715702,-1.472637863,0.7363189313,5.2988665948,6.0351855261
2020,New Hampshire,Coos County,31174,-247,240,450,-210,9,-45,-36,-1,2134,7.6683441169,14.378145219,-6.709801102,0.2875629044,-1.437814522,-1.150251618
2020,New Hampshire,Grafton County,90691,322,675,909,-234,218,335,553,3,7056,7.4560919032,10.04087043,-2.584778526,2.4080415332,3.7004307964,6.1084723296
2020,New Hampshire,Hillsborough County,418735,997,4196,3708,488,1162,-677,485,24,7678,10.032601172,8.8657972224,1.1668039494,2.778332355,-1.618701381,1.1596309743
2020,New Hampshire,Merrimack County,152622,1016,1273,1437,-164,317,860,1177,3,6505,8.3687234574,9.4468622218,-1.078138764,2.0839633433,5.653654496,7.7376178393
2020,New Hampshire,Rockingham County,311307,1660,2674,2754,-80,197,1540,1737,3,2412,8.6125542311,8.8702222709,-0.25766804,0.6345075481,4.9601097666,5.5946173146
2020,New Hampshire,Strafford County,131533,817,1156,1155,1,299,508,807,9,8602,8.8160488696,8.8084225297,0.0076263399,2.2802756159,3.8741806451,6.154456261
2020,New Hampshire,Sullivan County,43267,4,370,481,-111,7,108,115,0,721,8.5519473015,11.117531492,-2.56558419,0.1617935976,2.4962440772,2.6580376748
2020,New Jersey,New Jersey,8882371,-8887,99603,81630,17973,19674,-46623,-26949,89,180001,11.207953086,9.185518613,2.022434473,2.2138416415,-5.246311825,-3.032470184
2020,New Jersey,Atlantic County,262945,-708,2761,3055,-294,295,-719,-424,10,5995,10.486177312,11.60277859,-1.116601278,1.1203992419,-2.730735779,-1.610336538
2020,New Jersey,Bergen County,930394,-1862,8901,7939,962,1783,-4632,-2849,25,10435,9.5573510858,8.5244141411,1.0329369447,1.9144766864,-4.973559176,-3.05908249
2020,New Jersey,Burlington County,446596,436,4331,4404,-73,214,280,494,15,11774,9.7025391036,9.8660776293,-0.163538526,0.4794143081,0.6272710573,1.1066853653
2020,New Jersey,Camden County,506809,306,6100,5251,849,646,-1222,-576,33,7501,12.039727152,10.36403398,1.6756931725,1.2750268427,-2.411892882,-1.136866039
2020,New Jersey,Cape May County,91546,-701,813,1393,-580,32,-151,-119,-2,2711,8.8469092947,15.1583575,-6.311448205,0.348217832,-1.643152895,-1.294935063
2020,New Jersey,Cumberland County,147008,-1987,1850,1630,220,87,-2290,-2203,-4,8760,12.499873312,11.013401891,1.4864714209,0.5878318801,-15.47281615,-14.88498427
2020,New Jersey,Essex County,800501,-1661,10253,6750,3503,3010,-8188,-5178,14,23148,12.794954398,8.4234801702,4.3714742276,3.7562481944,-10.21799343,-6.461745233
2020,New Jersey,Gloucester County,293245,1403,2719,2937,-218,109,1509,1618,3,4238,9.2943442599,10.039532582,-0.745188322,0.3725941612,5.158207241,5.5308014022
2020,New Jersey,Hudson County,671666,-2364,10142,4459,5683,4638,-12630,-7992,-55,9488,15.07324091,6.6270539557,8.4461869546,6.8930872946,-18.7709557,-11.8778684
2020,New Jersey,Hunterdon County,124797,-404,973,1044,-71,82,-410,-328,-5,3842,7.7840622725,8.3520668165,-0.568004544,0.656005248,-3.28002624,-2.624020992
2020,New Jersey,Mercer County,367239,-808,3920,3219,701,1184,-2707,-1523,14,19977,10.662517714,8.7557766638,1.9067410504,3.2205155545,-7.363121289,-4.142605734
2020,New Jersey,Middlesex County,822736,-1658,8607,6707,1900,2837,-6424,-3587,29,23006,10.450905514,8.1438623545,2.3070431599,3.4447797077,-7.800234347,-4.355454639
2020,New Jersey,Monmouth County,618381,-1306,5799,6241,-442,164,-1032,-868,4,6654,9.3678214767,10.081837185,-0.714015708,0.2649289054,-1.6671136,-1.402184694
2020,New Jersey,Morris County,491087,-490,4419,4204,215,570,-1282,-712,7,8587,8.9939185724,8.5563325816,0.4375859907,1.1601116964,-2.609233675,-1.449121979
2020,New Jersey,Ocean County,614237,6739,9040,7815,1225,5,5529,5534,-20,7240,14.798626543,12.793281685,2.0053448579,0.0081850811,9.0510626281,9.0592477092
2020,New Jersey,Passaic County,500382,-1456,6378,4130,2248,1662,-5366,-3704,0,10155,12.727744407,8.2417034184,4.486040989,3.3166370657,-10.70822773,-7.391590669
2020,New Jersey,Salem County,62451,110,597,803,-206,28,289,317,-1,1258,9.5679210206,12.869414706,-3.301493685,0.4487467145,4.6317071607,5.0804538752
2020,New Jersey,Somerset County,329331,-667,3139,2783,356,491,-1515,-1024,1,5436,9.5218017105,8.4419159479,1.0798857626,1.4893930041,-4.595581265,-3.106188261
2020,New Jersey,Sussex County,140002,-708,1210,1378,-168,14,-555,-541,1,1662,8.6209353359,9.817891647,-1.196956311,0.0997463593,-3.954230671,-3.854484311
2020,New Jersey,Union County,555394,-1270,6643,4423,2220,1735,-5241,-3506,16,6158,11.94721858,7.9546210719,3.9925975084,3.1203408455,-9.425767361,-6.305426516
2020,New Jersey,Warren County,105624,169,1008,1065,-57,88,134,222,4,1976,9.5509264304,10.09100858,-0.540082149,0.8338110376,1.2696668072,2.1034778448
2020,New Mexico,New Mexico,2106319,6685,22671,19912,2759,2687,1221,3908,18,42967,10.780434303,9.4684843126,1.3119499909,1.2777128037,0.5806056321,1.8583184358
2020,New Mexico,Bernalillo County,681666,2241,6931,6443,488,991,738,1729,24,11882,10.184477011,9.4674051919,0.7170718196,1.4561847812,1.0844241862,2.5406089674
2020,New Mexico,Catron County,3623,116,11,30,-19,0,136,136,-1,106,3.0855539972,8.4151472651,-5.329593268,0.0,38.148667602,38.148667602
2020,New Mexico,Chaves County,64711,125,798,677,121,91,-90,1,3,1776,12.343673867,10.472014045,1.871659822,1.4076119322,-1.392143669,0.015468263
2020,New Mexico,Cibola County,26354,-327,297,298,-1,16,-339,-323,-3,2569,11.200150844,11.237861789,-0.037710946,0.6033751296,-12.78401056,-12.18063543
2020,New Mexico,Colfax County,11927,-141,109,150,-41,12,-112,-100,0,408,9.0852260888,12.502604709,-3.417378621,1.0002083767,-9.335278183,-8.335069806
2020,New Mexico,Curry County,48793,-290,802,399,403,55,-743,-688,-5,1503,16.38808288,8.1531734031,8.2349094773,1.1238710205,-15.18247579,-14.05860477
2020,New Mexico,De Baca County,1673,-68,10,22,-12,1,-57,-56,0,9,5.8582308143,12.888107791,-7.029876977,0.5858230814,-33.39191564,-32.80609256
2020,New Mexico,Doña Ana County,221262,2398,2598,1777,821,360,1206,1566,11,4412,11.805710183,8.0749603523,3.7307498307,1.6358951755,5.4802488378,7.1161440133
2020,New Mexico,Eddy County,58418,24,833,584,249,53,-284,-231,6,1000,14.262233332,9.9989727083,4.2632606239,0.9074410163,-4.862514125,-3.955073109
2020,New Mexico,Grant County,27007,66,233,368,-135,7,195,202,-1,587,8.6379476533,13.642767109,-5.004819456,0.259509157,7.2291836583,7.4886928153
2020,New Mexico,Guadalupe County,4275,-3,37,42,-5,0,1,1,1,574,8.6519349936,9.8211153981,-1.169180405,0.0,0.2338360809,0.2338360809
2020,New Mexico,Harding County,638,2,2,4,-2,0,6,6,-2,0,3.1397174254,6.2794348509,-3.139717425,0.0,9.4191522763,9.4191522763
2020,New Mexico,Hidalgo County,4106,-97,39,50,-11,1,-87,-86,0,64,9.3874112408,12.035142616,-2.647731376,0.2407028523,-20.94114815,-20.7004453
2020,New Mexico,Lea County,71830,707,1130,550,580,114,10,124,3,2068,15.809391898,7.6948367645,8.1145551335,1.5949298021,0.139906123,1.7348359251
2020,New Mexico,Lincoln County,19939,209,170,219,-49,47,213,260,-2,116,8.5709243994,11.041367315,-2.470442915,2.3696085104,10.7388641,13.108472611
2020,New Mexico,Los Alamos County,19462,79,176,110,66,55,-43,12,1,94,9.0616552967,5.6635345604,3.3981207363,2.8317672802,-2.213927146,0.6178401339
2020,New Mexico,Luna County,23905,130,344,287,57,52,21,73,0,548,14.429530201,12.038590604,2.3909395973,2.1812080537,0.8808724832,3.0620805369
2020,New Mexico,McKinley County,70824,-654,856,677,179,44,-876,-832,-1,774,12.0307515,9.5149751936,2.5157763067,0.6184031145,-12.31184383,-11.69344071
2020,New Mexico,Mora County,4478,-12,38,48,-10,0,-2,-2,0,8,8.4745762712,10.704727921,-2.23015165,0.0,-0.44603033,-0.44603033
2020,New Mexico,Otero County,67967,395,862,647,215,264,-84,180,0,2374,12.719586245,9.5470676337,3.1725186109,3.8955577361,-1.239495643,2.6560620928
2020,New Mexico,Quay County,8197,-46,100,107,-7,8,-48,-40,1,22,12.165450122,13.01703163,-0.851581509,0.9732360097,-5.839416058,-4.866180049
2020,New Mexico,Rio Arriba County,38521,-362,397,474,-77,19,-303,-284,-1,425,10.25786781,12.247429073,-1.989561263,0.4909307013,-7.829052762,-7.338122061
2020,New Mexico,Roosevelt County,18350,-151,253,177,76,45,-270,-225,-2,1078,13.730970666,9.6062522048,4.1247184608,2.4422675097,-14.65360506,-12.21133755
2020,New Mexico,Sandoval County,148904,1859,1365,1252,113,58,1694,1752,-6,760,9.2245623401,8.4609172526,0.7636450875,0.3919594254,11.447918391,11.839877817
2020,New Mexico,San Juan County,123312,-715,1382,1199,183,27,-924,-897,-1,1739,11.174946127,9.6951956626,1.4797504639,0.2183238389,-7.471526933,-7.253203094
2020,New Mexico,San Miguel County,27144,-193,244,301,-57,54,-189,-135,-1,1294,8.9572511518,11.049723757,-2.092472605,1.982342468,-6.938198638,-4.95585617
2020,New Mexico,Santa Fe County,151946,995,1163,1336,-173,178,993,1171,-3,2634,7.6791780704,8.8214805693,-1.142302499,1.175317022,6.5566842854,7.7320013074
2020,New Mexico,Sierra County,10867,-19,86,221,-135,7,111,118,-2,265,7.9069553625,20.319036455,-12.41208109,0.64358939,10.205488898,10.849078288
2020,New Mexico,Socorro County,16541,-72,185,163,22,27,-122,-95,1,581,11.160041021,9.8329010074,1.3271400133,1.6287627436,-7.359594619,-5.730831875
2020,New Mexico,Taos County,32593,-159,244,323,-79,0,-78,-78,-2,470,7.468054174,9.8859897467,-2.417935573,0.0,-2.387328793,-2.387328793
2020,New Mexico,Torrance County,15486,44,155,167,-12,26,29,55,1,611,10.023279876,10.799275737,-0.775995861,1.6813243663,1.8753233316,3.5566476979
2020,New Mexico,Union County,4026,-17,38,43,-5,5,-17,-12,0,667,9.4187631677,10.658074111,-1.239310943,1.2393109431,-4.213657207,-2.974346263
2020,New Mexico,Valencia County,77574,621,783,767,16,70,536,606,-1,1549,10.134151313,9.9270677616,0.2070835517,0.9059905389,6.9372989833,7.8432895222
2020,New York,New York,19336776,-126355,220375,177602,42773,35181,-203893,-168712,-416,564192,11.35956331,9.1547642112,2.2047990991,1.8134579549,-10.50997365,-8.69651569
2020,New York,Albany County,303654,-1098,2831,2964,-133,470,-1447,-977,12,16698,9.3062856053,9.7434936539,-0.437208049,1.5450209235,-4.756692077,-3.211671154
2020,New York,Allegany County,45587,-328,446,494,-48,26,-307,-281,1,4096,9.7484207995,10.797578195,-1.049157395,0.5682935892,-6.710235842,-6.141942253
2020,New York,Bronx County,1401142,-17045,19182,12017,7165,6795,-30848,-24053,-157,44149,13.60749313,8.524723436,5.0827696945,4.8202958931,-21.88322115,-17.06292526
2020,New York,Broome County,189420,-1317,1823,2249,-426,225,-1121,-896,5,11052,9.590774338,11.83195364,-2.241179302,1.1837214624,-5.897563375,-4.713841913
2020,New York,Cattaraugus County,75863,-367,834,914,-80,8,-291,-283,-4,2571,10.966974154,12.018962082,-1.051987928,0.1051987928,-3.82660609,-3.721407297
2020,New York,Cayuga County,76029,-421,691,759,-68,23,-377,-354,1,3762,9.0635431764,9.9554692777,-0.891926101,0.3016808872,-4.944943238,-4.643262351
2020,New York,Chautauqua County,126032,-604,1263,1505,-242,67,-430,-363,1,5731,9.9973087213,11.912865895,-1.915557174,0.5303402093,-3.40367597,-2.873335761
2020,New York,Chemung County,82622,-782,846,1014,-168,24,-637,-613,-1,3606,10.191174876,12.214954284,-2.023779408,0.289111344,-7.673496922,-7.384385578
2020,New York,Chenango County,46730,-504,445,571,-126,4,-381,-377,-1,728,9.4717125708,12.153590737,-2.681878166,0.0851389894,-8.10948874,-8.024349751
2020,New York,Clinton County,79778,-253,707,806,-99,46,-204,-158,4,6102,8.8480623745,10.087041406,-1.238979031,0.5756872266,-2.553047701,-1.977360474
2020,New York,Columbia County,59534,-48,449,710,-261,36,176,212,1,1863,7.5388696733,11.92115249,-4.382282817,0.6044528023,2.9551025891,3.5595553914
2020,New York,Cortland County,47173,-237,444,458,-14,17,-243,-226,3,3689,9.388579343,9.6846156286,-0.296036286,0.3594726325,-5.1383441,-4.778871467
2020,New York,Delaware County,43938,-418,368,622,-254,26,-190,-164,0,2349,8.3357872562,14.089292591,-5.753505334,0.5889414909,-4.303803203,-3.714861712
2020,New York,Dutchess County,293293,-641,2549,3006,-457,190,-383,-193,9,19505,8.6814809265,10.237948868,-1.556467942,0.6471092099,-1.304435934,-0.657326724
2020,New York,Erie County,917241,-1572,9679,10469,-790,1213,-2042,-829,47,27094,10.543262889,11.403804028,-0.860541139,1.3213119004,-2.22433545,-0.903023549
2020,New York,Essex County,36891,-96,285,450,-165,12,58,70,-1,2114,7.715422724,12.182246406,-4.466823682,0.3248599042,1.5701562035,1.8950161076
2020,New York,Franklin County,49965,-137,464,567,-103,1,-37,-36,2,6139,9.273786563,11.332407287,-2.058620724,0.019986609,-0.739504532,-0.719517923
2020,New York,Fulton County,52812,-524,492,612,-120,5,-408,-403,-1,1361,9.2700757433,11.531069827,-2.260994084,0.0942080868,-7.687379885,-7.593171798
2020,New York,Genesee County,56994,-420,579,676,-97,5,-329,-324,1,1985,10.121669813,11.81735543,-1.695685616,0.0874064751,-5.75134606,-5.663939585
2020,New York,Greene County,47177,-34,436,589,-153,15,103,118,1,3055,9.2384625164,12.480400051,-3.241937534,0.3178370132,2.1824808238,2.500317837
2020,New York,Hamilton County,4345,-93,18,67,-49,0,-44,-44,0,81,4.09882728,15.256745987,-11.15791871,0.0,-10.01935557,-10.01935557
2020,New York,Herkimer County,60945,-411,565,701,-136,8,-284,-276,1,1443,9.2394992682,11.463520331,-2.224021063,0.1308247684,-4.644279278,-4.51345451
2020,New York,Jefferson County,108095,-2048,1750,988,762,55,-2843,-2788,-22,6015,16.037537001,9.0543351754,6.9832018255,0.5040368772,-26.0541244,-25.55008752
2020,New York,Kings County,2538934,-23395,37399,19573,17826,5772,-46757,-40985,-236,35297,14.662643349,7.673785884,6.9888574653,2.2629689941,-18.33153868,-16.06856969
2020,New York,Lewis County,26187,-142,315,295,20,8,-170,-162,0,313,11.996343971,11.234671338,0.7616726331,0.3046690532,-6.474217381,-6.169548328
2020,New York,Livingston County,62398,-495,502,592,-90,39,-443,-404,-1,5738,8.013344933,9.4500003991,-1.436655466,0.622550702,-7.071537461,-6.448986759
2020,New York,Madison County,70478,-397,640,686,-46,18,-371,-353,2,4599,9.055343714,9.7061965434,-0.650852829,0.254681542,-5.249269559,-4.994588017
2020,New York,Monroe County,740900,-1705,7653,7288,365,1041,-3135,-2094,24,25887,10.317457643,9.8253797594,0.4920778831,1.4034330858,-4.226477161,-2.823044075
2020,New York,Montgomery County,49170,-185,608,569,39,56,-281,-225,1,922,12.342045166,11.550367927,0.7916772393,1.1367673179,-5.704136006,-4.567368688
2020,New York,Nassau County,1351334,-4739,13892,12111,1781,1155,-7704,-6549,29,19453,10.262217687,8.9465676937,1.3156499928,0.8532149027,-5.691054208,-4.837839305
2020,New York,New York County,1611989,-20337,16643,13234,3409,5118,-28743,-23625,-121,68180,10.259792899,8.1582706981,2.1015222011,3.155057385,-17.71899461,-14.56393723
2020,New York,Niagara County,208396,-1167,2041,2530,-489,74,-759,-685,7,3735,9.7665081982,12.106450633,-2.339942435,0.3541017181,-3.63193519,-3.277833472
2020,New York,Oneida County,227346,-894,2443,2651,-208,240,-932,-692,6,12765,10.724649133,11.637758842,-0.913109709,1.0535881261,-4.09143389,-3.037845763
2020,New York,Onondaga County,459214,-1656,5148,4546,602,695,-2963,-2268,10,16666,11.190282626,9.8817064529,1.3085761735,1.5107316289,-6.440716282,-4.929984654
2020,New York,Ontario County,110091,107,953,1186,-233,74,263,337,3,3203,8.6606838578,10.778143815,-2.117459957,0.672498012,2.390094286,3.0625922981
2020,New York,Orange County,385234,284,5072,3131,1941,142,-1800,-1658,1,11057,13.170878647,8.1305246538,5.0403539933,0.3687430536,-4.674207722,-4.305464668
2020,New York,Orleans County,39978,-373,336,448,-112,15,-277,-262,1,2522,8.3655964845,11.154128646,-2.788532161,0.3734641288,-6.896637578,-6.523173449
2020,New York,Oswego County,116346,-588,1189,1174,15,22,-629,-607,4,4249,10.193758573,10.06515775,0.128600823,0.1886145405,-5.39266118,-5.204046639
2020,New York,Otsego County,58701,-646,489,694,-205,21,-462,-441,0,5237,8.2847655191,11.757928978,-3.473163459,0.3557874763,-7.827324478,-7.471537002
2020,New York,Putnam County,98532,21,830,856,-26,76,-29,47,0,2578,8.4245570764,8.6884588643,-0.263901788,0.7714052263,-0.294351994,0.477053232
2020,New York,Queens County,2225821,-28121,26781,17672,9109,6849,-43870,-37021,-209,27742,11.956436088,7.8897030937,4.0667329946,3.0577510462,-19.58585756,-16.52810651
2020,New York,Rensselaer County,158108,-873,1568,1724,-156,113,-836,-723,6,5690,9.8899678008,10.873918679,-0.983950878,0.7127336489,-5.272967526,-4.560233878
2020,New York,Richmond County,475327,-814,5086,4496,590,250,-1681,-1431,27,7017,10.690848247,9.4506594021,1.240188845,0.5255037479,-3.533487201,-3.007983453
2020,New York,Rockland County,326225,-127,5617,2631,2986,342,-3458,-3116,3,6497,17.214826756,8.0634162712,9.1514104849,1.0481521721,-10.59798307,-9.549830901
2020,New York,St. Lawrence County,107185,-581,1045,1180,-135,80,-529,-449,3,10455,9.7231462054,10.979246433,-1.256100227,0.7443556904,-4.922052003,-4.177696312
2020,New York,Saratoga County,230298,663,1989,2244,-255,81,830,911,7,3405,8.6490858451,9.7579430047,-1.10885716,0.3522252154,3.6092213431,3.9614465585
2020,New York,Schenectady County,155358,-190,1828,1575,253,185,-634,-449,6,4538,11.759181232,10.131679672,1.62750156,1.1900703106,-4.078403119,-2.888332808
2020,New York,Schoharie County,31132,80,277,338,-61,4,138,142,-1,1236,8.9090441271,10.870963592,-1.961919465,0.1286504567,4.4384407565,4.5670912132
2020,New York,Schuyler County,17685,-127,172,197,-25,1,-102,-101,-1,203,9.6909597994,11.099529538,-1.408569738,0.0563427895,-5.746964532,-5.690621743
2020,New York,Seneca County,33991,-198,381,339,42,15,-256,-241,1,2670,11.176298035,9.9442651804,1.2320328542,0.4400117336,-7.509533588,-7.069521854
2020,New York,Steuben County,94657,-671,1018,1097,-79,41,-634,-593,1,1656,10.716635524,11.548280127,-0.831644604,0.4316130221,-6.674211122,-6.2425981
2020,New York,Suffolk County,1474273,-4052,15140,14189,951,1315,-6376,-5061,58,29392,10.255375097,9.6111966478,0.6441784489,0.8907409678,-4.318908297,-3.428167329
2020,New York,Sullivan County,75802,251,859,837,22,48,180,228,1,3773,11.350947784,11.060236665,0.290711119,0.6342788052,2.3785455194,3.0128243246
2020,New York,Tioga County,47904,-317,427,530,-103,0,-215,-215,1,480,8.8842652796,11.027308192,-2.143042913,0.0,-4.473342003,-4.473342003
2020,New York,Tompkins County,101058,-913,721,686,35,331,-1278,-947,-1,12890,7.1024336425,6.7576553103,0.3447783322,3.2606179413,-12.58933453,-9.328716587
2020,New York,Ulster County,177716,-217,1517,1868,-351,139,-11,128,6,11664,8.5308829773,10.504739223,-1.973856246,0.7816695675,-0.061858743,0.7198108247
2020,New York,Warren County,63756,-224,547,727,-180,16,-61,-45,1,608,8.5645393624,11.382852133,-2.81831277,0.2505166907,-0.955094883,-0.704578193
2020,New York,Washington County,60606,-562,531,732,-201,5,-367,-362,1,3054,8.721073464,12.022270764,-3.3011973,0.0821193358,-6.027559249,-5.945439913
2020,New York,Wayne County,89339,-477,962,953,9,17,-505,-488,2,1060,10.739303955,10.638832296,0.1004716586,0.1897797996,-5.6375764,-5.447796601
2020,New York,Westchester County,965802,-2665,9924,8141,1783,1500,-5988,-4488,40,27871,10.26124081,8.4176502855,1.8435905244,1.5509735202,-6.191486293,-4.640512773
2020,New York,Wyoming County,39465,-393,355,384,-29,5,-368,-363,-1,3333,8.9507456854,9.6819333611,-0.731187676,0.1260668406,-9.278519471,-9.15245263
2020,New York,Yates County,24780,-122,331,290,41,7,-171,-164,1,1369,13.324745381,11.674248219,1.650497162,0.2817921984,-6.883780846,-6.601988648
2020,North Carolina,North Carolina,10600823,99439,118855,102921,15934,13387,70229,83616,-111,279336,11.264698522,9.7545247281,1.5101737937,1.2687772421,6.656081044,7.9248582861
2020,North Carolina,Alamance County,171346,2173,1942,1879,63,36,2078,2114,-4,6238,11.406118308,11.036094902,0.3700234054,0.211441946,12.204898992,12.416340938
2020,North Carolina,Alexander County,37441,24,344,431,-87,0,109,109,2,1450,9.1907344572,11.515135323,-2.324400866,0.0,2.9121803949,2.9121803949
2020,North Carolina,Alleghany County,11194,60,84,154,-70,6,125,131,-1,102,7.52418488,13.794338947,-6.270154067,0.5374417771,11.19670369,11.734145468
2020,North Carolina,Anson County,24097,559,256,312,-56,29,590,619,-4,1425,10.748399286,13.09961163,-2.351212344,1.2175921066,24.77170148,25.989293587
2020,North Carolina,Ashe County,27166,-49,203,391,-188,-2,143,141,-2,324,7.4658428495,14.380022434,-6.914179585,-0.073555102,5.2591897906,5.1856346886
2020,North Carolina,Avery County,17571,75,148,242,-94,12,158,170,-1,2449,8.4409844013,13.80215017,-5.361165768,0.6844041406,9.0113211852,9.6957253258
2020,North Carolina,Beaufort County,47073,-23,424,648,-224,18,184,202,-1,512,9.0050865996,13.762490841,-4.757404241,0.3822914122,3.9078677696,4.2901591819
2020,North Carolina,Bertie County,18712,-250,165,280,-115,8,-142,-134,-1,1547,8.7593565854,14.86436269,-6.105006105,0.4246960769,-7.538355364,-7.113659288
2020,North Carolina,Bladen County,32911,47,345,490,-145,2,190,192,0,296,10.490307868,14.899277841,-4.408969973,0.0608133789,5.7772709996,5.8380843786
2020,North Carolina,Brunswick County,149039,6052,1035,1821,-786,4,6875,6879,-41,820,7.0884099361,12.471492264,-5.383082328,0.027394821,47.084848609,47.11224343
2020,North Carolina,Buncombe County,263477,1428,2465,2857,-392,142,1676,1818,2,7955,9.3810772445,10.872915898,-1.491838653,0.5404109407,6.3783713841,6.9187823248
2020,North Carolina,Burke County,90418,-6,863,1133,-270,53,208,261,3,3114,9.5442430409,12.530275047,-2.986032006,0.5861470234,2.3003505823,2.8864976056
2020,North Carolina,Cabarrus County,221479,5139,2574,1821,753,94,4317,4411,-25,1567,11.758283674,8.3185060493,3.439777625,0.4294011909,19.720478097,20.149879288
2020,North Carolina,Caldwell County,82100,-175,828,1100,-272,51,42,93,4,935,10.074524715,13.384030418,-3.309505703,0.6205323194,0.511026616,1.1315589354
2020,North Carolina,Camden County,10984,214,101,74,27,2,186,188,-1,17,9.2856486163,6.803346511,2.4823021054,0.18387423,17.100303392,17.284177623
2020,North Carolina,Carteret County,69558,45,504,964,-460,20,489,509,-4,975,7.2480962961,13.863422281,-6.615325985,0.2876228689,7.0323791445,7.3200020134
2020,North Carolina,Caswell County,22443,-147,210,271,-61,13,-99,-86,0,1190,9.3264939045,12.035618324,-2.70912442,0.5773543846,-4.396775698,-3.819421313
2020,North Carolina,Catawba County,160307,944,1688,1819,-131,136,940,1076,-1,2544,10.560890919,11.380486126,-0.819595208,0.8508774674,5.8810648481,6.7319423155
2020,North Carolina,Chatham County,75748,1329,629,845,-216,-13,1567,1554,-9,764,8.3773398949,11.254137061,-2.876797166,-0.17314057,20.870097958,20.696957387
2020,North Carolina,Cherokee County,29073,365,248,379,-131,2,497,499,-3,433,8.5841366539,13.118499161,-4.534362507,0.0692269085,17.202886762,17.272113671
2020,North Carolina,Chowan County,13815,-102,126,216,-90,-2,-9,-11,-1,253,9.0869753354,15.577672003,-6.490696668,-0.144237704,-0.649069667,-0.793307371
2020,North Carolina,Clay County,11505,228,84,144,-60,-2,293,291,-3,117,7.3742428233,12.641559126,-5.267316302,-0.17557721,25.722061276,25.546484066
2020,North Carolina,Cleveland County,99035,1071,1151,1358,-207,44,1240,1284,-6,1945,11.685338504,13.786872015,-2.10153351,0.4467027751,12.58889639,13.035599165
2020,North Carolina,Columbus County,54754,-698,558,822,-264,6,-438,-432,-2,2811,10.126490391,14.917518102,-4.791027712,0.1088869934,-7.948750522,-7.839863528
2020,North Carolina,Craven County,101233,-798,1304,1146,158,59,-1009,-950,-6,4727,12.830604534,11.275976071,1.5546284635,0.5805258186,-9.927975441,-9.347449622
2020,North Carolina,Cumberland County,336364,-160,5379,2912,2467,559,-3184,-2625,-2,16266,15.987801833,8.6552293992,7.332572434,1.6614949293,-9.463684893,-7.802189963
2020,North Carolina,Currituck County,29052,1136,271,205,66,1,1075,1076,-6,114,9.5141131864,7.19702289,2.3170902963,0.0351074287,37.740485887,37.775593316
2020,North Carolina,Dare County,37547,476,312,355,-43,43,479,522,-3,159,8.3625934761,9.5151303975,-1.152536921,1.1525369214,12.838725241,13.991262162
2020,North Carolina,Davidson County,169234,996,1768,2002,-234,96,1134,1230,0,1580,10.477906315,11.864688033,-1.386781718,0.5689360895,6.7205575574,7.2894936469
2020,North Carolina,Davie County,43286,587,401,490,-89,-11,692,681,-5,298,9.327208234,11.397336745,-2.070128511,-0.25585858,16.095830668,15.839972088
2020,North Carolina,Duplin County,58794,-8,700,625,75,93,-176,-83,0,363,11.905166842,10.629613252,1.2755535903,1.5816864519,-2.993299092,-1.41161264
2020,North Carolina,Durham County,327306,4337,4188,2429,1759,1271,1314,2585,-7,14454,12.880704317,7.4706854792,5.4100188382,3.9091153743,4.0413671139,7.9504824882
2020,North Carolina,Edgecombe County,50829,-600,572,730,-158,11,-450,-439,-3,912,11.187388762,14.277611532,-3.09022277,0.2151420916,-8.801267383,-8.586125291
2020,North Carolina,Forsyth County,383843,1725,4367,3714,653,333,716,1049,23,10832,11.402669327,9.6976216805,1.705047646,0.8694959665,1.8695468829,2.7390428494
2020,North Carolina,Franklin County,71859,2084,752,714,38,60,1998,2058,-12,1461,10.618919186,10.082324865,0.5365943206,0.8472541904,28.21356454,29.06081873
2020,North Carolina,Gaston County,226568,1916,2561,2646,-85,71,1929,2000,1,3318,11.351447188,11.728203537,-0.376756349,0.3147023625,8.5501529188,8.8648552812
2020,North Carolina,Gates County,11464,-72,94,131,-37,1,-36,-35,0,61,8.1739130435,11.391304348,-3.217391304,0.0869565217,-3.130434783,-3.043478261
2020,North Carolina,Graham County,8474,4,83,109,-26,-1,32,31,-1,93,9.7969782814,12.865911237,-3.068932956,-0.118035883,3.7771482531,3.6591123702
2020,North Carolina,Granville County,60486,128,582,632,-50,16,162,178,0,3567,9.6322531528,10.45976631,-0.827513157,0.2648042104,2.6811426302,2.9459468406
2020,North Carolina,Greene County,20928,13,215,237,-22,1,33,34,1,2485,10.27650981,11.328059652,-1.051549841,0.04779772,1.5773247616,1.6251224817
2020,North Carolina,Guilford County,540521,2649,6074,5065,1009,1087,520,1607,33,20099,11.264909917,9.3936069689,1.871302948,2.0159626407,0.9643979514,2.9803605921
2020,North Carolina,Halifax County,49479,-595,516,770,-254,14,-355,-341,0,1216,10.366337529,15.469147087,-5.102809559,0.2812572198,-7.131879501,-6.850622282
2020,North Carolina,Harnett County,137058,886,1850,1175,675,71,133,204,7,3134,13.541704791,8.6008125023,4.9408922885,0.5197086704,0.9735387769,1.4932474472
2020,North Carolina,Haywood County,62972,462,531,850,-319,6,778,784,-3,688,8.4633652635,13.547759838,-5.084394575,0.0956312459,12.400184887,12.495816133
2020,North Carolina,Henderson County,118445,1098,1055,1553,-498,4,1598,1602,-6,1208,8.9485648368,13.172626722,-4.224061885,0.0339282079,13.554319061,13.588247269
2020,North Carolina,Hertford County,23108,-534,206,317,-111,11,-429,-418,-5,2453,8.8128342246,13.561497326,-4.748663102,0.4705882353,-18.35294118,-17.88235294
2020,North Carolina,Hoke County,55830,664,846,422,424,38,201,239,1,862,15.243792569,7.6038776172,7.6399149519,0.6847093589,3.6217521352,4.3064614941
2020,North Carolina,Hyde County,4843,-89,34,56,-22,-2,-63,-65,-2,569,6.9565217391,11.457800512,-4.501278772,-0.409207161,-12.89002558,-13.29923274
2020,North Carolina,Iredell County,185770,3904,1921,1814,107,138,3680,3818,-21,1159,10.450554353,9.8684568432,0.5820975095,0.7507425823,20.019802196,20.770544778
2020,North Carolina,Jackson County,44033,297,365,405,-40,17,319,336,1,4208,8.3172874249,9.2287709784,-0.911483553,0.3873805102,7.2690813385,7.6564618487
2020,North Carolina,Johnston County,216246,6460,2481,1794,687,123,5680,5803,-30,1387,11.647012431,8.4219025801,3.2251098509,0.5774214144,26.664663687,27.242085102
2020,North Carolina,Jones County,9250,-89,84,126,-42,0,-47,-47,0,87,9.0376028834,13.556404325,-4.518801442,0.0,-5.056753994,-5.056753994
2020,North Carolina,Lee County,62353,581,791,624,167,65,346,411,3,1029,12.745216516,10.054380665,2.690835851,1.0473313192,5.5750251762,6.6223564955
2020,North Carolina,Lenoir County,55720,-354,620,805,-185,9,-179,-170,1,1107,11.091829615,14.401488452,-3.309658837,0.1610104299,-3.20231855,-3.04130812
2020,North Carolina,Lincoln County,88097,1470,874,965,-91,31,1535,1566,-5,675,10.004349717,11.045992537,-1.04164282,0.3548453561,17.570568439,17.925413795
2020,North Carolina,McDowell County,45782,-2,423,554,-131,5,124,129,0,1574,9.2392372715,12.100561344,-2.861324072,0.1092108425,2.7084288928,2.8176397353
2020,North Carolina,Macon County,35994,265,325,467,-142,20,390,410,-3,311,9.0626437823,13.022321989,-3.959678206,0.5577011558,10.875172539,11.432873695
2020,North Carolina,Madison County,21740,102,197,275,-78,7,174,181,-1,997,9.0829452718,12.679238324,-3.596293052,0.3227442482,8.0224998847,8.345244133
2020,North Carolina,Martin County,22178,-273,228,320,-92,0,-181,-181,0,146,10.217571534,14.340451276,-4.122879742,0.0,-8.111317753,-8.111317753
2020,North Carolina,Mecklenburg County,1128945,15662,14706,7302,7404,4206,4008,8214,44,17303,13.117310104,6.5131645845,6.6041455195,3.7516256152,3.5750155649,7.3266411801
2020,North Carolina,Mitchell County,14881,-47,135,245,-110,7,58,65,-2,187,9.0576671475,16.437988527,-7.380321379,0.4696568151,3.8914421819,4.3610989969
2020,North Carolina,Montgomery County,27238,29,280,333,-53,-1,83,82,0,1007,10.28523151,12.232078902,-1.946847393,-0.03673297,3.0488364832,3.0121035135
2020,North Carolina,Moore County,103352,2185,1178,1266,-88,65,2223,2288,-15,784,11.519712105,12.380267848,-0.860555743,0.6356377647,21.738811553,22.374449318
2020,North Carolina,Nash County,94859,601,1061,1174,-113,45,670,715,-1,2203,11.220567162,12.415594579,-1.195027417,0.475895874,7.0855607904,7.5614566644
2020,North Carolina,New Hanover County,236613,2338,2137,2276,-139,82,2391,2473,4,8179,9.0764682897,9.6668422215,-0.590373932,0.3482781468,10.155281086,10.503559233
2020,North Carolina,Northampton County,19088,-410,164,309,-145,6,-268,-262,-3,441,8.5004924066,16.016171668,-7.515679262,0.3109936246,-13.89104857,-13.58005494
2020,North Carolina,Onslow County,203943,1148,3802,1269,2533,48,-1430,-1382,-3,25397,18.695081355,6.2398890686,12.455192286,0.2360241728,-7.031553482,-6.795529309
2020,North Carolina,Orange County,149077,885,1127,925,202,392,284,676,7,10473,7.5823580663,6.2233196196,1.3590384467,2.6373419361,1.910727321,4.5480692571
2020,North Carolina,Pamlico County,12715,65,76,188,-112,-2,181,179,-2,710,5.9925093633,14.823575793,-8.83106643,-0.157697615,14.271634142,14.113936527
2020,North Carolina,Pasquotank County,40372,402,455,408,47,25,330,355,0,2031,11.326578875,10.156580618,1.1699982574,0.6223394986,8.2148813821,8.8372208807
2020,North Carolina,Pender County,64671,1625,619,650,-31,15,1654,1669,-13,973,9.6933062944,10.17875459,-0.485448296,0.2348943367,25.901015527,26.135909863
2020,North Carolina,Perquimans County,13667,89,119,148,-29,-3,122,119,-1,72,8.7355478069,10.864378785,-2.128830978,-0.220223894,8.9557717012,8.7355478069
2020,North Carolina,Person County,39925,304,414,492,-78,10,372,382,0,444,10.409071481,12.37020089,-1.961129409,0.2514268474,9.3530787217,9.6045055691
2020,North Carolina,Pitt County,182924,1667,2062,1548,514,75,1068,1143,10,6612,11.32403942,8.501267227,2.8227721929,0.4118831021,5.8652153737,6.2770984758
2020,North Carolina,Polk County,21030,307,153,296,-143,8,446,454,-4,339,7.3288146959,14.178621895,-6.849807199,0.3832059972,21.363734342,21.74694034
2020,North Carolina,Randolph County,144557,1062,1531,1720,-189,2,1251,1253,-2,1218,10.630025134,11.942288198,-1.312263064,0.0138863816,8.6859317068,8.6998180884
2020,North Carolina,Richmond County,44332,-432,552,621,-69,-5,-358,-363,0,866,12.39112867,13.940019754,-1.548891084,-0.112238484,-8.036275478,-8.148513962
2020,North Carolina,Robeson County,129999,-441,1661,1525,136,35,-617,-582,5,4253,12.755386098,11.710995665,1.0443904331,0.2687769497,-4.738153656,-4.469376706
2020,North Carolina,Rockingham County,91285,167,898,1320,-422,0,590,590,-1,1033,9.8463292819,14.47344616,-4.627116879,0.0,6.4691918444,6.4691918444
2020,North Carolina,Rowan County,142495,677,1573,1723,-150,20,805,825,2,4173,11.065269615,12.120444721,-1.055175106,0.1406900142,5.6627730705,5.8034630847
2020,North Carolina,Rutherford County,67076,45,663,928,-265,-6,316,310,0,1181,9.8876270441,13.839695169,-3.952068125,-0.089480788,4.7126548204,4.6231740327
2020,North Carolina,Sampson County,63382,10,780,752,28,86,-105,-19,1,872,12.307303912,11.865503258,0.4418006532,1.3569591492,-1.65675245,-0.2997933
2020,North Carolina,Scotland County,34637,-139,435,451,-16,14,-138,-124,1,2496,12.533675248,12.994683993,-0.461008745,0.4033826517,-3.976200424,-3.572817772
2020,North Carolina,Stanly County,63239,594,675,795,-120,3,713,716,-2,2140,10.724158749,12.63067586,-1.906517111,0.0476629278,11.327889168,11.375552096
2020,North Carolina,Stokes County,45743,109,384,599,-215,23,301,324,0,455,8.4047407991,13.110520153,-4.705779354,0.5034089541,6.5880910951,7.0915000492
2020,North Carolina,Surry County,71683,-58,759,1006,-247,15,172,187,2,824,10.584002677,14.028335564,-3.444332887,0.2091700134,2.3984828202,2.6076528336
2020,North Carolina,Swain County,14179,-133,161,250,-89,1,-46,-45,1,246,11.301814608,17.549401565,-6.247586957,0.0701976063,-3.229089888,-3.158892282
2020,North Carolina,Transylvania County,34498,228,268,448,-180,6,406,412,-4,1007,7.7943229409,13.029315961,-5.23499302,0.1744997673,11.80781759,11.982317357
2020,North Carolina,Tyrrell County,3774,-39,27,41,-14,0,-25,-25,0,402,7.1174377224,10.807960986,-3.690523263,0.0,-6.590220113,-6.590220113
2020,North Carolina,Union County,244562,4534,2374,1673,701,80,3774,3854,-21,2849,9.7979735446,6.9048061248,2.8931674199,0.3301760251,15.576053984,15.906230009
2020,North Carolina,Vance County,44718,48,558,567,-9,64,-8,56,1,802,12.484897302,12.686266613,-0.201369311,1.4319595471,-0.178994943,1.2529646037
2020,North Carolina,Wake County,1132271,19476,12716,6757,5959,2854,10635,13489,28,21362,11.327952051,6.0194221462,5.3085299051,2.5424642305,9.4741090017,12.016573232
2020,North Carolina,Warren County,19522,-170,148,272,-124,-4,-40,-44,-2,912,7.548324578,13.872596522,-6.324271944,-0.204008772,-2.040087724,-2.244096496
2020,North Carolina,Washington County,11485,-150,128,179,-51,-3,-94,-97,-2,149,11.07266436,15.484429066,-4.411764706,-0.259515571,-8.131487889,-8.39100346
2020,North Carolina,Watauga County,56441,170,328,424,-96,31,232,263,3,5759,5.8201433743,7.5235999716,-1.703456597,0.5500745262,4.1166867769,4.6667613031
2020,North Carolina,Wayne County,123967,63,1609,1521,88,207,-236,-29,4,2896,12.982559477,12.272512718,0.7100467582,1.6702236244,-1.904216306,-0.233992682
2020,North Carolina,Wilkes County,68043,-253,679,906,-227,30,-57,-27,1,927,9.9604661909,13.290401132,-3.329934942,0.4400795077,-0.836151065,-0.396071557
2020,North Carolina,Wilson County,81979,204,973,1011,-38,51,190,241,1,1541,11.883679177,12.347789978,-0.4641108,0.6228855478,2.3205540017,2.9434395496
2020,North Carolina,Yadkin County,37625,8,364,469,-105,-4,116,112,1,283,9.6754472236,12.466441615,-2.790994391,-0.106323596,3.0833842801,2.9770606842
2020,North Carolina,Yancey County,18099,40,178,249,-71,3,108,111,0,153,9.8456773052,13.772885668,-3.927208363,0.1659383815,5.9737817357,6.1397201173
2020,North Dakota,North Dakota,765309,1585,10509,6738,3771,577,-2766,-2189,3,24634,13.745942697,8.813413445,4.9325292521,0.7547253722,-3.617972928,-2.863247556
2020,North Dakota,Adams County,2188,-39,23,30,-7,6,-35,-29,-3,48,10.419026048,13.590033975,-3.171007928,2.718006795,-15.85503964,-13.13703284
2020,North Dakota,Barnes County,10402,-12,89,130,-41,0,30,30,-1,532,8.5511145273,12.490392006,-3.939277479,0.0,2.8823981553,2.8823981553
2020,North Dakota,Benson County,6762,-75,141,81,60,1,-137,-136,1,16,20.736818884,11.912640635,8.8241782484,0.1470696375,-20.14854033,-20.0014707
2020,North Dakota,Billings County,890,-47,10,7,3,0,-49,-49,-1,9,10.946907499,7.662835249,3.2840722496,0.0,-53.63984674,-53.63984674
2020,North Dakota,Bottineau County,6287,-5,64,84,-20,3,11,14,1,219,10.175689641,13.355592654,-3.179903013,0.4769854519,1.7489466571,2.2259321091
2020,North Dakota,Bowman County,2986,-50,33,32,1,0,-51,-51,0,60,10.959814015,10.627698439,0.3321155762,0.0,-16.93789439,-16.93789439
2020,North Dakota,Burke County,2118,-13,24,15,9,2,-23,-21,-1,2,11.296775712,7.06048482,4.236290892,0.941397976,-10.82607672,-9.884678748
2020,North Dakota,Burleigh County,96212,396,1160,822,338,64,-9,55,3,3846,12.081571437,8.5612514842,3.5203199533,0.6665694586,-0.09373633,0.5728331285
2020,North Dakota,Cass County,183904,1666,2446,1278,1168,225,264,489,9,5373,13.360936467,6.9808981215,6.3800383458,1.2290313594,1.4420634617,2.6710948211
2020,North Dakota,Cavalier County,3713,-21,45,44,1,3,-26,-23,1,74,12.085403518,11.816838996,0.2685645226,0.8056935679,-6.982677588,-6.17698402
2020,North Dakota,Dickey County,4705,-146,55,56,-1,2,-146,-144,-1,186,11.511092507,11.720385098,-0.209292591,0.4185851821,-30.55671829,-30.13813311
2020,North Dakota,Divide County,2277,33,27,23,4,2,27,29,0,62,11.944260119,10.174740102,1.7695200177,0.8847600088,11.944260119,12.829020128
2020,North Dakota,Dunn County,4465,53,72,23,49,3,0,3,1,131,16.221696519,5.1819308325,11.039765687,0.6759040216,0.0,0.6759040216
2020,North Dakota,Eddy County,2179,-62,28,39,-11,0,-50,-50,-1,69,12.669683258,17.647058824,-4.977375566,0.0,-22.62443439,-22.62443439
2020,North Dakota,Emmons County,3187,-48,29,49,-20,1,-29,-28,0,49,9.0314543756,15.2600436,-6.228589225,0.3114294612,-9.031454376,-8.720024914
2020,North Dakota,Foster County,3165,-52,38,45,-7,-2,-43,-45,0,55,11.908492636,14.102162332,-2.193669696,-0.62676277,-13.47539956,-14.10216233
2020,North Dakota,Golden Valley County,1737,-25,21,7,14,0,-38,-38,-1,52,12.003429551,4.0011431838,8.0022863675,0.0,-21.72049157,-21.72049157
2020,North Dakota,Grand Forks County,69481,-189,926,543,383,43,-615,-572,0,2964,13.309282722,7.8044714016,5.5048113201,0.6180336469,-8.839318438,-8.221284791
2020,North Dakota,Grant County,2215,-57,22,29,-7,0,-51,-51,1,6,9.80610653,12.926231335,-3.120124805,0.0,-22.73233786,-22.73233786
2020,North Dakota,Griggs County,2207,-11,21,34,-13,0,2,2,0,38,9.4915254237,15.367231638,-5.875706215,0.0,0.9039548023,0.9039548023
2020,North Dakota,Hettinger County,2438,-83,32,24,8,0,-90,-90,-1,132,12.905827788,9.6793708409,3.226456947,0.0,-36.29764065,-36.29764065
2020,North Dakota,Kidder County,2458,-23,27,18,9,1,-33,-32,0,0,10.933387325,7.2889248836,3.6444624418,0.4049402713,-13.36302895,-12.95808868
2020,North Dakota,LaMoure County,4033,-16,49,41,8,5,-27,-22,-2,58,12.125711458,10.146003464,1.9797079931,1.2373174957,-6.681514477,-5.444196981
2020,North Dakota,Logan County,1880,29,26,18,8,0,21,21,0,53,13.93728223,9.6488876977,4.2883945323,0.0,11.257035647,11.257035647
2020,North Dakota,McHenry County,5695,-58,62,56,6,1,-64,-63,-1,44,10.831586303,9.7833682739,1.0482180294,0.1747030049,-11.18099231,-11.00628931
2020,North Dakota,McIntosh County,2440,-33,26,47,-21,0,-13,-13,1,93,10.584164462,19.132912681,-8.548748219,0.0,-5.292082231,-5.292082231
2020,North Dakota,McKenzie County,15242,204,288,79,209,-4,-2,-6,1,149,19.022457067,5.2179656539,13.804491413,-0.264200793,-0.132100396,-0.396301189
2020,North Dakota,McLean County,9416,-24,104,107,-3,1,-21,-20,-1,147,11.030971574,11.349172677,-0.318201103,0.1060670344,-2.227407722,-2.121340687
2020,North Dakota,Mercer County,8174,-54,88,85,3,1,-57,-56,-1,125,10.730398732,10.364589684,0.3658090477,0.1219363492,-6.950371906,-6.828435557
2020,North Dakota,Morton County,31503,202,441,309,132,26,43,69,1,797,14.043691485,9.8401375709,4.2035539138,0.8279727406,1.3693395325,2.1973122731
2020,North Dakota,Mountrail County,10502,-5,193,91,102,8,-114,-106,-1,542,18.373078205,8.6629539721,9.7101242325,0.7615783712,-10.85249179,-10.09091342
2020,North Dakota,Nelson County,2789,-67,24,48,-24,4,-47,-43,0,79,8.5031000886,17.006200177,-8.503100089,1.4171833481,-16.65190434,-15.23472099
2020,North Dakota,Oliver County,1926,-25,23,5,18,0,-43,-43,0,2,11.864843952,2.5793139025,9.285530049,0.0,-22.18209956,-22.18209956
2020,North Dakota,Pembina County,6658,-96,61,89,-28,1,-69,-68,0,146,9.0963316433,13.271696988,-4.175365344,0.1491201909,-10.28929317,-10.14017298
2020,North Dakota,Pierce County,3928,-69,35,50,-15,2,-55,-53,-1,238,8.832807571,12.61829653,-3.785488959,0.5047318612,-13.88012618,-13.37539432
2020,North Dakota,Ramsey County,11388,-100,160,134,26,11,-135,-124,-2,425,13.988459521,11.715334849,2.2731246721,0.9617065921,-11.80276272,-10.84105613
2020,North Dakota,Ransom County,5173,-44,51,79,-28,0,-16,-16,0,139,9.8171318576,15.20692974,-5.389797883,0.0,-3.079884504,-3.079884504
2020,North Dakota,Renville County,2283,-41,21,24,-3,0,-38,-38,0,54,9.1165617539,10.418927719,-1.302365965,0.0,-16.49663555,-16.49663555
2020,North Dakota,Richland County,16156,-31,189,151,38,0,-70,-70,1,909,11.68722753,9.3374145874,2.3498129425,0.0,-4.328602789,-4.328602789
2020,North Dakota,Rolette County,14165,-106,218,187,31,0,-136,-136,-1,123,15.332676888,13.152342102,2.1803347869,0.0,-9.56533971,-9.56533971
2020,North Dakota,Sargent County,3913,-37,49,39,10,6,-53,-47,0,38,12.463436347,9.9198779092,2.5435584383,1.526135063,-13.48085972,-11.95472466
2020,North Dakota,Sheridan County,1275,-20,12,8,4,0,-24,-24,0,3,9.3385214008,6.2256809339,3.1128404669,0.0,-18.6770428,-18.6770428
2020,North Dakota,Sioux County,4173,-86,71,73,-2,0,-84,-84,0,52,16.840607211,17.314990512,-0.474383302,0.0,-19.92409867,-19.92409867
2020,North Dakota,Slope County,747,-7,8,6,2,0,-10,-10,1,0,10.659560293,7.9946702199,2.6648900733,0.0,-13.32445037,-13.32445037
2020,North Dakota,Stark County,32107,624,544,251,293,28,304,332,-1,542,17.109608429,7.8943230068,9.2152854222,0.8806416103,9.5612517691,10.441893379
2020,North Dakota,Steele County,1890,-10,20,10,10,0,-20,-20,0,0,10.55408971,5.2770448549,5.2770448549,0.0,-10.55408971,-10.55408971
2020,North Dakota,Stutsman County,20498,-197,224,248,-24,5,-178,-173,0,1646,10.87563421,12.040880732,-1.165246522,0.2427596922,-8.642245042,-8.399485349
2020,North Dakota,Towner County,2108,-58,23,22,1,6,-64,-58,-1,32,10.762751521,10.294805803,0.4679457183,2.8076743098,-29.94852597,-27.14085166
2020,North Dakota,Traill County,7959,-78,89,96,-7,2,-72,-70,-1,301,11.127781945,12.00300075,-0.875218805,0.2500625156,-9.002250563,-8.752188047
2020,North Dakota,Walsh County,10437,-137,125,132,-7,3,-134,-131,1,329,11.898529342,12.564846985,-0.666317643,0.2855647042,-12.75522345,-12.46965875
2020,North Dakota,Ward County,68466,17,1070,530,540,90,-614,-524,1,3151,15.630135486,7.7420297265,7.888105759,1.3146842932,-8.9690684,-7.654384107
2020,North Dakota,Wells County,3709,-85,37,58,-21,0,-63,-63,-1,71,9.862721578,15.460482474,-5.597760896,0.0,-16.79328269,-16.79328269
2020,North Dakota,Williams County,38700,803,845,252,593,27,180,207,3,423,22.063527292,6.5798921629,15.483635129,0.704988446,4.6999229735,5.4049114195
2020,Ohio,Ohio,11693217,-3290,133153,126835,6318,13303,-23146,-9843,235,309717,11.385598223,10.84536098,0.5402372426,1.1375080783,-1.979159737,-0.841651659
2020,Ohio,Adams County,27531,-109,346,389,-43,8,-75,-67,1,338,12.54282141,14.101611354,-1.558789944,0.2900074314,-2.71881967,-2.428812238
2020,Ohio,Allen County,101980,-470,1237,1168,69,28,-568,-540,1,5743,12.101941985,11.426894291,0.6750476936,0.2739323974,-5.556914347,-5.28298195
2020,Ohio,Ashland County,53362,-56,596,620,-24,69,-103,-34,2,2024,11.163139165,11.612661547,-0.449522382,1.2923768496,-1.929200225,-0.636823375
2020,Ohio,Ashtabula County,96513,-575,1073,1234,-161,30,-444,-414,0,3212,11.084653488,12.747868038,-1.66321455,0.3099157546,-4.586753168,-4.276837413
2020,Ohio,Athens County,65481,-101,473,536,-63,157,-198,-41,3,9598,7.2179028406,8.1792725636,-0.961369723,2.395794389,-3.021447701,-0.625653312
2020,Ohio,Auglaize County,45680,70,530,534,-4,9,64,73,1,526,11.61134845,11.698981268,-0.087632818,0.1971738416,1.4021250958,1.5992989375
2020,Ohio,Belmont County,65932,-1047,639,907,-268,7,-784,-777,-2,3552,9.6154569599,13.648230771,-4.032773811,0.1053336443,-11.79736816,-11.69203452
2020,Ohio,Brown County,43414,-59,486,541,-55,-3,-3,-6,2,575,11.186943962,12.452956138,-1.266012177,-0.06905521,-0.06905521,-0.138110419
2020,Ohio,Butler County,385648,2045,4426,3747,679,447,902,1349,17,12209,11.507297358,9.7419437869,1.7653535712,1.1621694349,2.3451383229,3.5073077578
2020,Ohio,Carroll County,26897,-87,269,340,-71,-1,-16,-17,1,405,9.9849668714,12.620404224,-2.635437353,-0.037118836,-0.593901375,-0.631020211
2020,Ohio,Champaign County,38960,30,388,429,-41,4,65,69,2,672,9.9627680062,11.015534728,-1.052766722,0.1027089485,1.6690204134,1.7717293619
2020,Ohio,Clark County,133593,-722,1530,1785,-255,62,-530,-468,1,3293,11.421831375,13.325469937,-1.903638562,0.4628454544,-3.95658211,-3.493736656
2020,Ohio,Clermont County,207449,598,2258,1968,290,115,179,294,14,1716,10.900313782,9.5003620565,1.3999517258,0.5551532706,0.8641081342,1.4192614048
2020,Ohio,Clinton County,41921,-81,455,502,-47,25,-61,-36,2,1123,10.843273,11.963347354,-1.120074354,0.5957842308,-1.453713523,-0.857929292
2020,Ohio,Columbiana County,101118,-676,976,1326,-350,34,-363,-329,3,3943,9.6199337644,13.069705094,-3.449771329,0.3351206434,-3.577905693,-3.24278505
2020,Ohio,Coshocton County,36449,-100,448,442,6,3,-109,-106,0,428,12.274308885,12.10992082,0.1643880654,0.0821940327,-2.986383189,-2.904189156
2020,Ohio,Crawford County,41338,-58,450,540,-90,23,8,31,1,579,10.878236275,13.05388353,-2.175647255,0.555998743,0.1933908671,0.7493896101
2020,Ohio,Cuyahoga County,1227883,-7691,13702,14348,-646,1749,-8799,-7050,5,29818,11.124204725,11.648670953,-0.524466228,1.4199557776,-7.143619718,-5.723663941
2020,Ohio,Darke County,51205,24,612,646,-34,13,45,58,0,607,11.95475944,12.618912742,-0.664153302,0.2539409685,0.8790264294,1.1329673979
2020,Ohio,Defiance County,37778,-200,404,438,-34,12,-178,-166,0,724,10.665821849,11.56344052,-0.89761867,0.3168065896,-4.699297745,-4.382491156
2020,Ohio,Delaware County,213554,3786,2118,1372,746,257,2790,3047,-7,1896,10.006567105,6.4820632993,3.5245038056,1.2142057346,13.181455252,14.395660986
2020,Ohio,Erie County,73719,-460,758,991,-233,6,-233,-227,0,1679,10.250307644,13.401127804,-3.15082016,0.0811369998,-3.15082016,-3.06968316
2020,Ohio,Fairfield County,159709,2006,1720,1530,190,100,1724,1824,-8,2705,10.83764949,9.6404672791,1.1971822111,0.6300959006,10.862853326,11.492949227
2020,Ohio,Fayette County,28579,93,321,344,-23,13,102,115,1,593,11.250328573,12.056426882,-0.806098309,0.4556207833,3.5748707614,4.0304915447
2020,Ohio,Franklin County,1324624,5858,18195,10851,7344,4178,-5726,-1548,62,30651,13.766413583,8.2099122717,5.5565013108,3.1610923852,-4.332315701,-1.171223316
2020,Ohio,Fulton County,41889,-286,466,459,7,36,-328,-292,-1,392,11.086791016,10.920251237,0.1665397792,0.8564902931,-7.803578226,-6.947087933
2020,Ohio,Gallia County,29802,-48,349,384,-35,19,-33,-14,1,883,11.701200295,12.874673104,-1.173472809,0.6370280963,-1.10641722,-0.469389124
2020,Ohio,Geauga County,93271,-223,912,919,-7,27,-238,-211,-5,864,9.7662838326,9.8412443445,-0.074960512,0.2891334029,-2.548657404,-2.259524001
2020,Ohio,Greene County,170122,768,1713,1683,30,258,474,732,6,8406,10.092024178,9.9152811981,0.1767429804,1.5199896311,2.7925390897,4.3125287207
2020,Ohio,Guernsey County,38779,-97,436,515,-79,7,-28,-21,3,510,11.229154594,13.263794991,-2.034640397,0.1802845921,-0.721138368,-0.540853776
2020,Ohio,Hamilton County,817985,-668,10619,8412,2207,1377,-4279,-2902,27,23395,12.976602034,10.279609785,2.6969922487,1.6827178643,-5.229012158,-3.546294294
2020,Ohio,Hancock County,75407,-283,848,762,86,101,-470,-369,0,1337,11.224577589,10.086235994,1.1383415951,1.3368895478,-6.221169183,-4.884279635
2020,Ohio,Hardin County,31469,100,368,349,19,3,77,80,1,1856,11.712657946,11.107928324,0.6047296222,0.0954836246,2.4507463637,2.5462299882
2020,Ohio,Harrison County,15014,-39,135,209,-74,1,35,36,-1,232,8.97994479,13.902284897,-4.922340107,0.0665181096,2.3281338344,2.394651944
2020,Ohio,Henry County,26904,-38,300,273,27,-1,-64,-65,0,346,11.14288898,10.140028972,1.0028600082,-0.037142963,-2.377149649,-2.414292612
2020,Ohio,Highland County,43304,181,543,518,25,3,153,156,0,484,12.56551772,11.986994805,0.5785229153,0.0694227498,3.5405602416,3.6099829914
2020,Ohio,Hocking County,28095,-145,291,349,-58,1,-88,-87,0,308,10.331055294,12.390165971,-2.059110677,0.0355019082,-3.124167924,-3.088666016
2020,Ohio,Holmes County,44004,-17,809,366,443,1,-460,-459,-1,765,18.381141721,8.3158193695,10.065322352,0.0227208179,-10.45157626,-10.42885544
2020,Ohio,Huron County,57979,-290,686,658,28,7,-325,-318,0,578,11.802353589,11.320624871,0.4817287179,0.1204321795,-5.591494047,-5.471061868
2020,Ohio,Jackson County,32493,121,376,419,-43,16,148,164,0,325,11.593309181,12.919139752,-1.325830571,0.4933323056,4.5633238264,5.056656132
2020,Ohio,Jefferson County,64939,-555,659,990,-331,-6,-219,-225,1,2353,10.104804766,15.180207463,-5.075402697,-0.092001257,-3.358045893,-3.450047151
2020,Ohio,Knox County,62423,184,738,646,92,10,84,94,-2,3559,11.840015402,10.364024322,1.4759910799,0.160433813,1.3476440295,1.5080778425
2020,Ohio,Lake County,229569,-170,2185,2694,-509,157,171,328,11,2811,9.5143128358,11.730690517,-2.216377681,0.6836371237,0.7445983958,1.4282355195
2020,Ohio,Lawrence County,59091,-465,612,829,-217,-4,-244,-248,0,669,10.316316468,13.974226066,-3.657909597,-0.067426905,-4.113041206,-4.180468111
2020,Ohio,Licking County,178100,926,1980,1826,154,101,666,767,5,3485,11.146326497,10.279389992,0.8669365053,0.5685752405,3.7492189127,4.3177941532
2020,Ohio,Logan County,45326,-268,542,544,-2,7,-273,-266,0,450,11.922569292,11.966564012,-0.043994721,0.1539815222,-6.005279366,-5.851297844
2020,Ohio,Lorain County,312172,2072,3204,3323,-119,252,1937,2189,2,8447,10.297747609,10.680217011,-0.382469402,0.8099352052,6.2255733827,7.0355085879
2020,Ohio,Lucas County,428294,-594,5238,4808,430,339,-1379,-1040,16,9462,12.221441887,11.218154371,1.0032875165,0.7909638793,-3.217519733,-2.426555854
2020,Ohio,Madison County,44559,-253,449,442,7,38,-297,-259,-1,4598,10.048002148,9.8913517808,0.1566503676,0.8503877097,-6.64645131,-5.7960636
2020,Ohio,Mahoning County,226075,-1435,2350,3116,-766,130,-802,-672,3,8974,10.361894683,13.739431419,-3.377536735,0.5732111953,-3.536272143,-2.963060948
2020,Ohio,Marion County,64820,-237,722,808,-86,29,-178,-149,-2,5466,11.118211847,12.44254179,-1.324329943,0.4465763761,-2.741054998,-2.294478622
2020,Ohio,Medina County,180912,791,1664,1613,51,120,615,735,5,1199,9.217993923,8.9354712727,0.2825226503,0.6647591771,3.4068907828,4.07164996
2020,Ohio,Meigs County,22678,-190,201,290,-89,-1,-100,-101,0,212,8.8262416019,12.734378431,-3.908136829,-0.04391165,-4.391164976,-4.435076626
2020,Ohio,Mercer County,41274,19,637,408,229,24,-234,-210,0,439,15.436997904,9.8874335082,5.5495643955,0.5816137358,-5.670733924,-5.089120188
2020,Ohio,Miami County,107516,521,1192,1153,39,47,434,481,1,1056,11.113649183,10.750031467,0.3636177166,0.4382059661,4.0464125383,4.4846185044
2020,Ohio,Monroe County,13586,-122,127,195,-68,0,-54,-54,0,165,9.3060745951,14.288854693,-4.982780098,0.0,-3.956913607,-3.956913607
2020,Ohio,Montgomery County,531610,-529,6367,6441,-74,791,-1270,-479,24,15268,11.970869068,12.109999633,-0.139130566,1.4871929374,-2.387781328,-0.900588391
2020,Ohio,Morgan County,14305,-200,125,177,-52,1,-148,-147,-1,188,8.67754252,12.287400208,-3.609857688,0.0694203402,-10.27421034,-10.20479
2020,Ohio,Morrow County,35411,69,381,358,23,-2,47,45,1,366,10.769861349,10.119712238,0.6501491103,-0.056534705,1.3285655732,1.2720308679
2020,Ohio,Muskingum County,86020,-22,970,1019,-49,25,-2,23,4,1571,11.275005521,11.844567656,-0.569562135,0.2905929258,-0.023247434,0.2673454917
2020,Ohio,Noble County,14364,-87,145,161,-16,2,-72,-70,-1,2655,10.064202672,11.174735381,-1.110532709,0.1388165886,-4.997397189,-4.8585806
2020,Ohio,Ottawa County,40253,-279,318,545,-227,2,-52,-50,-2,495,7.8727486538,13.492603825,-5.619855171,0.0495141425,-1.287367704,-1.237853562
2020,Ohio,Paulding County,18648,-24,219,224,-5,4,-22,-18,-1,85,11.736334405,12.004287245,-0.26795284,0.2143622722,-1.178992497,-0.964630225
2020,Ohio,Perry County,36215,88,413,413,0,9,78,87,1,307,11.417986785,11.417986785,0.0,0.248818114,2.1564236543,2.4052417683
2020,Ohio,Pickaway County,58658,137,602,643,-41,14,163,177,1,4460,10.274878605,10.974662696,-0.699784091,0.2389506652,2.7820684594,3.0210191246
2020,Ohio,Pike County,27695,-89,345,396,-51,-1,-38,-39,1,496,12.437138377,14.275671876,-1.838533499,-0.036049676,-1.369887705,-1.405937382
2020,Ohio,Portage County,162583,157,1348,1571,-223,313,61,374,6,7139,8.2951549034,9.6674245944,-1.372269691,1.926100508,0.3753742204,2.3014747284
2020,Ohio,Preble County,40836,-12,426,500,-74,15,45,60,2,386,10.430439254,12.242299594,-1.81186034,0.3672689878,1.1018069634,1.4690759512
2020,Ohio,Putnam County,33654,-189,424,350,74,15,-278,-263,0,303,12.563521342,10.370831296,2.1926900455,0.4444641984,-8.237403144,-7.792938945
2020,Ohio,Richland County,120891,-493,1385,1494,-109,28,-412,-384,0,6872,11.433288618,12.33309256,-0.899803942,0.231142297,-3.401093798,-3.169951501
2020,Ohio,Ross County,76420,-193,808,929,-121,3,-77,-74,2,5243,10.559813896,12.141172165,-1.581358269,0.0392072298,-1.006318899,-0.967111669
2020,Ohio,Sandusky County,58351,-169,625,668,-43,17,-145,-128,2,902,10.695553217,11.431407278,-0.735854061,0.2909190475,-2.481368346,-2.190449299
2020,Ohio,Scioto County,74347,-704,784,1037,-253,10,-462,-452,1,3148,10.495455093,13.88238129,-3.386926197,0.1338706007,-6.184821751,-6.050951151
2020,Ohio,Seneca County,54938,-282,584,611,-27,42,-296,-254,-1,2468,10.602952123,11.093157102,-0.490204978,0.7625410774,-5.374099021,-4.611557944
2020,Ohio,Shelby County,48337,-255,610,487,123,36,-414,-378,0,589,12.58653241,10.048592269,2.5379401418,0.7428117488,-8.542335111,-7.799523362
2020,Ohio,Stark County,369772,-951,4040,4443,-403,97,-649,-552,4,8792,10.91161993,12.000081027,-1.088461097,0.2619869142,-1.752881518,-1.490894604
2020,Ohio,Summit County,538866,-1948,5804,6298,-494,721,-2188,-1467,13,9534,10.751333729,11.66641968,-0.915085951,1.3355809129,-4.053052756,-2.717471844
2020,Ohio,Trumbull County,196800,-1269,2078,2644,-566,17,-720,-703,0,3810,10.52500956,13.391783098,-2.866773538,0.0861045055,-3.646779058,-3.560674553
2020,Ohio,Tuscarawas County,91776,-217,1125,1118,7,53,-279,-226,2,1251,12.243631951,12.167449352,0.0761825988,0.5768111052,-3.036420724,-2.459609619
2020,Ohio,Union County,60021,967,714,416,298,46,623,669,0,2414,11.992441738,6.9871929456,5.0052487928,0.7726222969,10.463993282,11.236615578
2020,Ohio,Van Wert County,28159,-72,340,315,25,8,-104,-96,-1,396,12.058875687,11.172193651,0.8866820358,0.2837382515,-3.688597269,-3.404859018
2020,Ohio,Vinton County,12972,-56,125,184,-59,0,3,3,0,68,9.6153846154,14.153846154,-4.538461538,0.0,0.2307692308,0.2307692308
2020,Ohio,Warren County,238412,2811,2360,2019,341,365,2106,2471,-1,5248,9.9575328103,8.5187537051,1.4387791052,1.5400421507,8.8858322451,10.425874396
2020,Ohio,Washington County,59652,-366,592,782,-190,27,-206,-179,3,1587,9.8938748224,13.069273836,-3.175399014,0.4512409125,-3.442801036,-2.991560124
2020,Ohio,Wayne County,115694,-130,1428,1249,179,54,-365,-311,2,3365,12.335973877,10.789657824,1.5463160532,0.4664864071,-3.153102567,-2.686616159
2020,Ohio,Williams County,36565,-200,419,410,9,12,-219,-207,-2,990,11.427792172,11.182326469,0.245465703,0.327287604,-5.972998773,-5.645711169
2020,Ohio,Wood County,131113,24,1265,1182,83,133,-197,-64,5,6435,9.6490492063,9.0159495351,0.6330996712,1.0144850154,-1.502658256,-0.48817324
2020,Ohio,Wyandot County,21711,-85,223,263,-40,2,-47,-45,0,251,10.251223941,12.090008504,-1.838784563,0.0919392282,-2.160571862,-2.068632634
2020,Oklahoma,Oklahoma,3980783,20107,49033,43466,5567,2821,11682,14503,37,109811,12.348612516,10.946603137,1.4020093789,0.7104487979,2.9420286625,3.6524774604
2020,Oklahoma,Adair County,21955,-269,298,291,7,1,-276,-275,-1,92,13.490572444,13.173679803,0.3168926413,0.0452703773,-12.49462414,-12.44935377
2020,Oklahoma,Alfalfa County,5718,54,49,55,-6,5,56,61,-1,1051,8.6100861009,9.6643823581,-1.054296257,0.8785802144,9.840098401,10.718678615
2020,Oklahoma,Atoka County,13912,174,154,139,15,-1,162,161,-2,749,11.139240506,10.054249548,1.0849909584,-0.072332731,11.717902351,11.64556962
2020,Oklahoma,Beaver County,5207,-101,49,54,-5,8,-104,-96,0,43,9.3200190204,10.271041369,-0.951022349,1.5216357584,-19.78126486,-18.2596291
2020,Oklahoma,Beckham County,21468,-366,295,280,15,-3,-375,-378,-3,1926,13.62523671,12.932428063,0.6928086463,-0.138561729,-17.32021616,-17.45877789
2020,Oklahoma,Blaine County,9447,-10,129,114,15,20,-45,-25,0,107,13.647905205,12.060939484,1.5869657215,2.1159542954,-4.760897165,-2.644942869
2020,Oklahoma,Bryan County,48998,909,597,601,-4,17,900,917,-4,1137,12.298247963,12.380648285,-0.082400321,0.3502013658,18.540072306,18.890273672
2020,Oklahoma,Caddo County,28684,-243,368,386,-18,41,-265,-224,-1,1927,12.775338043,13.400218708,-0.624880665,1.4233392928,-9.199632015,-7.776292722
2020,Oklahoma,Canadian County,153192,4557,1891,1228,663,60,3855,3915,-21,2482,12.530356794,8.1371116567,4.3932451371,0.3975787454,25.544434395,25.94201314
2020,Oklahoma,Carter County,48353,25,654,700,-46,33,35,68,3,913,13.529028454,14.480611496,-0.951583041,0.6826573991,0.7240305748,1.4066879739
2020,Oklahoma,Cherokee County,49019,200,581,543,38,35,124,159,3,2013,11.876775895,11.099981602,0.7767942926,0.7154684274,2.5348024285,3.2502708559
2020,Oklahoma,Choctaw County,14646,4,197,238,-41,0,45,45,0,172,13.452608577,16.252390057,-2.79978148,0.0,3.0729308932,3.0729308932
2020,Oklahoma,Cimarron County,2145,-3,28,17,11,1,-15,-14,0,7,13.044491032,7.9198695551,5.1246214768,0.4658746797,-6.988120196,-6.522245516
2020,Oklahoma,Cleveland County,287066,2529,2800,2346,454,188,1875,2063,12,10547,9.7970094629,8.2084943571,1.5885151058,0.6577992068,6.5604974082,7.218296615
2020,Oklahoma,Coal County,5587,76,75,83,-8,0,84,84,0,61,13.51594882,14.957650027,-1.441701207,0.0,15.137862678,15.137862678
2020,Oklahoma,Comanche County,121099,-125,1643,1189,454,67,-650,-583,4,10280,13.560413168,9.8133482996,3.747064868,0.5529809387,-5.36474045,-4.811759511
2020,Oklahoma,Cotton County,5676,26,51,98,-47,0,75,75,-2,48,9.0058273,17.305315204,-8.299487904,0.0,13.243863676,13.243863676
2020,Oklahoma,Craig County,14194,84,141,231,-90,0,175,175,-1,1050,9.9632560769,16.322781232,-6.359525155,0.0,12.365743358,12.365743358
2020,Oklahoma,Creek County,71485,123,776,985,-209,19,312,331,1,1061,10.864771399,13.79097916,-2.926207761,0.2660188873,4.36831015,4.6343290374
2020,Oklahoma,Custer County,28648,-265,394,289,105,8,-377,-369,-1,1525,13.689824708,10.041521169,3.6483035389,0.2779659839,-13.09914699,-12.82118101
2020,Oklahoma,Delaware County,43136,125,410,635,-225,0,351,351,-1,356,9.5186135327,14.74224291,-5.223629378,0.0,8.1488618292,8.1488618292
2020,Oklahoma,Dewey County,4815,-81,55,79,-24,6,-63,-57,0,93,11.327360725,16.270209041,-4.942848316,1.2357120791,-12.97497683,-11.73926475
2020,Oklahoma,Ellis County,3830,-35,47,50,-3,3,-36,-33,1,46,12.215724496,12.995451592,-0.779727096,0.7797270955,-9.356725146,-8.576998051
2020,Oklahoma,Garfield County,60869,-463,818,676,142,142,-744,-602,-3,1801,13.387779151,11.063739249,2.3240399015,2.3240399015,-12.17665977,-9.852619864
2020,Oklahoma,Garvin County,27691,4,327,360,-33,25,13,38,-1,317,11.809743942,13.001552963,-1.191809022,0.9028856224,0.4695005237,1.3723861461
2020,Oklahoma,Grady County,55906,142,550,581,-31,12,158,170,3,1075,9.8504522253,10.405659533,-0.555207307,0.2149189576,2.8297662756,3.0446852333
2020,Oklahoma,Grant County,4372,44,51,47,4,0,40,40,0,73,11.724137931,10.804597701,0.9195402299,0.0,9.1954022989,9.1954022989
2020,Oklahoma,Greer County,5704,6,49,60,-11,-1,18,17,0,1136,8.5949833363,10.524469391,-1.929486055,-0.175407823,3.1573408174,2.9819329942
2020,Oklahoma,Harmon County,2557,-88,25,31,-6,2,-84,-82,0,100,9.6116878124,11.918492887,-2.306805075,0.768935025,-32.29527105,-31.52633602
2020,Oklahoma,Harper County,3611,-96,36,77,-41,14,-69,-55,0,41,9.8387537579,21.044001093,-11.20524734,3.8261820169,-18.85761137,-15.03142935
2020,Oklahoma,Haskell County,12652,-18,119,144,-25,6,0,6,1,78,9.3989416318,11.373509201,-1.97456757,0.4738962167,0.0,0.4738962167
2020,Oklahoma,Hughes County,13126,-114,151,176,-25,1,-89,-88,-1,1556,11.45414549,13.350527194,-1.896381704,0.0758552681,-6.751118865,-6.675263597
2020,Oklahoma,Jackson County,24305,-126,358,222,136,19,-281,-262,0,687,14.691398555,9.1103086014,5.581089954,0.7797110965,-11.53151674,-10.75180565
2020,Oklahoma,Jefferson County,5949,-39,59,85,-26,0,-13,-13,0,144,9.885230795,14.241434196,-4.356203401,0.0,-2.178101701,-2.178101701
2020,Oklahoma,Johnston County,10824,-231,125,185,-60,1,-170,-169,-2,292,11.426482015,16.911193382,-5.484711367,0.0914118561,-15.54001554,-15.44860368
2020,Oklahoma,Kay County,43274,-394,517,577,-60,2,-335,-333,-1,1275,11.892986129,13.273216627,-1.380230498,0.0460076833,-7.70628695,-7.660279267
2020,Oklahoma,Kingfisher County,15806,-93,186,142,44,28,-166,-138,1,155,11.733165116,8.9575776691,2.7755874468,1.7662829207,-10.47153446,-8.705251538
2020,Oklahoma,Kiowa County,8741,16,110,108,2,1,13,14,0,171,12.595900607,12.366884232,0.2290163747,0.1145081873,1.4886064354,1.6031146227
2020,Oklahoma,Latimer County,10132,88,121,121,0,2,87,89,-1,575,11.99444885,11.99444885,0.0,0.1982553529,8.6241078509,8.8223632038
2020,Oklahoma,Le Flore County,49935,131,596,732,-136,25,241,266,1,1612,11.951192613,14.67831039,-2.727117777,0.501308415,4.8326131202,5.3339215352
2020,Oklahoma,Lincoln County,35045,106,358,382,-24,2,129,131,-1,386,10.230909922,10.916780979,-0.685871056,0.0571559214,3.6865569273,3.7437128487
2020,Oklahoma,Logan County,48777,693,504,437,67,7,622,629,-3,2163,10.406665221,9.0232394875,1.3834257338,0.144537017,12.843146364,12.987683381
2020,Oklahoma,Love County,10230,53,121,139,-18,7,65,72,-1,88,11.858675945,13.622776498,-1.764100554,0.6860391042,6.3703631107,7.0564022149
2020,Oklahoma,McClain County,41348,882,419,408,11,5,872,877,-6,194,10.24274574,9.9738431075,0.2689026328,0.1222284695,21.316645073,21.438873542
2020,Oklahoma,McCurtain County,32772,24,432,490,-58,45,35,80,2,454,13.186813187,14.957264957,-1.77045177,1.3736263736,1.0683760684,2.442002442
2020,Oklahoma,McIntosh County,19635,40,177,335,-158,-1,201,200,-2,345,9.0237063472,17.07876625,-8.055059903,-0.050981392,10.24725975,10.196278358
2020,Oklahoma,Major County,7579,-51,110,74,36,9,-96,-87,0,77,14.465119337,9.7310802814,4.7340390558,1.183509764,-12.62410415,-11.44059438
2020,Oklahoma,Marshall County,17114,168,203,185,18,5,146,151,-1,329,11.920140928,10.863182619,1.0569583089,0.2935995302,8.573106283,8.8667058133
2020,Oklahoma,Mayes County,41152,16,458,594,-136,4,147,151,1,565,11.131635232,14.437098969,-3.305463737,0.0972195217,3.5728174217,3.6700369434
2020,Oklahoma,Murray County,13955,-126,163,217,-54,5,-77,-72,0,313,11.627906977,15.480097018,-3.852190041,0.3566842631,-5.492937652,-5.136253389
2020,Oklahoma,Muskogee County,67610,-487,795,924,-129,17,-375,-358,0,3505,11.71641846,13.617573154,-1.901154694,0.2505397658,-5.526612481,-5.276072715
2020,Oklahoma,Noble County,11113,-55,109,130,-21,1,-35,-34,0,273,9.784121,11.669135138,-1.885014138,0.089762578,-3.141690229,-3.051927651
2020,Oklahoma,Nowata County,10076,-47,131,158,-27,1,-21,-20,0,157,12.970939155,15.644338829,-2.673399673,0.0990148027,-2.079310857,-1.980296054
2020,Oklahoma,Okfuskee County,11765,-191,144,171,-27,1,-165,-164,0,1226,12.141140761,14.417604654,-2.276463893,0.0843134775,-13.91172379,-13.82741031
2020,Oklahoma,Oklahoma County,804041,6478,11194,7683,3511,692,2237,2929,38,14800,13.978486567,9.5941318828,4.3843546844,0.864133706,2.7934495668,3.6575832728
2020,Oklahoma,Okmulgee County,38234,-183,415,576,-161,2,-25,-23,1,1376,10.828299696,15.029158132,-4.200858436,0.0521845768,-0.652307211,-0.600122634
2020,Oklahoma,Osage County,46642,-300,432,597,-165,6,-143,-137,2,1497,9.2323474098,12.758591212,-3.526243802,0.1282270474,-3.056077962,-2.927850915
2020,Oklahoma,Ottawa County,30879,-301,393,531,-138,12,-173,-161,-2,971,12.665366828,17.112747547,-4.447380718,0.3867287581,-5.575339596,-5.188610838
2020,Oklahoma,Pawnee County,16381,2,185,202,-17,5,16,21,-2,194,11.294261294,12.332112332,-1.037851038,0.3052503053,0.9768009768,1.2820512821
2020,Oklahoma,Payne County,81755,72,813,664,149,226,-307,-81,4,7786,9.9487267343,8.1254053525,1.8233213818,2.7655747133,-3.75677627,-0.991201557
2020,Oklahoma,Pittsburg County,43679,6,522,632,-110,6,109,115,1,2417,11.951643923,14.470189578,-2.518545654,0.1373752175,2.4956497848,2.6330250023
2020,Oklahoma,Pontotoc County,38397,45,498,541,-43,16,69,85,3,1699,12.977367783,14.097903556,-1.120535772,0.4169435432,1.7980690302,2.2150125735
2020,Oklahoma,Pottawatomie County,72998,295,849,883,-34,19,307,326,3,3049,11.654003747,12.120712967,-0.46670922,0.2608080933,4.2141097178,4.4749178111
2020,Oklahoma,Pushmataha County,10970,-60,101,172,-71,0,13,13,-2,110,9.1818181818,15.636363636,-6.454545455,0.0,1.1818181818,1.1818181818
2020,Oklahoma,Roger Mills County,3570,-23,34,28,6,0,-30,-30,1,11,9.493229094,7.8179533715,1.6752757225,0.0,-8.376378612,-8.376378612
2020,Oklahoma,Rogers County,93155,539,1046,921,125,30,381,411,3,1217,11.261176395,9.9154335176,1.345742877,0.3229782905,4.101824289,4.4248025795
2020,Oklahoma,Seminole County,24248,-73,305,349,-44,8,-38,-30,1,581,12.559451502,14.371306801,-1.811855299,0.3294282361,-1.564784122,-1.235355885
2020,Oklahoma,Sequoyah County,41538,-61,546,599,-53,10,-20,-10,2,464,13.134945933,14.409949842,-1.275003909,0.2405667753,-0.481133551,-0.240566775
2020,Oklahoma,Stephens County,43100,-158,512,589,-77,17,-99,-82,1,540,11.857615971,13.640890248,-1.783274277,0.3937099053,-2.292781213,-1.899071308
2020,Oklahoma,Texas County,19997,-219,335,130,205,79,-500,-421,-3,574,16.661278691,6.4655708353,10.195707856,3.9290776615,-24.86758014,-20.93850247
2020,Oklahoma,Tillman County,7229,-31,73,81,-8,11,-33,-22,-1,267,10.076609842,11.180895852,-1.10428601,1.5183932639,-4.555179792,-3.036786528
2020,Oklahoma,Tulsa County,657589,5423,8841,6617,2224,666,2504,3170,29,9858,13.500234777,10.104179789,3.3960549874,1.0169840924,3.8236158671,4.8405999595
2020,Oklahoma,Wagoner County,82925,1459,891,845,46,32,1387,1419,-6,319,10.84000949,10.280368147,0.5596413429,0.3893157168,16.8744031,17.263718817
2020,Oklahoma,Washington County,52222,557,575,683,-108,66,604,670,-5,798,11.069719984,13.148902173,-2.079182188,1.2706113373,11.628018905,12.898630242
2020,Oklahoma,Washita County,10830,-113,122,151,-29,3,-87,-84,0,206,11.20654021,13.870389932,-2.663849722,0.2755706609,-7.991549166,-7.715978505
2020,Oklahoma,Woods County,8687,-103,93,105,-12,4,-94,-90,-1,997,10.642558792,12.015792184,-1.373233392,0.4577444642,-10.75699491,-10.29925044
2020,Oklahoma,Woodward County,19812,-326,254,288,-34,16,-306,-290,-2,1231,12.715894869,14.418022528,-1.70212766,0.8010012516,-15.31914894,-14.51814768
2020,Oregon,Oregon,4241507,25391,42070,39735,2335,1908,21128,23036,20,88649,9.9484216783,9.3962570807,0.5521645975,0.4511906005,4.9962028338,5.4473934343
2020,Oregon,Baker County,16284,161,160,231,-71,5,230,235,-3,368,9.8744098497,14.256179221,-4.381769371,0.3085753078,14.194464159,14.503039467
2020,Oregon,Benton County,93239,125,678,650,28,204,-111,93,4,5819,7.2765128546,6.976007899,0.3005049556,2.1893932483,-1.191287503,0.9981057455
2020,Oregon,Clackamas County,421596,3397,3864,3871,-7,75,3339,3414,-10,2915,9.2022457862,9.2189165213,-0.016670735,0.1786150191,7.9519406522,8.1305556713
2020,Oregon,Clatsop County,40423,215,373,435,-62,6,271,277,0,859,9.2520246555,10.789894706,-1.53787005,0.1488261339,6.7219803798,6.8708065136
2020,Oregon,Columbia County,52876,262,466,533,-67,-1,333,332,-3,465,8.8349606598,10.105223244,-1.270262584,-0.018959143,6.3133946346,6.2944354915
2020,Oregon,Coos County,64711,34,570,999,-429,-5,471,466,-3,1188,8.8107088756,15.441926608,-6.631217733,-0.07728692,7.2804278604,7.2031409404
2020,Oregon,Crook County,25105,717,237,266,-29,-5,757,752,-6,229,9.5771119148,10.748994807,-1.171882893,-0.202048775,30.590184471,30.388135696
2020,Oregon,Curry County,23305,324,169,403,-234,-11,572,561,-3,304,7.3024240591,17.413472756,-10.1110487,-0.475305708,24.715896815,24.240591107
2020,Oregon,Deschutes County,201769,4352,1866,1674,192,-52,4235,4183,-23,1378,9.3490252664,8.3870676827,0.9619575837,-0.260530179,21.218178994,20.957648815
2020,Oregon,Douglas County,111364,438,1048,1592,-544,-6,994,988,-6,1836,9.4291241171,14.323631292,-4.894507175,-0.053983535,8.9432723019,8.8892887669
2020,Oregon,Gilliam County,1975,64,14,21,-7,0,71,71,0,18,7.2053525476,10.808028821,-3.602676274,0.0,36.541430777,36.541430777
2020,Oregon,Grant County,7180,14,59,89,-30,-2,46,44,0,126,8.2252892792,12.40763976,-4.182350481,-0.278823365,6.4129374042,6.1341140388
2020,Oregon,Harney County,7373,-2,63,83,-20,3,16,19,-1,155,8.5435313263,11.255763493,-2.712232167,0.4068348251,2.1697857337,2.5766205587
2020,Oregon,Hood River County,23280,-67,250,179,71,-2,-137,-139,1,791,10.723400605,7.677954833,3.0454457718,-0.085787205,-5.876423531,-5.962210736
2020,Oregon,Jackson County,221844,1029,2159,2524,-365,-30,1426,1396,-2,3484,9.7546870164,11.403811964,-1.649124947,-0.135544516,6.4428826704,6.3073381542
2020,Oregon,Jefferson County,24856,209,310,274,36,-10,184,174,-1,943,12.524493465,11.070036159,1.4544573056,-0.404015918,7.4338928954,7.0298769772
2020,Oregon,Josephine County,88053,374,803,1293,-490,-16,885,869,-5,1615,9.1389160768,14.715589648,-5.576673571,-0.182095464,10.072155327,9.8900598639
2020,Oregon,Klamath County,68739,396,771,894,-123,-10,530,520,-1,1193,11.248741629,13.043287959,-1.79454633,-0.145898076,7.732598007,7.5866999314
2020,Oregon,Lake County,7949,10,71,107,-36,0,46,46,0,469,8.9375629406,13.469284995,-4.531722054,0.0,5.7905337362,5.7905337362
2020,Oregon,Lane County,382986,922,3314,4016,-702,137,1470,1607,17,8800,8.6634860467,10.498660218,-1.835174172,0.3581465264,3.8428860859,4.2010326122
2020,Oregon,Lincoln County,50583,458,386,690,-304,-3,769,766,-4,857,7.6657266553,13.702982881,-6.037256226,-0.059578186,15.271875124,15.212296938
2020,Oregon,Linn County,131054,1456,1498,1472,26,-4,1437,1433,-3,1171,11.494252874,11.294753157,0.1994997161,-0.030692264,11.026195847,10.995503583
2020,Oregon,Malheur County,30983,285,383,269,114,6,166,172,-1,3266,12.418735105,8.7222969796,3.6964381252,0.194549375,5.3825327086,5.5770820836
2020,Oregon,Marion County,349204,1647,4119,3161,958,46,625,671,18,10478,11.823279432,9.0734125475,2.7498668841,0.1320395372,1.7940154515,1.9260549887
2020,Oregon,Morrow County,11700,93,167,101,66,16,11,27,0,23,14.33045866,8.6669241001,5.6635345604,1.3729780753,0.9439224267,2.316900502
2020,Oregon,Multnomah County,815637,3198,8081,6509,1572,872,742,1614,12,19129,9.9270550023,7.9959412214,1.9311137809,1.0712030642,0.9115053597,1.9827084239
2020,Oregon,Polk County,87744,1893,846,783,63,22,1818,1840,-10,1799,9.7468245053,9.0209971485,0.7258273568,0.2534635214,20.945303724,21.198767246
2020,Oregon,Sherman County,1801,11,23,15,8,0,1,1,2,0,12.809802283,8.3542188805,4.455583403,0.0,0.5569479254,0.5569479254
2020,Oregon,Tillamook County,27442,310,248,318,-70,-7,390,383,-3,477,9.088576978,11.653901125,-2.565324147,-0.256532415,14.292520248,14.035987833
2020,Oregon,Umatilla County,77752,8,956,711,245,3,-243,-240,3,4089,12.296136235,9.1449297731,3.1512064619,0.0385862016,-3.125482328,-3.086896126
2020,Oregon,Union County,26551,-182,260,344,-84,13,-112,-99,1,878,9.7590271001,12.911943548,-3.152916448,0.487951355,-4.203888597,-3.715937242
2020,Oregon,Wallowa County,7181,12,64,79,-15,0,28,28,-1,105,8.9198606272,11.010452962,-2.090592334,0.0,3.9024390244,3.9024390244
2020,Oregon,Wasco County,26403,-129,282,298,-16,-4,-108,-112,-1,741,10.654576367,11.259091338,-0.604514971,-0.151128743,-4.080476056,-4.231604798
2020,Oregon,Washington County,603514,2581,6426,3878,2548,718,-732,-14,47,7407,10.670457065,6.4394697318,4.2309873328,1.1922483928,-1.215495576,-0.023247183
2020,Oregon,Wheeler County,1387,39,8,17,-9,0,47,47,1,24,5.8500914077,12.431444241,-6.581352834,0.0,34.36928702,34.36928702
2020,Oregon,Yamhill County,107664,737,1078,956,122,-50,661,611,4,5250,10.047019679,8.9099729252,1.1370467541,-0.466002768,6.1605565937,5.6945538256
2020,Pennsylvania,Pennsylvania,12783254,-15629,133740,143283,-9543,14523,-20854,-6331,245,415344,10.455733233,11.201800694,-0.746067461,1.1354016281,-1.630356369,-0.494954741
2020,Pennsylvania,Adams County,102742,-34,899,1106,-207,14,157,171,2,4038,8.7486254245,10.763047519,-2.014422094,0.1362411078,1.5278467093,1.6640878171
2020,Pennsylvania,Allegheny County,1211358,-4358,12681,14553,-1872,1303,-3839,-2536,50,34557,10.449619583,11.99221779,-1.542598207,1.0737208672,-3.163479976,-2.089759109
2020,Pennsylvania,Armstrong County,64162,-537,562,947,-385,1,-154,-153,1,650,8.7225770404,14.698007931,-5.975430891,0.0155205997,-2.390172356,-2.374651757
2020,Pennsylvania,Beaver County,162575,-1381,1539,2215,-676,16,-723,-707,2,3195,9.4263638062,13.566858889,-4.140495083,0.0979998836,-4.428369741,-4.330369858
2020,Pennsylvania,Bedford County,47817,-96,458,598,-140,3,41,44,0,551,9.5685782931,12.493471221,-2.924892928,0.062676277,0.8565757861,0.9192520631
2020,Pennsylvania,Berks County,421017,642,4564,4204,360,776,-508,268,14,11407,10.848688839,9.9929640405,0.8557247989,1.8445623443,-1.207522772,0.6370395725
2020,Pennsylvania,Blair County,121007,-935,1164,1740,-576,19,-381,-362,3,3721,9.5822580048,14.323993925,-4.74173592,0.1564114279,-3.136460739,-2.980049311
2020,Pennsylvania,Bradford County,60221,-208,652,787,-135,18,-92,-74,1,664,10.808122669,13.046000829,-2.23787816,0.2983837547,-1.525072524,-1.226688769
2020,Pennsylvania,Bucks County,627987,-510,5615,6632,-1017,244,260,504,3,8250,8.9376386806,10.556441626,-1.618802945,0.3883853674,0.4138532604,0.8022386278
2020,Pennsylvania,Butler County,189135,822,1783,2133,-350,59,1111,1170,2,5443,9.4476590153,11.302219114,-1.854560098,0.3126258451,5.8869036265,6.1995294716
2020,Pennsylvania,Cambria County,128672,-1435,1171,1837,-666,19,-787,-768,-1,5924,9.0501934083,14.197442605,-5.147249197,0.1468434456,-6.082410087,-5.935566642
2020,Pennsylvania,Cameron County,4330,-95,33,76,-43,2,-55,-53,1,92,7.5385494003,17.36150771,-9.82295831,0.4568817818,-12.564249,-12.10736722
2020,Pennsylvania,Carbon County,64081,-44,542,857,-315,13,258,271,0,700,8.455142505,13.36910909,-4.913966585,0.202798621,4.0247726315,4.2275712525
2020,Pennsylvania,Centre County,161496,-599,1137,1208,-71,508,-1043,-535,7,19160,7.0273895133,7.4662150678,-0.438825554,3.1397659391,-6.446409202,-3.306643263
2020,Pennsylvania,Chester County,526759,1700,5359,4549,810,446,431,877,13,13409,10.189975832,8.6497854192,1.5401904132,0.8480554621,0.8195334174,1.6675888794
2020,Pennsylvania,Clarion County,38305,-193,363,481,-118,9,-85,-76,1,1774,9.4527557517,12.525552387,-3.072796636,0.2343658451,-2.213455204,-1.979089358
2020,Pennsylvania,Clearfield County,78612,-571,681,1008,-327,35,-281,-246,2,5668,8.6314522006,12.776070218,-4.144618017,0.4436135492,-3.561583067,-3.117969517
2020,Pennsylvania,Clinton County,37957,-345,411,424,-13,3,-335,-332,0,1753,10.779055587,11.119998951,-0.340943364,0.0786792379,-8.785848228,-8.70716899
2020,Pennsylvania,Columbia County,64842,-178,521,774,-253,11,62,73,2,3509,8.0239022963,11.920346214,-3.896443917,0.1694106051,0.9548597742,1.1242703793
2020,Pennsylvania,Crawford County,83697,-724,885,1043,-158,9,-575,-566,0,3685,10.528319395,12.407951558,-1.879632163,0.1070676549,-6.840433505,-6.73336585
2020,Pennsylvania,Cumberland County,255857,2724,2592,2510,82,282,2367,2649,-7,11803,10.184875931,9.8626692076,0.3222067231,1.1080767795,9.3007721173,10.408848897
2020,Pennsylvania,Dauphin County,279874,1447,3381,2798,583,538,313,851,13,7057,12.111746173,10.023267019,2.0884791537,1.9272757885,1.1212589625,3.048534751
2020,Pennsylvania,Delaware County,566753,247,6418,5884,534,763,-1071,-308,21,22261,11.326625246,10.384210494,0.9424147525,1.3465589067,-1.89012397,-0.543565063
2020,Pennsylvania,Elk County,29607,-287,261,386,-125,1,-164,-163,1,355,8.772961799,12.974571856,-4.201610057,0.0336128805,-5.512512395,-5.478899514
2020,Pennsylvania,Erie County,268426,-1103,2681,3012,-331,357,-1137,-780,8,12120,9.9673764534,11.197962655,-1.230586201,1.3272485617,-4.227119369,-2.899870807
2020,Pennsylvania,Fayette County,128126,-1296,1284,1938,-654,22,-664,-642,0,4259,9.9709568702,15.049621818,-5.078664948,0.1708419401,-5.156320375,-4.985478435
2020,Pennsylvania,Forest County,6965,-65,15,82,-67,3,-1,2,0,2430,2.1436227224,11.718470882,-9.57484816,0.4287245445,-0.142908181,0.285816363
2020,Pennsylvania,Franklin County,155637,115,1717,1763,-46,152,3,155,6,2690,11.036158363,11.331827137,-0.295668774,0.9769924701,0.0192827461,0.9962752162
2020,Pennsylvania,Fulton County,14501,-1,144,162,-18,0,16,16,1,122,9.9300072406,11.171258146,-1.241250905,0.0,1.1033341378,1.1033341378
2020,Pennsylvania,Greene County,35621,-441,320,461,-141,1,-300,-299,-1,2968,8.9281977596,12.862184897,-3.933987138,0.027900618,-8.3701854,-8.342284782
2020,Pennsylvania,Huntingdon County,44590,-304,408,572,-164,18,-160,-142,2,4778,9.1189486389,12.784408386,-3.665459747,0.4023065576,-3.57605829,-3.173751732
2020,Pennsylvania,Indiana County,83664,-358,788,961,-173,37,-224,-187,2,4926,9.3985186599,11.461899026,-2.063380366,0.4413010031,-2.671660127,-2.230359124
2020,Pennsylvania,Jefferson County,43108,-191,459,554,-95,0,-96,-96,0,759,10.624139248,12.823035171,-2.198895923,0.0,-2.222042196,-2.222042196
2020,Pennsylvania,Juniata County,24619,-141,282,271,11,12,-164,-152,0,292,11.421859495,10.976325969,0.4455335264,0.4860365743,-6.642499848,-6.156463274
2020,Pennsylvania,Lackawanna County,208989,-819,1987,2711,-724,373,-473,-100,5,7653,9.4890842102,12.94660659,-3.45752238,1.7812926072,-2.258850947,-0.47755834
2020,Pennsylvania,Lancaster County,546192,751,6879,5565,1314,590,-1165,-575,12,12603,12.603136768,10.195734281,2.4074024878,1.0809493667,-2.13441697,-1.053467603
2020,Pennsylvania,Lawrence County,85083,-421,840,1158,-318,15,-119,-104,1,2091,9.8483471777,13.576650038,-3.72830286,0.1758633425,-1.395182517,-1.219319174
2020,Pennsylvania,Lebanon County,141663,345,1541,1628,-87,232,197,429,3,3684,10.891190575,11.506072846,-0.614882271,1.6396860567,1.3923196257,3.0320056824
2020,Pennsylvania,Lehigh County,370802,1494,4307,3571,736,1033,-288,745,13,8979,11.638810447,9.6499169042,1.9888935429,2.7914769426,-0.778262691,2.0132142519
2020,Pennsylvania,Luzerne County,316982,-456,3269,4204,-935,582,-109,473,6,11699,10.305475868,13.25305003,-2.947574162,1.8347466978,-0.343620945,1.4911257527
2020,Pennsylvania,Lycoming County,113209,-372,1169,1418,-249,57,-183,-126,3,5276,10.309096521,12.504960536,-2.195864015,0.5026676661,-1.61382777,-1.111160104
2020,Pennsylvania,McKean County,40333,-298,354,540,-186,12,-126,-114,2,2966,8.7446272417,13.339261894,-4.594634652,0.2964280421,-3.112494442,-2.8160664
2020,Pennsylvania,Mercer County,108545,-751,1053,1520,-467,16,-301,-285,1,6071,9.6676015993,13.955132413,-4.287530814,0.1468961307,-2.763483458,-2.616587327
2020,Pennsylvania,Mifflin County,46064,-26,603,564,39,1,-67,-66,1,560,13.086789505,12.240380233,0.8464092714,0.0217028018,-1.454087723,-1.432384921
2020,Pennsylvania,Monroe County,170154,71,1521,1775,-254,135,186,321,4,4164,8.9408265415,10.433903426,-1.493076885,0.7935644859,1.093355514,1.8869199999
2020,Pennsylvania,Montgomery County,833869,3472,8467,8416,51,855,2549,3404,17,20808,10.175056151,10.113767871,0.0612882796,1.0274799822,3.0632122509,4.0906922331
2020,Pennsylvania,Montour County,18042,-139,191,241,-50,11,-98,-87,-2,845,10.545785827,13.306462745,-2.760676918,0.607348922,-5.410926759,-4.803577837
2020,Pennsylvania,Northampton County,305892,377,2894,3214,-320,317,369,686,11,11165,9.4666891285,10.513455031,-1.046765902,1.0369524719,1.207051931,2.244004403
2020,Pennsylvania,Northumberland County,90258,-426,882,1174,-292,14,-152,-138,4,3566,9.7489803362,12.976533917,-3.227553581,0.1547457196,-1.680096384,-1.525350665
2020,Pennsylvania,Perry County,46212,-114,493,499,-6,5,-116,-111,3,659,10.655082236,10.784758694,-0.129676457,0.1080637144,-2.507078173,-2.399014459
2020,Pennsylvania,Philadelphia County,1578487,-5952,20478,16685,3793,4153,-13894,-9741,-4,55137,12.948769589,10.550357485,2.3984121032,2.6260494239,-8.785535925,-6.159486501
2020,Pennsylvania,Pike County,56072,246,418,569,-151,10,390,400,-3,477,7.4710897424,10.169976228,-2.698886486,0.1787342044,6.9706339702,7.1493681746
2020,Pennsylvania,Potter County,16453,-92,158,230,-72,3,-23,-20,0,217,9.5763379599,13.940238802,-4.363900842,0.1818292018,-1.39402388,-1.212194678
2020,Pennsylvania,Schuylkill County,140709,-457,1261,1882,-621,4,158,162,2,6566,8.9472283814,13.353436807,-4.406208426,0.0283813747,1.1210643016,1.1494456763
2020,Pennsylvania,Snyder County,40317,-76,409,416,-7,7,-76,-69,0,2684,10.135051419,10.308511956,-0.173460538,0.1734605377,-1.883285838,-1.7098253
2020,Pennsylvania,Somerset County,72916,-526,705,999,-294,14,-246,-232,0,4863,9.633911368,13.651457385,-4.017546017,0.1913117151,-3.361620137,-3.170308422
2020,Pennsylvania,Sullivan County,5913,-46,39,110,-71,0,25,25,0,371,6.5700808625,18.530997305,-11.96091644,0.0,4.2115902965,4.2115902965
2020,Pennsylvania,Susquehanna County,40006,-235,376,501,-125,2,-112,-110,0,282,9.3710668312,12.486448092,-3.11538126,0.0498461002,-2.791381609,-2.741535509
2020,Pennsylvania,Tioga County,40381,-284,379,520,-141,4,-148,-144,1,1314,9.3527132739,12.83221874,-3.479505466,0.0987093749,-3.652246872,-3.553537497
2020,Pennsylvania,Union County,44294,-204,401,463,-62,15,-159,-144,2,8328,9.0323452563,10.428867466,-1.396522209,0.3378682764,-3.58140373,-3.243535454
2020,Pennsylvania,Venango County,50328,-547,447,723,-276,4,-274,-270,-1,1302,8.8337302254,14.288113989,-5.454383763,0.07904904,-5.414859243,-5.335810203
2020,Pennsylvania,Warren County,38911,-260,400,562,-162,3,-98,-95,-3,759,10.2456392,14.395123076,-4.149483876,0.076842294,-2.510181604,-2.43333931
2020,Pennsylvania,Washington County,206803,-63,2026,2691,-665,33,568,601,1,5316,9.7952710984,13.010402036,-3.215130938,0.1595478511,2.7461569516,2.9057048026
2020,Pennsylvania,Wayne County,51163,-108,374,664,-290,1,181,182,0,3748,7.3022629205,12.964445399,-5.662182478,0.0195247672,3.5339828573,3.5535076244
2020,Pennsylvania,Westmoreland County,347087,-1854,2801,4744,-1943,43,45,88,1,6968,8.0485267834,13.631635509,-5.583108726,0.1235582477,0.1293051429,0.2528633906
2020,Pennsylvania,Wyoming County,26557,-233,223,340,-117,3,-118,-115,-1,644,8.3603576584,12.74673365,-4.386375991,0.1124711793,-4.423866384,-4.311395205
2020,Pennsylvania,York County,450448,1107,4625,4460,165,282,643,925,17,8609,10.280187911,9.9134352609,0.3667526498,0.6268136196,1.4292239625,2.0560375821
2020,Rhode Island,Rhode Island,1057125,-1033,10447,10470,-23,1193,-2234,-1041,31,41167,9.8776381222,9.8993846213,-0.021746499,1.1279814569,-2.112246919,-0.984265462
2020,Rhode Island,Bristol County,48350,-177,310,558,-248,-4,75,71,0,2755,6.3998678737,11.519762173,-5.119894299,-0.08257894,1.5483551307,1.4657761904
2020,Rhode Island,Kent County,164646,413,1494,1788,-294,43,660,703,4,1145,9.0854083113,10.873299907,-1.787891595,0.261494349,4.0136341937,4.2751285427
2020,Rhode Island,Newport County,81836,-636,694,874,-180,39,-492,-453,-3,4071,8.4475497237,10.638556857,-2.191007133,0.4747182121,-5.98875283,-5.514034618
2020,Rhode Island,Providence County,636547,-505,7081,5904,1177,1067,-2776,-1709,27,26365,11.119669535,9.2713640636,1.8483054713,1.6755666422,-4.359299905,-2.683733263
2020,Rhode Island,Washington County,125746,-128,868,1346,-478,48,299,347,3,6831,6.8992925841,10.698672602,-3.799380017,0.3815277005,2.3765996344,2.7581273349
2020,South Carolina,South Carolina,5218040,60338,56554,55751,803,6023,53671,59694,-159,130657,10.901196271,10.74641216,0.1547841109,1.1609772101,10.345476979,11.506454189
2020,South Carolina,Abbeville County,24404,-180,232,312,-80,0,-99,-99,-1,901,9.4717073569,12.737813342,-3.266105985,0.0,-4.041806157,-4.041806157
2020,South Carolina,Aiken County,172895,1595,1845,2025,-180,183,1593,1776,-1,2341,10.720667064,11.766585802,-1.045918738,1.0633507169,9.2563808306,10.319731548
2020,South Carolina,Allendale County,8331,-296,64,111,-47,3,-250,-247,-2,946,7.5480599127,13.091166411,-5.543106498,0.3538153084,-29.48460903,-29.13079373
2020,South Carolina,Anderson County,204353,1929,2205,2414,-209,59,2083,2142,-4,2956,10.84132092,11.868910976,-1.027590055,0.290085231,10.241483663,10.531568894
2020,South Carolina,Bamberg County,13906,-202,140,205,-65,11,-146,-135,-2,999,9.9950024988,14.635539373,-4.640536874,0.7853216249,-10.42335975,-9.638038124
2020,South Carolina,Barnwell County,20805,-119,247,304,-57,-4,-58,-62,0,285,11.838289918,14.570202976,-2.731913058,-0.191713197,-2.779841357,-2.971554554
2020,South Carolina,Beaufort County,195656,3018,1875,1894,-19,279,2773,3052,-15,5537,9.6576305583,9.7554945479,-0.09786399,1.4370554271,14.282991754,15.720047181
2020,South Carolina,Berkeley County,235987,7035,2873,1833,1040,346,5675,6021,-26,3684,12.358610484,7.8849053317,4.4737051527,1.4883672912,24.411804559,25.900171851
2020,South Carolina,Calhoun County,14554,41,124,194,-70,1,110,111,0,158,8.5320122476,13.348470774,-4.816458527,0.0688065504,7.5687205422,7.6375270926
2020,South Carolina,Charleston County,417981,5366,4886,3890,996,478,3900,4378,-8,11055,11.765045823,9.3667679594,2.3982778631,1.1509807415,9.3908470544,10.541827796
2020,South Carolina,Cherokee County,57316,-15,639,723,-84,14,52,66,3,1138,11.147260722,12.612628329,-1.465367607,0.2442279344,0.9071323279,1.1513602624
2020,South Carolina,Chester County,32232,46,374,486,-112,-1,159,158,0,218,11.611661337,15.088950293,-3.477288957,-0.031047223,4.9365084293,4.9054612065
2020,South Carolina,Chesterfield County,45606,-25,475,603,-128,16,87,103,0,872,10.412442321,13.218321514,-2.805879194,0.3507348992,1.9071210145,2.2578559137
2020,South Carolina,Clarendon County,33415,-388,302,441,-139,15,-262,-247,-2,1287,8.9856883573,13.121485316,-4.135796959,0.4463090244,-7.795530959,-7.349221935
2020,South Carolina,Colleton County,37481,-224,451,614,-163,16,-79,-63,2,385,11.996914319,16.33282792,-4.335913601,0.425611151,-2.101455058,-1.675843907
2020,South Carolina,Darlington County,66509,-147,757,936,-179,35,-6,29,3,1441,11.369353809,14.057747907,-2.688394098,0.5256636504,-0.090113769,0.4355498817
2020,South Carolina,Dillon County,30367,15,404,418,-14,8,20,28,1,468,13.307202029,13.768342693,-0.461140664,0.2635089511,0.6587723777,0.9222813287
2020,South Carolina,Dorchester County,165737,2220,1835,1359,476,183,1562,1745,-1,2000,11.146409763,8.2550249959,2.8913847668,1.1116038074,9.4881155582,10.599719366
2020,South Carolina,Edgefield County,27120,-229,191,298,-107,16,-136,-120,-2,2447,7.0131634508,10.942003709,-3.928840258,0.587490132,-4.993666122,-4.40617599
2020,South Carolina,Fairfield County,22059,-263,193,326,-133,7,-137,-130,0,397,8.6974155607,14.690971362,-5.993555801,0.3154503053,-6.173813118,-5.858362813
2020,South Carolina,Florence County,137588,-540,1584,1759,-175,57,-427,-370,5,2939,11.490083999,12.759506159,-1.269422159,0.4134689318,-3.097390068,-2.683921136
2020,South Carolina,Georgetown County,63353,328,520,939,-419,13,738,751,-4,553,8.2292804127,14.860181361,-6.630900948,0.2057320103,11.67924797,11.884979981
2020,South Carolina,Greenville County,532486,7738,6276,4894,1382,1499,4849,6348,8,10465,11.872489912,9.2581207188,2.6143691936,2.8357014625,9.172992923,12.008694386
2020,South Carolina,Greenwood County,71074,111,801,883,-82,88,101,189,4,2524,11.278751311,12.433380035,-1.154628724,1.2391137521,1.4221646472,2.6612783993
2020,South Carolina,Hampton County,18053,-1263,188,272,-84,12,-1183,-1171,-8,281,10.061815944,14.55752094,-4.495704996,0.6422435709,-63.31451203,-62.67226846
2020,South Carolina,Horry County,365449,11031,3135,4357,-1222,359,11943,12302,-49,3733,8.7099422532,12.105013843,-3.39507159,0.9974064654,33.181129292,34.178535757
2020,South Carolina,Jasper County,31588,1294,372,302,70,59,1168,1227,-3,1247,12.02288226,9.7605119421,2.2623703177,1.9068549821,37.74926473,39.656119712
2020,South Carolina,Kershaw County,67472,724,741,841,-100,27,802,829,-5,400,11.041573536,12.531664432,-1.490090896,0.4023245418,11.950528982,12.352853524
2020,South Carolina,Lancaster County,100926,2646,1016,1123,-107,45,2718,2763,-10,1814,10.200495969,11.2747608,-1.074264831,0.4517936207,27.288334689,27.740128309
2020,South Carolina,Laurens County,67883,435,778,940,-162,54,543,597,0,2239,11.497735183,13.891865131,-2.394129948,0.798043316,8.0247689,8.822812216
2020,South Carolina,Lee County,16701,-155,167,299,-132,0,-23,-23,0,1657,9.9532139345,17.820424949,-7.867211014,0.0,-1.370801919,-1.370801919
2020,South Carolina,Lexington County,303946,4525,3202,2844,358,378,3798,4176,-9,2342,10.613772381,9.4270982669,1.1866741138,1.252968757,12.589352749,13.842321506
2020,South Carolina,McCormick County,9430,-32,48,184,-136,0,104,104,0,948,5.0815159856,19.479144611,-14.39762863,0.0,11.009951302,11.009951302
2020,South Carolina,Marion County,30158,-407,317,482,-165,15,-254,-239,-3,200,10.440854371,15.875368477,-5.434514105,0.4940467368,-8.365858077,-7.87181134
2020,South Carolina,Marlboro County,25581,-576,271,388,-117,3,-459,-456,-3,2451,10.475859136,14.998647029,-4.522787893,0.1159689203,-17.74324481,-17.62727589
2020,South Carolina,Newberry County,38445,37,412,497,-85,-1,120,119,3,1310,10.72176753,12.933782676,-2.212015146,-0.026023708,3.1228449117,3.0968212041
2020,South Carolina,Oconee County,80015,565,695,1045,-350,123,794,917,-2,792,8.716646286,13.106324272,-4.389677986,1.5426582636,9.9582980591,11.500956323
2020,South Carolina,Orangeburg County,85343,-888,942,1233,-291,24,-617,-593,-4,3032,10.980684719,14.372807069,-3.39212235,0.279762668,-7.192231923,-6.912469255
2020,South Carolina,Pickens County,127983,1009,1212,1369,-157,134,1031,1165,1,8297,9.507485576,10.739065803,-1.231580227,1.0511576462,8.0876383076,9.1387959538
2020,South Carolina,Richland County,419051,2024,4713,3440,1273,874,-154,720,31,28576,11.274067731,8.2288973038,3.0451704267,2.0907140243,-0.368386682,1.7223273427
2020,South Carolina,Saluda County,20315,-66,224,235,-11,8,-63,-55,0,298,11.008452919,11.549046589,-0.54059367,0.3931590328,-3.096127384,-2.702968351
2020,South Carolina,Spartanburg County,326205,5951,3942,3518,424,259,5290,5549,-22,7711,12.195669022,10.883907564,1.3117614574,0.8012882488,16.366080447,17.167368696
2020,South Carolina,Sumter County,106360,-275,1366,1200,166,74,-517,-443,2,2544,12.826592174,11.267870138,1.5587220357,0.6948519918,-4.854574051,-4.159722059
2020,South Carolina,Union County,26991,-230,280,411,-131,-1,-100,-101,2,444,10.329816277,15.162694606,-4.83287833,-0.036892201,-3.689220099,-3.7261123
2020,South Carolina,Williamsburg County,29825,-431,271,445,-174,15,-271,-256,-1,919,9.0211547744,14.813335331,-5.792180556,0.49932591,-9.021154774,-8.521828864
2020,South Carolina,York County,289105,7606,2969,2465,504,240,6899,7139,-37,3426,10.406516603,8.6399674731,1.7665491304,0.8412138716,24.181393751,25.022607623
2020,South Dakota,South Dakota,892717,5590,11686,7920,3766,1856,-21,1835,-11,34043,13.131487928,8.8996563744,4.2318315538,2.0855760392,-0.023597574,2.0619784655
2020,South Dakota,Aurora County,2730,-19,38,24,14,5,-39,-34,1,96,13.871144369,8.7607227596,5.1104216098,1.8251505749,-14.23617448,-12.41102391
2020,South Dakota,Beadle County,18513,124,287,202,85,148,-109,39,0,620,15.554712482,10.947916102,4.6067963796,8.021245461,-5.907538887,2.1137065742
2020,South Dakota,Bennett County,3399,35,46,30,16,1,18,19,0,37,13.60343043,8.8718024545,4.7316279758,0.2957267485,5.3230814727,5.6188082212
2020,South Dakota,Bon Homme County,6848,-63,71,77,-6,0,-57,-57,0,1534,10.320517479,11.192673886,-0.872156407,0.0,-8.285485864,-8.285485864
2020,South Dakota,Brookings County,35603,140,419,217,202,239,-301,-62,0,3616,11.791855458,6.1069991276,5.6848563307,6.7261418963,-8.47099879,-1.744856894
2020,South Dakota,Brown County,38738,-145,477,354,123,123,-391,-268,0,1369,12.290488399,9.1212429626,3.1692454362,3.1692454362,-10.07459322,-6.90534778
2020,South Dakota,Brule County,5254,32,65,50,15,0,18,18,-1,132,12.409316533,9.5456281023,2.8636884307,0.0,3.4364261168,3.4364261168
2020,South Dakota,Buffalo County,1956,-26,31,30,1,0,-28,-28,1,3,15.744032504,15.236160488,0.5078720163,0.0,-14.22041646,-14.22041646
2020,South Dakota,Butte County,10538,120,135,117,18,0,103,103,-1,111,12.884138194,11.166253102,1.7178850926,0.0,9.830120252,9.830120252
2020,South Dakota,Campbell County,1380,0,12,9,3,1,-4,-3,0,0,8.6956521739,6.5217391304,2.1739130435,0.7246376812,-2.898550725,-2.173913043
2020,South Dakota,Charles Mix County,9262,-24,147,112,35,0,-59,-59,0,589,15.850765581,12.076773776,3.773991805,0.0,-6.3618719,-6.3618719
2020,South Dakota,Clark County,3802,62,67,35,32,4,26,30,0,489,17.767170512,9.28135773,8.4858127818,1.0607265977,6.8947228852,7.9554494829
2020,South Dakota,Clay County,14246,150,130,88,42,27,80,107,1,2255,9.1736645261,6.2098652177,2.9637993084,1.9052995554,5.6453320161,7.5506315715
2020,South Dakota,Codington County,28186,94,309,265,44,49,0,49,1,381,10.981200469,9.4175343829,1.5636660862,1.7413554142,0.0,1.7413554142
2020,South Dakota,Corson County,4031,-45,91,66,25,0,-70,-70,0,1,22.449734797,16.282225237,6.1675095596,0.0,-17.26902677,-17.26902677
2020,South Dakota,Custer County,9017,88,69,94,-25,6,109,115,-2,252,7.6897358743,10.475872061,-2.786136186,0.6686726847,12.147553772,12.816226457
2020,South Dakota,Davison County,19812,-53,260,205,55,5,-113,-108,0,771,13.105829574,10.333442549,2.7723870252,0.2520351841,-5.695995161,-5.443959977
2020,South Dakota,Day County,5345,-69,61,81,-20,1,-49,-48,-1,139,11.339343805,15.057161446,-3.717817641,0.1858908821,-9.108653221,-8.922762339
2020,South Dakota,Deuel County,4346,12,56,41,15,3,-5,-2,-1,50,12.903225806,9.4470046083,3.4562211982,0.6912442396,-1.152073733,-0.460829493
2020,South Dakota,Dewey County,5789,-83,127,76,51,0,-134,-134,0,19,21.782008404,13.034902667,8.7471057371,0.0,-22.98259154,-22.98259154
2020,South Dakota,Douglas County,2906,-5,43,35,8,6,-18,-12,-1,178,14.784253051,12.033694344,2.7505587072,2.0629190304,-6.188757091,-4.125838061
2020,South Dakota,Edmunds County,3817,-40,39,34,5,5,-49,-44,-1,420,10.164190774,8.8610893928,1.3031013813,1.3031013813,-12.77039354,-11.46729216
2020,South Dakota,Fall River County,6708,20,46,105,-59,7,73,80,-1,199,6.867721708,15.67632129,-8.808599582,1.045088086,10.898775754,11.94386384
2020,South Dakota,Faulk County,2306,-1,31,19,12,0,-12,-12,-1,497,13.440277477,8.2375894212,5.2026880555,0.0,-5.202688055,-5.202688055
2020,South Dakota,Grant County,7000,-102,76,87,-11,7,-97,-90,-1,104,10.778612963,12.338675365,-1.560062402,0.9927669834,-13.75691391,-12.76414693
2020,South Dakota,Gregory County,4219,36,49,56,-7,0,43,43,0,44,11.66388955,13.330159486,-1.666269936,0.0,10.235658177,10.235658177
2020,South Dakota,Haakon County,1861,-5,17,13,4,0,-8,-8,-1,36,9.1226187282,6.9761202039,2.1464985243,0.0,-4.292997049,-4.292997049
2020,South Dakota,Hamlin County,6234,10,131,61,70,7,-68,-61,1,245,21.030663028,9.792904158,11.23775887,1.123775887,-10.91668004,-9.792904158
2020,South Dakota,Hand County,3127,-43,30,27,3,0,-46,-46,0,61,9.5283468318,8.5755121486,0.9528346832,0.0,-14.61013181,-14.61013181
2020,South Dakota,Hanson County,3489,26,44,13,31,0,-5,-5,0,520,12.658227848,3.7399309551,8.918296893,0.0,-1.438434983,-1.438434983
2020,South Dakota,Harding County,1311,4,16,7,9,0,-4,-4,-1,29,12.223071047,5.3475935829,6.8754774637,0.0,-3.055767762,-3.055767762
2020,South Dakota,Hughes County,17336,-151,224,195,29,3,-182,-179,-1,770,12.865060449,11.199494587,1.6655658616,0.1722999167,-10.45286161,-10.2805617
2020,South Dakota,Hutchinson County,7282,-5,112,97,15,1,-21,-20,0,832,15.375111538,13.315944814,2.0591667239,0.1372777816,-2.882833413,-2.745555632
2020,South Dakota,Hyde County,1281,-14,16,15,1,0,-15,-15,0,38,12.422360248,11.645962733,0.7763975155,0.0,-11.64596273,-11.64596273
2020,South Dakota,Jackson County,3321,-14,69,18,51,1,-66,-65,0,42,20.733173077,5.4086538462,15.324519231,0.3004807692,-19.83173077,-19.53125
2020,South Dakota,Jerauld County,1985,-29,25,26,-1,4,-31,-27,-1,176,12.503125781,13.003250813,-0.500125031,2.000500125,-15.50387597,-13.50337584
2020,South Dakota,Jones County,938,27,14,6,8,0,19,19,0,0,15.143320714,6.4899945917,8.6533261222,0.0,20.55164954,20.55164954
2020,South Dakota,Kingsbury County,4987,80,61,52,9,1,70,71,0,203,12.330705478,10.511421063,1.8192844148,0.2021427128,14.149989893,14.352132606
2020,South Dakota,Lake County,12488,-281,122,103,19,2,-300,-298,-2,879,9.6606881261,8.1561547294,1.5045333967,0.1583719365,-23.75579047,-23.59741854
2020,South Dakota,Lawrence County,26221,313,204,230,-26,80,260,340,-1,1075,7.8267375165,8.8242628863,-0.99752537,3.06930883,9.9752536976,13.044562528
2020,South Dakota,Lincoln County,63019,1784,854,292,562,5,1219,1224,-2,284,13.746036345,4.7000498978,9.0459864471,0.0804803065,19.621098717,19.701579024
2020,South Dakota,Lyman County,3797,10,68,16,52,0,-42,-42,0,37,17.932489451,4.2194092827,13.713080169,0.0,-11.07594937,-11.07594937
2020,South Dakota,McCook County,5520,-40,90,75,15,11,-67,-56,1,312,16.245487365,13.537906137,2.7075812274,1.9855595668,-12.09386282,-10.10830325
2020,South Dakota,McPherson County,2363,-25,25,30,-5,0,-20,-20,0,347,10.524100189,12.628920227,-2.104820038,0.0,-8.419280152,-8.419280152
2020,South Dakota,Marshall County,4884,-29,67,49,18,3,-49,-46,-1,373,13.677656425,10.003062162,3.6745942636,0.6124323773,-10.00306216,-9.390629785
2020,South Dakota,Meade County,28588,119,253,227,26,26,68,94,-1,820,8.8683246578,7.9569553254,0.9113693324,0.9113693324,2.3835813309,3.2949506634
2020,South Dakota,Mellette County,2089,21,31,23,8,0,14,14,-1,49,14.914601876,11.06567236,3.8489295165,0.0,6.7356266538,6.7356266538
2020,South Dakota,Miner County,2202,-19,24,23,1,-1,-19,-20,0,80,10.85236265,10.400180873,0.4521817771,-0.452181777,-8.591453764,-9.043635541
2020,South Dakota,Minnehaha County,196659,2506,2856,1532,1324,800,370,1170,12,6269,14.615723161,7.8400867937,6.7756363674,4.0940401011,1.8934935468,5.9875336479
2020,South Dakota,Moody County,6525,-30,86,54,32,0,-62,-62,0,164,13.149847095,8.2568807339,4.8929663609,0.0,-9.480122324,-9.480122324
2020,South Dakota,Oglala Lakota County,14070,-101,260,172,88,-2,-187,-189,0,92,18.412945717,12.180871782,6.2320739351,-0.141638044,-13.24315711,-13.38479516
2020,South Dakota,Pennington County,115926,1519,1499,1045,454,145,923,1068,-3,2571,13.015937794,9.0738192096,3.9421185848,1.2590466846,8.0144833784,9.273530063
2020,South Dakota,Perkins County,2832,-1,37,23,14,0,-14,-14,-1,65,13.06266549,8.1200353045,4.9426301853,0.0,-4.942630185,-4.942630185
2020,South Dakota,Potter County,2163,14,22,26,-4,2,15,17,1,63,10.204081633,12.059369202,-1.85528757,0.9276437848,6.9573283859,7.8849721707
2020,South Dakota,Roberts County,10331,-68,161,115,46,3,-118,-115,1,281,15.533043898,11.095031356,4.4380125422,0.2894356006,-11.38446696,-11.09503136
2020,South Dakota,Sanborn County,2322,-23,32,15,17,1,-40,-39,-1,174,13.713306192,6.4281122777,7.2851939147,0.4285408185,-17.14163274,-16.71309192
2020,South Dakota,Spink County,6319,-82,81,67,14,0,-97,-97,1,404,12.735849057,10.534591195,2.2012578616,0.0,-15.25157233,-15.25157233
2020,South Dakota,Stanley County,3121,-8,35,16,19,-1,-27,-28,1,0,11.2,5.12,6.08,-0.32,-8.64,-8.96
2020,South Dakota,Sully County,1391,14,16,11,5,0,9,9,0,0,11.560693642,7.9479768786,3.612716763,0.0,6.5028901734,6.5028901734
2020,South Dakota,Todd County,10313,10,230,123,107,40,-138,-98,1,28,22.312766783,11.932479627,10.380287156,3.8804811797,-13.38766007,-9.50717889
2020,South Dakota,Tripp County,5377,-53,83,74,9,1,-63,-62,0,131,15.360414546,13.694827427,1.6655871195,0.1850652355,-11.65910984,-11.4740446
2020,South Dakota,Turner County,8368,52,90,89,1,1,51,52,-1,153,10.788779669,10.668904339,0.1198753297,0.1198753297,6.1136418125,6.2335171422
2020,South Dakota,Union County,16192,189,175,134,41,60,89,149,-1,89,10.8712533,8.3242739556,2.5469793446,3.7272868458,5.5288088212,9.256095667
2020,South Dakota,Walworth County,5336,-85,65,55,10,9,-103,-94,-1,152,12.085153853,10.225899414,1.859254439,1.6733289951,-19.15032072,-17.47699173
2020,South Dakota,Yankton County,22742,-95,248,232,16,17,-128,-111,0,2293,10.882204524,10.180126813,0.7020777112,0.7459575682,-5.61662169,-4.870664122
2020,South Dakota,Ziebach County,2656,-145,31,30,1,0,-143,-143,-3,0,11.361553967,10.995052226,0.3665017409,0.0,-52.40974895,-52.40974895
2020,Tennessee,Tennessee,6886834,56509,80474,73874,6600,3280,46732,50012,-103,156810,11.733333411,10.771035023,0.9622983885,0.4782331385,6.8136558015,7.29188894
2020,Tennessee,Anderson County,77558,567,812,1000,-188,14,744,758,-3,1226,10.507994228,12.940879592,-2.432885363,0.1811723143,9.6280144161,9.8091867304
2020,Tennessee,Bedford County,50179,495,680,503,177,34,283,317,1,524,13.618657561,10.073801108,3.5448564533,0.680932878,5.6677648378,6.3486977159
2020,Tennessee,Benton County,16131,-68,170,267,-97,-1,30,29,0,234,10.516548098,16.517166718,-6.00061862,-0.061862048,1.855861429,1.7939993814
2020,Tennessee,Bledsoe County,15223,138,118,166,-48,18,168,186,0,2746,7.7867229774,10.954203511,-3.167480533,1.1878051999,11.086181866,12.273987066
2020,Tennessee,Blount County,134751,1355,1283,1541,-258,37,1579,1616,-3,2024,9.5693779904,11.493695622,-1.924317632,0.2759680325,11.77712225,12.053090283
2020,Tennessee,Bradley County,109071,838,1224,1199,25,51,759,810,3,2532,11.265324154,11.035231749,0.2300924051,0.4693885064,6.9856054191,7.4549939256
2020,Tennessee,Campbell County,39837,59,441,628,-187,9,237,246,0,683,11.078314388,15.775921623,-4.697607235,0.2260880487,5.95365195,6.1797399987
2020,Tennessee,Cannon County,14847,264,166,158,8,2,254,256,0,150,11.281005776,10.737342847,0.543662929,0.1359157322,17.261297995,17.397213727
2020,Tennessee,Carroll County,27779,69,299,408,-109,4,174,178,0,1212,10.776910739,14.70561733,-3.92870659,0.1441727189,6.2715132729,6.4156859918
2020,Tennessee,Carter County,56418,22,451,835,-384,-1,407,406,0,1045,7.9954615562,14.803127271,-6.807665715,-0.017728296,7.2154165263,7.1976882302
2020,Tennessee,Cheatham County,41101,273,466,452,14,24,233,257,2,289,11.375703353,11.033944025,0.3417593282,0.5858731341,5.6878516765,6.2737248105
2020,Tennessee,Chester County,17432,126,178,181,-3,0,130,130,-1,1140,10.248143244,10.420864759,-0.172721515,0.0,7.4845989982,7.4845989982
2020,Tennessee,Claiborne County,32023,104,330,456,-126,4,226,230,0,1263,10.32185418,14.262925776,-3.941071596,0.125113384,7.0689061962,7.1940195802
2020,Tennessee,Clay County,7629,32,65,113,-48,0,81,81,-1,76,8.538027059,14.843031656,-6.305004597,0.0,10.639695258,10.639695258
2020,Tennessee,Cocke County,36225,208,351,558,-207,1,416,417,-2,388,9.7173389441,15.448077296,-5.730738352,0.0276847263,11.516846156,11.544530882
2020,Tennessee,Coffee County,57632,915,703,685,18,13,887,900,-3,603,12.295691261,11.980865596,0.3148256653,0.2273740916,15.513909173,15.741283264
2020,Tennessee,Crockett County,14180,-9,165,185,-20,9,3,12,-1,194,11.632415665,13.042405443,-1.409989778,0.6344953999,0.2114984666,0.8459938665
2020,Tennessee,Cumberland County,61603,771,547,926,-379,25,1131,1156,-6,652,8.9353534529,15.126393597,-6.191040144,0.4083799567,18.475109242,18.883489198
2020,Tennessee,Davidson County,694176,1177,10034,5962,4072,1079,-3946,-2867,-28,25409,14.466812046,8.595887325,5.8709247211,1.5556797088,-5.689260548,-4.133580839
2020,Tennessee,Decatur County,11601,-7,106,183,-77,0,72,72,-2,216,9.1343875221,15.769744496,-6.635356974,0.0,6.2044896376,6.2044896376
2020,Tennessee,DeKalb County,20837,428,229,270,-41,40,431,471,-2,274,11.104107065,13.092178636,-1.988071571,1.9395820201,20.898996266,22.838578286
2020,Tennessee,Dickson County,54376,520,638,575,63,1,453,454,3,683,11.789489245,10.625323379,1.1641658659,0.0184788233,8.3709069406,8.3893857639
2020,Tennessee,Dyer County,36693,-429,451,499,-48,-1,-379,-380,-1,517,12.219738536,13.520287204,-1.300548669,-0.027094764,-10.26891553,-10.2960103
2020,Tennessee,Fayette County,41620,576,393,477,-84,6,656,662,-2,442,9.5083712378,11.540694861,-2.032323623,0.1451659731,15.871479725,16.016645698
2020,Tennessee,Fentress County,18787,219,188,279,-91,4,307,311,-1,261,10.065586936,14.937759336,-4.8721724,0.2141614242,16.436889305,16.651050729
2020,Tennessee,Franklin County,42485,230,405,510,-105,22,313,335,0,2200,9.5586499882,12.036818504,-2.478168515,0.519235308,7.3873023366,7.9065376446
2020,Tennessee,Gibson County,49159,45,559,703,-144,3,187,190,-1,1144,11.376471666,14.307083329,-2.930611663,0.0610544097,3.8057248685,3.8667792781
2020,Tennessee,Giles County,29530,49,304,418,-114,36,126,162,1,660,10.303163817,14.166850248,-3.863686431,1.2201115046,4.2703902662,5.4905017709
2020,Tennessee,Grainger County,23565,159,237,316,-79,11,228,239,-1,151,10.09133295,13.4551106,-3.36377765,0.4683741032,9.7081177748,10.176491878
2020,Tennessee,Greene County,69571,444,652,1022,-370,9,809,818,-4,1688,9.4017217263,14.737054608,-5.335332882,0.1297783674,11.665633246,11.795411614
2020,Tennessee,Grundy County,13485,76,157,191,-34,0,110,110,0,195,11.675466647,14.203911653,-2.528445006,0.0,8.1802632557,8.1802632557
2020,Tennessee,Hamblen County,65110,237,778,821,-43,14,264,278,2,1002,11.970796181,12.632421163,-0.661624982,0.2154127847,4.0620696553,4.27748244
2020,Tennessee,Hamilton County,371662,3886,4290,4042,248,119,3520,3639,-1,9945,11.603406912,10.932627211,0.6707797003,0.3218660659,9.5207441327,9.8426101986
2020,Tennessee,Hancock County,6493,-112,70,100,-30,1,-83,-82,0,155,10.688654756,15.269506795,-4.580852038,0.1526950679,-12.67369064,-12.52099557
2020,Tennessee,Hardeman County,24836,-213,216,306,-90,0,-123,-123,0,3814,8.659917811,12.268216899,-3.608299088,0.0,-4.931342087,-4.931342087
2020,Tennessee,Hardin County,25583,-44,227,397,-170,-1,127,126,0,371,8.8654559656,15.504784222,-6.639328256,-0.039054872,4.9599687561,4.920913884
2020,Tennessee,Hawkins County,56775,-80,527,842,-315,19,215,234,1,580,9.2757194403,14.820029922,-5.544310481,0.3344187274,3.7842119159,4.1186306433
2020,Tennessee,Haywood County,17002,-242,186,231,-45,-1,-195,-196,-1,196,10.862582491,13.490626643,-2.628044151,-0.058400981,-11.38819132,-11.4465923
2020,Tennessee,Henderson County,28076,26,299,364,-65,-2,94,92,-1,367,10.654598582,12.970815665,-2.316217083,-0.071268218,3.3496062431,3.2783380252
2020,Tennessee,Henry County,32056,-253,305,525,-220,-2,-31,-33,0,497,9.4772003418,16.313213703,-6.836013361,-0.062145576,-0.963256428,-1.025402004
2020,Tennessee,Hickman County,25387,232,269,291,-22,0,253,253,1,1477,10.644612402,11.515175498,-0.870563096,0.0,10.011475604,10.011475604
2020,Tennessee,Houston County,8292,86,80,110,-30,0,117,117,-1,181,9.6981452297,13.334949691,-3.636804461,0.0,14.183537398,14.183537398
2020,Tennessee,Humphreys County,18590,-6,207,257,-50,3,41,44,0,254,11.13322218,13.822406282,-2.689184102,0.1613510461,2.2051309633,2.3664820094
2020,Tennessee,Jackson County,11864,26,89,179,-90,1,116,117,-1,185,7.5099147751,15.104210615,-7.59429584,0.0843810649,9.7882035271,9.872584592
2020,Tennessee,Jefferson County,55307,744,485,724,-239,-8,995,987,-4,1453,8.8286156367,13.179211796,-4.350596159,-0.14562665,18.112314554,17.966687904
2020,Tennessee,Johnson County,17849,76,149,257,-108,-1,184,183,1,1634,8.3656167537,14.429285273,-6.063668519,-0.056145079,10.330694515,10.274549436
2020,Tennessee,Knox County,475609,5472,5136,4888,248,238,4983,5221,3,12376,10.86126719,10.336813478,0.5244537117,0.5033063846,10.537713086,11.04101947
2020,Tennessee,Lake County,6988,-22,65,97,-32,1,7,8,2,2225,9.2870410059,13.859122732,-4.572081726,0.1428775539,1.0001428776,1.1430204315
2020,Tennessee,Lauderdale County,25451,-157,278,295,-17,0,-142,-142,2,2153,10.889363286,11.555259602,-0.665896316,0.0,-5.562192757,-5.562192757
2020,Tennessee,Lawrence County,44432,269,555,555,0,0,269,269,0,535,12.528923754,12.528923754,0.0,0.0,6.0725774592,6.0725774592
2020,Tennessee,Lewis County,12363,96,139,167,-28,0,124,124,0,210,11.287048315,13.560698335,-2.27365002,0.0,10.069021518,10.069021518
2020,Tennessee,Lincoln County,34540,104,375,443,-68,21,150,171,1,287,10.873347251,12.845047553,-1.971700302,0.6089074461,4.3493389005,4.9582463466
2020,Tennessee,Loudon County,54910,871,490,689,-199,50,1024,1074,-4,481,8.9950343739,12.648119762,-3.653085389,0.9178606504,18.79778612,19.715646771
2020,Tennessee,McMinn County,54208,398,582,727,-145,23,522,545,-2,1066,10.775981781,13.46071951,-2.684737729,0.4258549501,9.665055824,10.090910774
2020,Tennessee,McNairy County,25696,34,256,384,-128,3,159,162,0,317,9.9692355621,14.953853343,-4.984617781,0.1168269792,6.1918298999,6.3086568792
2020,Tennessee,Macon County,24827,203,329,278,51,4,147,151,1,339,13.306100989,11.243453115,2.0626478737,0.1617763038,5.9452791652,6.1070554691
2020,Tennessee,Madison County,98360,314,1217,1049,168,39,103,142,4,4563,12.392696761,10.681954726,1.7107420344,0.3971365437,1.0488477949,1.4459843386
2020,Tennessee,Marion County,28924,46,307,371,-64,2,107,109,1,276,10.622469811,12.836926058,-2.214456247,0.0692017577,3.7022940383,3.771495796
2020,Tennessee,Marshall County,35016,509,425,388,37,32,442,474,-2,384,12.226169757,11.161773801,1.0643959553,0.920558664,12.715216547,13.635775211
2020,Tennessee,Maury County,99590,2795,1207,1084,123,16,2668,2684,-12,1010,12.292181175,11.03953968,1.252641495,0.1629452351,27.171117957,27.334063192
2020,Tennessee,Meigs County,12532,174,130,184,-54,0,229,229,-1,148,10.445962234,14.785054239,-4.339092005,0.0,18.400964243,18.400964243
2020,Tennessee,Monroe County,47177,527,507,631,-124,-14,669,655,-4,514,10.807123749,13.450286165,-2.643162416,-0.298421563,14.26028755,13.961865987
2020,Tennessee,Montgomery County,214251,4444,3482,1483,1999,-8,2445,2437,8,3706,16.422281858,6.9943262478,9.4279556098,-0.037730688,11.531441454,11.493710766
2020,Tennessee,Moore County,6438,-1,57,63,-6,4,0,4,1,104,8.8529937097,9.7848877844,-0.931894075,0.6212627165,0.0,0.6212627165
2020,Tennessee,Morgan County,21431,46,188,263,-75,1,121,122,-1,2265,8.7817638266,12.285127055,-3.503363229,0.0467115097,5.6520926756,5.6988041854
2020,Tennessee,Obion County,30131,-118,347,442,-95,12,-34,-22,-1,461,11.493872143,14.640609473,-3.14673733,0.3974826101,-1.126200729,-0.728718119
2020,Tennessee,Overton County,22566,295,241,337,-96,-1,393,392,-1,286,10.750050182,15.032227848,-4.282177666,-0.044606017,17.530164819,17.485558802
2020,Tennessee,Perry County,8099,15,106,106,0,4,9,13,2,129,13.100166842,13.100166842,0.0,0.4943459186,1.1122783168,1.6066242353
2020,Tennessee,Pickett County,5061,-7,41,63,-22,0,15,15,0,65,8.0955671833,12.439530062,-4.343962879,0.0,2.961792872,2.961792872
2020,Tennessee,Polk County,16835,71,162,262,-100,1,171,172,-1,277,9.6431441412,15.595702253,-5.952558112,0.0595255811,10.178874371,10.238399952
2020,Tennessee,Putnam County,80929,972,909,842,67,45,861,906,-1,2496,11.299926656,10.467038773,0.8328878833,0.5594023097,10.703230859,11.262633169
2020,Tennessee,Rhea County,33443,237,376,425,-49,21,264,285,1,826,11.282989992,12.753379646,-1.470389653,0.6301669943,7.9220993563,8.5522663506
2020,Tennessee,Roane County,53841,365,463,803,-340,-15,725,710,-5,730,8.6286422468,14.965010203,-6.336367957,-0.279545645,13.511372849,13.231827204
2020,Tennessee,Robertson County,72275,582,891,725,166,32,383,415,1,913,12.377750611,10.071682596,2.3060680151,0.4445432318,5.320626806,5.7651700378
2020,Tennessee,Rutherford County,339261,7136,4254,2322,1932,132,5081,5213,-9,5136,12.672292839,6.9170343141,5.7552585249,0.393216421,15.135853295,15.529069715
2020,Tennessee,Scott County,22090,-12,251,292,-41,1,25,26,3,314,11.359522085,13.21506155,-1.855539464,0.0452570601,1.1314265025,1.1766835626
2020,Tennessee,Sequatchie County,15176,105,173,183,-10,-2,117,115,0,188,11.43915099,12.100373591,-0.661222601,-0.13224452,7.7363044269,7.6040599068
2020,Tennessee,Sevier County,99244,842,1041,1146,-105,101,849,950,-3,1180,10.533985003,11.596490695,-1.062505692,1.0220292847,8.5911174524,9.6131467371
2020,Tennessee,Shelby County,936017,-1053,12832,9204,3628,521,-5241,-4720,39,17362,13.701445795,9.8276268,3.8738189951,0.5563009086,-5.596109524,-5.039808615
2020,Tennessee,Smith County,20285,170,216,241,-25,-3,198,195,0,236,10.693069307,11.930693069,-1.237623762,-0.148514851,9.801980198,9.6534653465
2020,Tennessee,Stewart County,13859,160,143,192,-49,-3,214,211,-2,153,10.378111619,13.934247768,-3.556136149,-0.217722621,15.530880325,15.313157704
2020,Tennessee,Sullivan County,158755,286,1491,2144,-653,10,931,941,-2,2710,9.4002975815,13.51726225,-4.116964668,0.0630469321,5.8696693819,5.932716314
2020,Tennessee,Sumner County,195561,4064,2156,1857,299,57,3725,3782,-17,1435,11.140449235,9.5954611454,1.5449880896,0.294529502,19.247761317,19.542290819
2020,Tennessee,Tipton County,61918,203,688,651,37,-2,164,162,4,1024,11.129714558,10.531168863,0.5985456957,-0.032353821,2.653013354,2.6206595326
2020,Tennessee,Trousdale County,11455,178,124,82,42,-2,138,136,0,2612,10.909730776,7.2144993841,3.6952313919,-0.1759634,12.141474573,11.965511174
2020,Tennessee,Unicoi County,17755,-159,155,295,-140,22,-41,-19,0,453,8.6910202136,16.540973955,-7.849953741,1.2335641594,-2.298915024,-1.065350865
2020,Tennessee,Union County,20187,251,210,235,-25,-1,278,277,-1,171,10.46781148,11.713979513,-1.246168033,-0.049846721,13.85738853,13.807541809
2020,Tennessee,Van Buren County,5947,73,68,67,1,0,73,73,-1,136,11.50494882,11.335758396,0.1691904238,0.0,12.350900939,12.350900939
2020,Tennessee,Warren County,41605,336,496,508,-12,25,323,348,0,542,11.969978522,12.259574776,-0.289596255,0.6033255303,7.7949658518,8.3982913821
2020,Tennessee,Washington County,130367,697,1231,1500,-269,82,881,963,3,4046,9.4678834166,11.53681976,-2.068936344,0.6306794802,6.7759588059,7.4066382861
2020,Tennessee,Wayne County,16524,-120,123,217,-94,1,-28,-27,1,2235,7.4167872648,13.08490111,-5.668113845,0.0602990835,-1.688374337,-1.628075253
2020,Tennessee,Weakley County,33334,65,318,400,-82,19,127,146,1,1638,9.549119409,12.011470955,-2.462351546,0.5705448704,3.8136420281,4.3841868985
2020,Tennessee,White County,27707,329,285,369,-84,1,414,415,-2,392,10.347644549,13.397476627,-3.049832078,0.0363075247,15.03131524,15.067622765
2020,Tennessee,Williamson County,245348,6792,2310,1501,809,159,5860,6019,-36,1181,9.5473482344,6.2037098267,3.3436384076,0.6571551382,24.219679937,24.876835075
2020,Tennessee,Wilson County,148130,3623,1669,1312,357,56,3227,3283,-17,1592,11.406623223,8.9667403643,2.4398828583,0.3827267229,22.054627405,22.437354128
2020,Texas,Texas,29360759,373965,378318,220988,157330,54650,162299,216949,-314,590686,12.967741766,7.5748849313,5.392856835,1.8732576497,5.5631810301,7.4364386798
2020,Texas,Anderson County,57805,-11,578,688,-110,40,55,95,4,14250,9.998183721,11.900952249,-1.902768528,0.6919158284,0.9513842641,1.6433000925
2020,Texas,Andrews County,18879,58,325,117,208,21,-171,-150,0,77,17.24137931,6.2068965517,11.034482759,1.1140583554,-9.071618037,-7.957559682
2020,Texas,Angelina County,86796,35,1101,993,108,-9,-68,-77,4,2608,12.687474432,11.442926531,1.2445479007,-0.103712325,-0.783604234,-0.887316559
2020,Texas,Aransas County,23814,450,219,376,-157,1,611,612,-5,437,9.2839882996,15.93963288,-6.65564458,0.0423926406,25.90190343,25.94429607
2020,Texas,Archer County,8730,38,73,65,8,3,27,30,0,53,8.3802089312,7.4618298703,0.918379061,0.3443921479,3.0995293307,3.4439214786
2020,Texas,Armstrong County,1869,16,16,27,-11,0,28,28,-1,51,8.5975282106,14.508328855,-5.910800645,0.0,15.045674369,15.045674369
2020,Texas,Atascosa County,51724,584,701,464,237,0,346,346,1,304,13.629646912,9.0216207808,4.6080261316,0.0,6.7273292892,6.7273292892
2020,Texas,Austin County,29972,-135,332,324,8,6,-149,-143,0,208,11.052114716,10.785798698,0.2663160172,0.1997370129,-4.960135821,-4.760398808
2020,Texas,Bailey County,6697,-162,117,45,72,-1,-231,-232,-2,92,17.261729124,6.639126586,10.622602538,-0.147536146,-34.08084981,-34.22838595
2020,Texas,Bandera County,23861,680,170,246,-76,10,752,762,-6,303,7.2275838612,10.458738999,-3.231155138,0.4251519918,31.971429786,32.396581778
2020,Texas,Bastrop County,91601,2864,1095,803,292,-21,2609,2588,-16,2286,12.14386319,8.9054996728,3.2383635174,-0.232896006,28.934556222,28.701660216
2020,Texas,Baylor County,3518,-7,38,45,-7,0,0,0,0,64,10.790856169,12.778645464,-1.987789294,0.0,0.0,0.0
2020,Texas,Bee County,32513,-105,307,210,97,2,-205,-203,1,7753,9.427154504,6.4485421689,2.9786123351,0.0614146873,-6.295005451,-6.233590763
2020,Texas,Bell County,369927,6234,5939,2527,3412,337,2462,2799,23,10413,16.19094354,6.8891251602,9.3018183801,0.9187317685,6.7119217033,7.6306534718
2020,Texas,Bexar County,2026823,24378,26476,15038,11438,2056,10790,12846,94,42211,13.141841148,7.4643831088,5.6774580395,1.0205327618,5.3558115271,6.3763442888
2020,Texas,Blanco County,12269,298,83,145,-62,5,358,363,-3,53,6.8481848185,11.96369637,-5.115511551,0.4125412541,29.537953795,29.95049505
2020,Texas,Borden County,706,50,4,7,-3,0,54,54,-1,0,5.8737151248,10.279001468,-4.405286344,0.0,79.295154185,79.295154185
2020,Texas,Bosque County,18603,9,159,267,-108,8,109,117,0,298,8.5490765384,14.355996451,-5.806919913,0.4301422158,5.8606876899,6.2908299056
2020,Texas,Bowie County,93481,-24,1098,1068,30,39,-98,-59,5,5825,11.744194753,11.423315115,0.320879638,0.4171435295,-1.048206818,-0.631063288
2020,Texas,Brazoria County,380518,5819,4721,2816,1905,271,3647,3918,-4,10301,12.502366869,7.4574592468,5.0449076226,0.7176745227,9.6581512334,10.375825756
2020,Texas,Brazos County,232555,3137,2587,1262,1325,810,977,1787,25,14468,11.199788732,5.46352276,5.7362659723,3.5066984434,4.2296844188,7.7363828622
2020,Texas,Brewster County,9237,93,88,79,9,3,82,85,-1,44,9.5751047277,8.5958326533,0.9792720744,0.3264240248,8.9222566781,9.2486807029
2020,Texas,Briscoe County,1487,-55,20,12,8,1,-64,-63,0,0,13.205678442,7.923407065,5.2822713767,0.6602839221,-42.25817101,-41.59788709
2020,Texas,Brooks County,6964,-129,108,75,33,29,-190,-161,-1,54,15.366009817,10.670840151,4.6951696664,4.1260581916,-27.03279505,-22.90673686
2020,Texas,Brown County,37633,-137,383,475,-92,17,-61,-44,-1,1579,10.158746999,12.598968211,-2.440221211,0.4509104412,-1.61797276,-1.167062318
2020,Texas,Burleson County,18514,89,193,235,-42,24,107,131,0,160,10.449660251,12.72367958,-2.274019329,1.2994396167,5.7933349576,7.0927745743
2020,Texas,Burnet County,49653,1373,477,517,-40,-21,1445,1424,-11,1140,9.7413537827,10.558238796,-0.816885013,-0.428864632,29.509971103,29.081106471
2020,Texas,Caldwell County,43979,400,565,385,180,23,195,218,2,3361,12.905731058,8.7941707211,4.1115603371,0.5253660431,4.4541903652,4.9795564083
2020,Texas,Calhoun County,21001,-236,268,237,31,16,-282,-266,-1,249,12.689994791,11.22212226,1.4678725318,0.7576116293,-13.35290497,-12.59529334
2020,Texas,Callahan County,14110,169,121,198,-77,2,245,247,-1,77,8.6271434173,14.117143774,-5.490000356,0.1425974119,17.468182952,17.610780364
2020,Texas,Cameron County,424180,1531,6223,3006,3217,12,-1712,-1700,14,3427,14.697182076,7.0994262124,7.5977558633,0.0283410228,-4.043319253,-4.014978231
2020,Texas,Camp County,13060,-18,183,138,45,22,-86,-64,1,67,14.002601576,10.559338894,3.4432626827,1.6833728671,-6.580457571,-4.897084704
2020,Texas,Carson County,5854,-13,43,73,-30,2,15,17,0,25,7.3372579131,12.456275062,-5.119017149,0.3412678099,2.5595085744,2.9007763843
2020,Texas,Cass County,29879,-123,308,489,-181,2,56,58,0,358,10.287069354,16.332392579,-6.045323224,0.0667991517,1.8703762462,1.9371753979
2020,Texas,Castro County,7396,-88,104,56,48,23,-157,-134,-2,45,13.978494624,7.5268817204,6.4516129032,3.0913978495,-21.10215054,-18.01075269
2020,Texas,Chambers County,45590,1864,604,320,284,24,1570,1594,-14,224,13.525012316,7.1655694388,6.359442877,0.5374177079,35.156075059,35.693492767
2020,Texas,Cherokee County,52875,314,699,578,121,6,185,191,2,2779,13.259228347,10.963997117,2.2952312303,0.1138131189,3.5092378315,3.6230509503
2020,Texas,Childress County,7143,-79,53,78,-25,-4,-50,-54,0,1729,7.3790462931,10.859728507,-3.480682214,-0.556909154,-6.961364427,-7.518273582
2020,Texas,Clay County,10550,85,77,147,-70,10,145,155,0,68,7.3280989769,13.990007138,-6.661908161,0.9517011658,13.799666905,14.75136807
2020,Texas,Cochran County,2897,72,39,18,21,12,40,52,-1,78,13.631597344,6.2915064663,7.3400908773,4.1943376442,13.981125481,18.175463125
2020,Texas,Coke County,3323,7,34,65,-31,-1,40,39,-1,36,10.242506402,19.581262238,-9.338755837,-0.301250188,12.050007531,11.748757343
2020,Texas,Coleman County,8100,-25,74,125,-51,1,26,27,-1,16,9.1217257319,15.408320493,-6.286594761,0.1232665639,3.2049306626,3.3281972265
2020,Texas,Collin County,1072069,36997,11413,5752,5661,3444,28051,31495,-159,3940,10.832687514,5.4595302355,5.373157278,3.268884237,26.624701432,29.893585669
2020,Texas,Collingsworth County,2877,-44,35,32,3,0,-47,-47,0,54,12.073128665,11.038289065,1.0348395999,0.0,-16.21248706,-16.21248706
2020,Texas,Colorado County,21610,143,259,293,-34,52,127,179,-2,319,12.024978527,13.603547137,-1.57856861,2.4142814031,5.8964180421,8.3106994452
2020,Texas,Comal County,164812,8377,1626,1318,308,54,8070,8124,-55,1155,10.123051733,8.2055240983,1.9175276345,0.3361899099,50.24171432,50.577904229
2020,Texas,Comanche County,13750,121,154,205,-51,11,161,172,0,148,11.24949779,14.974980825,-3.725483034,0.8035355564,11.760838599,12.564374155
2020,Texas,Concho County,2827,78,29,38,-9,27,60,87,0,40,10.401721664,13.629842181,-3.228120516,9.6843615495,21.520803443,31.205164993
2020,Texas,Cooke County,41393,319,541,471,70,13,236,249,0,607,13.120399675,11.422750919,1.6976487565,0.3152776262,5.7235015218,6.038779148
2020,Texas,Coryell County,76737,194,895,508,387,61,-259,-198,5,12772,11.677974948,6.6283924843,5.0495824635,0.7959290188,-3.379436326,-2.583507307
2020,Texas,Cottle County,1363,-22,14,11,3,0,-25,-25,0,0,10.18922853,8.0058224163,2.1834061135,0.0,-18.19505095,-18.19505095
2020,Texas,Crane County,4765,6,56,32,24,5,-23,-18,0,87,11.759764805,6.7198656027,5.039899202,1.0499790004,-4.829903402,-3.779924402
2020,Texas,Crockett County,3513,45,35,21,14,0,30,30,1,26,10.027216731,6.0163300387,4.0108866925,0.0,8.5947571981,8.5947571981
2020,Texas,Crosby County,5567,-134,73,63,10,1,-144,-143,-1,63,12.957046503,11.182108626,1.7749378772,0.1774937877,-25.55910543,-25.38161164
2020,Texas,Culberson County,2149,3,23,21,2,0,2,2,-1,12,10.710128056,9.7788125728,0.9313154831,0.0,0.9313154831,0.9313154831
2020,Texas,Dallam County,7273,18,151,51,100,40,-121,-81,-1,39,20.787444934,7.0209251101,13.766519824,5.5066079295,-16.65748899,-11.15088106
2020,Texas,Dallas County,2635888,285,37726,18457,19269,7924,-26911,-18987,3,30844,14.313218025,7.0025728964,7.3106451287,3.0063600602,-10.21001459,-7.203654526
2020,Texas,Dawson County,12974,-11,196,128,68,8,-86,-78,-1,1602,15.100735776,9.8617049963,5.2390307793,0.6163565623,-6.625833044,-6.009476482
2020,Texas,Deaf Smith County,18277,-282,314,169,145,1,-427,-426,-1,359,17.048539472,9.1758062765,7.8727331958,0.0542947117,-23.18384189,-23.12954718
2020,Texas,Delta County,5349,22,75,51,24,0,-2,-2,0,54,14.05020607,9.5541401274,4.4960659423,0.0,-0.374672162,-0.374672162
2020,Texas,Denton County,919324,30559,10151,5077,5074,1395,24196,25591,-106,11790,11.228429574,5.6158739974,5.6125555766,1.5430656345,26.764169242,28.307234876
2020,Texas,DeWitt County,20174,69,226,221,5,-5,68,63,1,1793,11.221728444,10.973460116,0.2482683284,-0.248268328,3.3764492664,3.128180938
2020,Texas,Dickens County,2140,-45,16,21,-5,1,-41,-40,0,315,7.3988439306,9.710982659,-2.312138728,0.4624277457,-18.95953757,-18.49710983
2020,Texas,Dimmit County,9925,-179,131,81,50,-6,-222,-228,-1,87,13.081032503,8.0882720056,4.9927604973,-0.59913126,-22.16785661,-22.76698787
2020,Texas,Donley County,3308,45,28,43,-15,1,59,60,0,224,8.5222949323,13.087810075,-4.565515142,0.3043676762,17.957692893,18.262060569
2020,Texas,Duval County,11058,-81,149,153,-4,3,-80,-77,0,601,13.425237645,13.785646709,-0.360409064,0.2703067982,-7.208181286,-6.937874488
2020,Texas,Eastland County,18388,121,189,270,-81,-3,207,204,-2,779,10.312372118,14.731960169,-4.419588051,-0.163688446,11.294502796,11.13081435
2020,Texas,Ector County,167701,1497,3059,1324,1735,186,-442,-256,18,2505,18.322576781,7.9303993651,10.392177416,1.1140893368,-2.647459607,-1.53337027
2020,Texas,Edwards County,1923,8,22,9,13,-1,-3,-4,-1,5,11.464304325,4.6899426785,6.7743616467,-0.521104742,-1.563314226,-2.084418968
2020,Texas,Ellis County,191760,6995,2262,1546,716,45,6279,6324,-45,1489,12.015138437,8.2119381183,3.8032003187,0.239027953,33.352367041,33.591394994
2020,Texas,El Paso County,841286,3785,11572,5844,5728,289,-2283,-1994,51,16662,13.786144401,6.9621697094,6.8239746913,0.3442962091,-2.719820918,-2.375524709
2020,Texas,Erath County,43224,688,478,387,91,1,597,598,-1,3518,11.14738806,9.0251865672,2.1222014925,0.0233208955,13.922574627,13.945895522
2020,Texas,Falls County,17275,-7,201,186,15,-1,-22,-23,1,1936,11.63295425,10.764823335,0.8681309141,-0.057875394,-1.273258674,-1.331134068
2020,Texas,Fannin County,35913,359,303,483,-180,40,502,542,-3,2996,8.4794380623,13.516728,-5.037289938,1.119397764,14.048441938,15.167839702
2020,Texas,Fayette County,25547,239,242,323,-81,14,307,321,-1,420,9.5172549405,12.702782421,-3.18552748,0.5505849966,12.073542425,12.624127421
2020,Texas,Fisher County,3784,-26,32,68,-36,4,7,11,-1,22,8.4277060838,17.908875428,-9.481169344,1.0534632605,1.8435607058,2.8970239663
2020,Texas,Floyd County,5672,-82,62,54,8,0,-90,-90,0,34,10.852441799,9.4521267285,1.4003150709,0.0,-15.75354455,-15.75354455
2020,Texas,Foard County,1135,-21,8,10,-2,0,-19,-19,0,37,6.9838498472,8.729812309,-1.745962462,0.0,-16.58664339,-16.58664339
2020,Texas,Fort Bend County,839706,26969,9482,4331,5151,3526,18398,21924,-106,5055,11.476341393,5.2419357279,6.2344056648,4.2676207288,22.267636463,26.535257192
2020,Texas,Franklin County,10821,72,134,144,-10,2,82,84,-2,56,12.424663885,13.351877608,-0.927213723,0.1854427446,7.6031525267,7.7885952712
2020,Texas,Freestone County,19874,121,230,223,7,17,98,115,-1,1577,11.608246902,11.254952431,0.3532944709,0.858000858,4.9461225932,5.8041234512
2020,Texas,Frio County,20379,180,255,163,92,177,-91,86,2,3397,12.568386811,8.0339100005,4.5344768101,8.7239390803,-4.485189019,4.2387500616
2020,Texas,Gaines County,21996,456,449,159,290,82,83,165,1,63,20.626607865,7.3042998897,13.322307975,3.7669974274,3.8129364204,7.5799338479
2020,Texas,Galveston County,345089,3548,3930,3265,665,281,2598,2879,4,4845,11.447213201,9.510216565,1.9369966357,0.8184903077,7.5673943754,8.3858846832
2020,Texas,Garza County,6222,-16,45,38,7,45,-68,-23,0,1854,7.2231139647,6.0995184591,1.1235955056,7.2231139647,-10.91492777,-3.691813804
2020,Texas,Gillespie County,26960,33,235,405,-170,26,178,204,-1,246,8.7219552026,15.031454711,-6.309499508,0.9649822777,6.6064171321,7.5713994099
2020,Texas,Glasscock County,1439,9,25,14,11,12,-13,-1,-1,0,17.427675148,9.759498083,7.6681770652,8.3652840711,-9.062391077,-0.697107006
2020,Texas,Goliad County,7626,19,72,73,-1,0,19,19,1,93,9.4531609007,9.5844548021,-0.131293901,0.0,2.4945841266,2.4945841266
2020,Texas,Gonzales County,20948,49,276,216,60,-2,-8,-10,-1,313,13.190909743,10.323320668,2.8675890745,-0.095586302,-0.38234521,-0.477931512
2020,Texas,Gray County,21658,-191,243,251,-8,0,-182,-182,-1,1950,11.170616223,11.538373135,-0.367756913,0.0,-8.366469763,-8.366469763
2020,Texas,Grayson County,138318,2175,1676,1545,131,48,2003,2051,-7,2234,12.213028445,11.258430159,0.9545982854,0.349776471,14.595880653,14.945657124
2020,Texas,Gregg County,124229,131,1625,1385,240,68,-184,-116,7,3995,13.087582099,11.154646897,1.9329352024,0.547664974,-1.481916988,-0.934252014
2020,Texas,Grimes County,29614,674,319,258,61,-8,625,617,-4,2940,10.895925129,8.8123783175,2.0835468115,-0.273252041,21.347815691,21.074563651
2020,Texas,Guadalupe County,170608,3638,1874,1246,628,20,3004,3024,-14,1871,11.102619247,7.381997642,3.7206216045,0.1184911339,17.797368312,17.915859446
2020,Texas,Hale County,32754,-344,428,318,110,-10,-443,-453,-1,2522,12.998845897,9.6580210168,3.34082488,-0.303711353,-13.45441293,-13.75812428
2020,Texas,Hall County,2939,-53,26,32,-6,1,-48,-47,0,42,8.7674928343,10.790760411,-2.023267577,0.3372112629,-16.18614062,-15.84892935
2020,Texas,Hamilton County,8557,92,80,121,-41,9,125,134,-1,178,9.399600517,14.216895782,-4.817295265,1.0574550582,14.686875808,15.744330866
2020,Texas,Hansford County,5279,-101,64,41,23,17,-140,-123,-1,61,12.008631204,7.6930293649,4.3156018388,3.1897926635,-26.26888076,-23.07908809
2020,Texas,Hardeman County,4011,84,38,44,-6,8,82,90,0,21,9.5742000504,11.085915848,-1.511715797,2.0156210632,20.660115898,22.675736961
2020,Texas,Hardin County,58305,509,671,614,57,23,428,451,1,404,11.558901301,10.576997614,0.9819036873,0.396206751,7.372890845,7.7690975961
2020,Texas,Harris County,4738253,29010,66344,31172,35172,19679,-26091,-6412,250,47049,14.044779696,6.5989972369,7.4457824592,4.1659715971,-5.523368308,-1.357396711
2020,Texas,Harrison County,66386,-98,709,755,-46,47,-102,-55,3,1054,10.672085497,11.364491608,-0.692406111,0.707458418,-1.53533529,-0.827876872
2020,Texas,Hartley County,5443,-64,71,25,46,6,-116,-110,0,1125,12.96803653,4.5662100457,8.401826484,1.095890411,-21.18721461,-20.0913242
2020,Texas,Haskell County,5754,89,37,58,-21,25,86,111,-1,531,6.4804273579,10.15850775,-3.678080392,4.3786671337,15.06261494,19.441282074
2020,Texas,Hays County,241365,10965,2642,1277,1365,264,9392,9656,-56,7477,11.20049177,5.4137123356,5.7867794347,1.1192012973,39.81643403,40.935635327
2020,Texas,Hemphill County,3777,-54,43,32,11,5,-69,-64,-1,37,11.303890641,8.4121976866,2.8916929548,1.3144058885,-18.13880126,-16.82439537
2020,Texas,Henderson County,83792,970,903,1222,-319,11,1286,1297,-8,1216,10.839425258,14.668635289,-3.82921003,0.1320417252,15.436878053,15.568919779
2020,Texas,Hidalgo County,875200,7979,14081,5110,8971,211,-1271,-1060,68,7029,16.162569207,5.8654022191,10.297166988,0.242191755,-1.458889671,-1.216697916
2020,Texas,Hill County,37006,470,419,434,-15,4,484,488,-3,652,11.394849202,11.802779364,-0.407930162,0.1087813766,13.162546572,13.271327949
2020,Texas,Hockley County,22921,-134,302,241,61,14,-209,-195,0,798,13.13728902,10.483730642,2.6535583783,0.6090133983,-9.091700017,-8.482686619
2020,Texas,Hood County,63527,1765,575,747,-172,1,1949,1950,-13,673,9.1787786637,11.924430716,-2.745652052,0.0159630933,31.112068897,31.12803199
2020,Texas,Hopkins County,37170,107,471,432,39,-1,69,68,0,413,12.68977409,11.639028464,1.0507456253,-0.026942196,1.8590114908,1.8320692953
2020,Texas,Houston County,22835,-42,191,327,-136,-1,97,96,-2,2661,8.3566678334,14.306965348,-5.950297515,-0.043752188,4.2439621981,4.2002100105
2020,Texas,Howard County,36540,-192,454,351,103,73,-370,-297,2,5820,12.392182553,9.5807402555,2.8114422972,1.9925756087,-10.09935582,-8.106780216
2020,Texas,Hudspeth County,4906,31,39,19,20,59,-46,13,-2,86,7.9746447194,3.8850833248,4.0895613945,12.064206114,-9.405991207,2.6582149065
2020,Texas,Hunt County,99807,1248,1187,1093,94,59,1097,1156,-2,2658,11.967776736,11.020033675,0.9477430608,0.5948600063,11.060363167,11.655223173
2020,Texas,Hutchinson County,20677,-222,235,229,6,-1,-225,-226,-2,229,11.304598807,11.015970752,0.2886280546,-0.048104676,-10.82355205,-10.87165673
2020,Texas,Irion County,1564,-1,14,10,4,0,-4,-4,-1,0,8.9485458613,6.3918184724,2.5567273889,0.0,-2.556727389,-2.556727389
2020,Texas,Jack County,9056,111,80,76,4,2,107,109,-2,1126,8.8883950892,8.4439753347,0.4444197545,0.2222098772,11.888228432,12.110438309
2020,Texas,Jackson County,14854,94,215,141,74,6,13,19,1,222,14.520159384,9.522523131,4.9976362531,0.4052137503,0.8779631255,1.2831768758
2020,Texas,Jasper County,35375,-235,374,455,-81,0,-154,-154,0,931,10.537437487,12.819609777,-2.28217229,0.0,-4.338944848,-4.338944848
2020,Texas,Jeff Davis County,2220,-55,17,31,-14,3,-44,-41,0,87,7.5639599555,13.793103448,-6.229143493,1.3348164627,-19.57730812,-18.24249166
2020,Texas,Jefferson County,250127,-1188,3346,2718,628,273,-2094,-1821,5,15585,13.345511545,10.840735319,2.5047762254,1.0888597285,-8.351913083,-7.263053354
2020,Texas,Jim Hogg County,5184,23,49,61,-12,9,26,35,0,17,9.4731754471,11.793136781,-2.319961334,1.7399710005,5.0265828903,6.7665538908
2020,Texas,Jim Wells County,40452,-121,514,409,105,44,-270,-226,0,358,12.687442147,10.095649491,2.5917926566,1.0860845418,-6.664609688,-5.578525147
2020,Texas,Johnson County,179575,3578,2158,1579,579,8,3007,3015,-16,2588,12.138188609,8.8814642323,3.2567243765,0.0449979188,16.913592746,16.958590665
2020,Texas,Jones County,19875,8,154,194,-40,2,46,48,0,5090,7.7499874189,9.762971164,-2.012983745,0.1006491873,2.3149313069,2.4155804942
2020,Texas,Karnes County,15562,206,144,160,-16,89,134,223,-1,2660,9.314962158,10.349957953,-1.034995795,5.7571641115,8.6680897859,14.425253897
2020,Texas,Kaufman County,143198,6739,1953,1174,779,30,5978,6008,-48,1251,13.967109709,8.395999385,5.5711103244,0.2145485362,42.752371655,42.966920192
2020,Texas,Kendall County,48523,1105,396,484,-88,21,1179,1200,-7,510,8.2550734305,10.089534193,-1.834460762,0.4377690456,24.577604986,25.015374032
2020,Texas,Kenedy County,379,-6,2,0,2,1,-9,-8,0,0,5.2356020942,0.0,5.2356020942,2.6178010471,-23.56020942,-20.94240838
2020,Texas,Kent County,786,28,8,14,-6,0,34,34,0,52,10.362694301,18.134715026,-7.772020725,0.0,44.041450777,44.041450777
2020,Texas,Kerr County,52869,447,504,783,-279,28,699,727,-1,1891,9.5734678178,14.873066074,-5.299598256,0.5318593232,13.277488104,13.809347428
2020,Texas,Kimble County,4396,34,56,59,-3,0,37,37,0,16,12.788307833,13.473395752,-0.68508792,0.0,8.4494176753,8.4494176753
2020,Texas,King County,283,16,2,0,2,0,14,14,0,0,7.2727272727,0.0,7.2727272727,0.0,50.909090909,50.909090909
2020,Texas,Kinney County,3670,2,37,41,-4,12,-7,5,1,334,10.084491687,11.174707005,-1.090215318,3.2706459526,-1.907876806,1.3627691469
2020,Texas,Kleberg County,30338,-164,406,253,153,32,-349,-317,0,1362,13.346482577,8.3168967784,5.0295857988,1.0519395135,-11.47271532,-10.42077581
2020,Texas,Knox County,3683,20,47,37,10,4,6,10,0,104,12.796079499,10.073509393,2.7225701062,1.0890280425,1.6335420637,2.7225701062
2020,Texas,Lamar County,49905,124,628,723,-95,12,207,219,0,645,12.599562627,14.505547419,-1.905984792,0.2407559738,4.1530405473,4.3937965211
2020,Texas,Lamb County,12710,-194,157,153,4,5,-204,-199,1,179,12.258920903,11.946591708,0.312329195,0.3904114937,-15.92878894,-15.53837745
2020,Texas,Lampasas County,21789,360,209,212,-3,4,362,366,-3,214,9.6718959693,9.8107270119,-0.138831043,0.1851080568,16.752279143,16.9373872
2020,Texas,La Salle County,7500,-46,92,40,52,18,-117,-99,1,1634,12.229163897,5.3170277815,6.9121361159,2.3926625017,-15.55230626,-13.15964376
2020,Texas,Lavaca County,20216,60,222,259,-37,9,89,98,-1,420,10.997721193,12.830674725,-1.832953532,0.4458535619,4.4089963341,4.854849896
2020,Texas,Lee County,17397,102,228,162,66,-6,42,36,0,470,13.144240747,9.3393289519,3.8049117952,-0.345901072,2.4213075061,2.0754064338
2020,Texas,Leon County,17493,72,192,240,-48,2,120,122,-2,107,10.998453342,13.748066678,-2.749613336,0.1145672223,6.8740333391,6.9886005614
2020,Texas,Liberty County,91547,3094,1314,858,456,10,2652,2662,-24,4845,14.6,9.5333333333,5.0666666667,0.1111111111,29.466666667,29.577777778
2020,Texas,Limestone County,23340,-49,244,298,-54,6,-1,5,0,1571,10.443193734,12.754392347,-2.311198613,0.2567998459,-0.042799974,0.2139998716
2020,Texas,Lipscomb County,3111,-103,36,43,-7,5,-100,-95,-1,34,11.383399209,13.596837945,-2.213438735,1.581027668,-31.62055336,-30.03952569
2020,Texas,Live Oak County,12324,88,143,113,30,7,51,58,0,1156,11.64495114,9.2019543974,2.4429967427,0.5700325733,4.1530944625,4.7231270358
2020,Texas,Llano County,21958,148,167,381,-214,7,358,365,-3,127,7.6311460428,17.409979894,-9.778833851,0.319868397,16.358983732,16.678852129
2020,Texas,Loving County,181,16,0,0,0,0,16,16,0,0,0.0,0.0,0.0,0.0,92.485549133,92.485549133
2020,Texas,Lubbock County,314772,3685,3865,2762,1103,245,2324,2569,13,12280,12.351024752,8.8262691756,3.5247555759,0.7829239493,7.4265928907,8.2095168401
2020,Texas,Lynn County,6025,69,67,53,14,1,55,56,-1,42,11.184375261,8.8473416242,2.3370336366,0.166930974,9.1812035723,9.3481345464
2020,Texas,McCulloch County,7823,-188,86,119,-33,1,-154,-153,-2,104,10.862700518,15.030946065,-4.168245548,0.1263104711,-19.45181256,-19.32550208
2020,Texas,McLennan County,259730,2650,3456,2345,1111,171,1357,1528,11,8550,13.374354211,9.0749018014,4.29945241,0.6617519011,5.2514463729,5.913198274
2020,Texas,McMullen County,721,-12,9,12,-3,0,-9,-9,0,0,12.379642366,16.506189821,-4.126547455,0.0,-12.37964237,-12.37964237
2020,Texas,Madison County,14427,45,181,139,42,28,-25,3,0,2582,12.56551772,9.6497622271,2.9157554931,1.9438369954,-1.735568746,0.2082682495
2020,Texas,Marion County,9960,112,73,154,-81,0,195,195,-2,144,7.3707592892,15.549273021,-8.178513732,0.0,19.68901454,19.68901454
2020,Texas,Martin County,5816,73,88,43,45,1,27,28,0,20,15.226230643,7.4400899732,7.7861406696,0.1730253482,4.6716844018,4.84470975
2020,Texas,Mason County,4344,57,24,47,-23,3,78,81,-1,3,5.561348627,10.890974395,-5.329625768,0.6951685784,18.074383038,18.769551616
2020,Texas,Matagorda County,36725,70,517,390,127,28,-86,-58,1,348,14.091032979,10.629599346,3.4614336331,0.7631507223,-2.343962933,-1.58081221
2020,Texas,Maverick County,58378,21,1019,410,609,61,-647,-586,-2,1049,17.458345826,7.0244571037,10.433888722,1.0451021545,-11.08493597,-10.03983381
2020,Texas,Medina County,52358,750,576,491,85,9,660,669,-4,2304,11.080545563,9.4453956101,1.6351499529,0.1731335244,12.696458458,12.869591982
2020,Texas,Menard County,2124,25,16,24,-8,2,31,33,0,39,7.5775515037,11.366327256,-3.788775752,0.947193938,14.681506038,15.628699976
2020,Texas,Midland County,177863,1419,3025,1222,1803,295,-696,-401,17,1553,17.075586991,6.8979726621,10.177614329,1.665222533,-3.928796213,-2.26357368
2020,Texas,Milam County,24708,-13,250,303,-53,-3,42,39,1,394,10.11551923,12.260009306,-2.144490077,-0.121386231,1.6994072306,1.5780209998
2020,Texas,Mills County,4840,-32,35,78,-43,4,7,11,0,145,7.2075782537,16.062602965,-8.855024712,0.823723229,1.4415156507,2.2652388797
2020,Texas,Mitchell County,8202,41,88,75,13,4,24,28,0,1439,10.755973843,9.167023162,1.5889506814,0.488907902,2.9334474118,3.4223553138
2020,Texas,Montague County,19962,114,189,293,-104,-2,222,220,-2,212,9.4951017332,14.719919618,-5.224817885,-0.100477267,11.152976639,11.052499372
2020,Texas,Montgomery County,626351,18768,7586,4800,2786,764,15305,16069,-87,3123,12.295633316,7.7799947161,4.5156385998,1.2383158256,24.806837319,26.045153144
2020,Texas,Moore County,20654,-277,388,135,253,26,-552,-526,-4,146,18.660574726,6.4927257425,12.167848984,1.2504508837,-26.54803415,-25.29758326
2020,Texas,Morris County,12393,50,148,156,-8,-1,59,58,0,138,11.966364812,12.613195343,-0.64683053,-0.080853816,4.7703751617,4.6895213454
2020,Texas,Motley County,1185,-15,14,20,-6,0,-8,-8,-1,0,11.740041929,16.77148847,-5.031446541,0.0,-6.708595388,-6.708595388
2020,Texas,Nacogdoches County,64753,-93,794,643,151,-23,-224,-247,3,4586,12.253180966,9.9229160719,2.330264894,-0.35494101,-3.456816796,-3.811757807
2020,Texas,Navarro County,50694,716,645,614,31,18,671,689,-4,681,12.813890655,12.198029243,0.6158614113,0.3575969485,13.33041958,13.688016529
2020,Texas,Newton County,13414,-259,106,211,-105,0,-153,-153,-1,723,7.826632702,15.579429247,-7.752796544,0.0,-11.29693211,-11.29693211
2020,Texas,Nolan County,14835,2,195,174,21,31,-50,-19,0,419,13.145476608,11.729809896,1.4156667116,2.0897937171,-3.370635028,-1.280841311
2020,Texas,Nueces County,363148,801,4467,3227,1240,328,-790,-462,23,6740,12.314350891,8.8959951481,3.4183557433,0.9042102289,-2.177823417,-1.273613188
2020,Texas,Ochiltree County,9598,-217,139,73,66,7,-289,-282,-1,22,14.320300829,7.5207335291,6.7995673003,0.7211662288,-29.77386288,-29.05269665
2020,Texas,Oldham County,2135,20,20,8,12,0,8,8,0,277,9.4117647059,3.7647058824,5.6470588235,0.0,3.7647058824,3.7647058824
2020,Texas,Orange County,82878,-208,1019,982,37,10,-258,-248,3,608,12.279771517,11.833891687,0.4458798294,0.120508062,-3.109107999,-2.988599937
2020,Texas,Palo Pinto County,29320,206,344,407,-63,5,263,268,1,260,11.773967211,13.93024609,-2.156278879,0.1711332443,9.0016086525,9.1727418968
2020,Texas,Panola County,23187,84,261,280,-19,-1,103,102,1,345,11.276733636,12.09764528,-0.820911644,-0.043205876,4.4502052279,4.4069993519
2020,Texas,Parker County,148198,5049,1600,1320,280,70,4729,4799,-30,1114,10.983466451,9.0613598218,1.9221066289,0.4805266572,32.463008028,32.943534685
2020,Texas,Parmer County,9522,-33,135,37,98,13,-144,-131,0,64,14.153168737,3.8790166169,10.27415212,1.3628977303,-15.09671332,-13.73381559
2020,Texas,Pecos County,15718,-39,204,102,102,12,-153,-141,0,2056,12.962668785,6.4813343924,6.4813343924,0.7625099285,-9.722001589,-8.95949166
2020,Texas,Polk County,52995,1741,515,663,-148,66,1838,1904,-15,4227,9.8801906973,12.71954647,-2.839355773,1.2661991962,35.261729129,36.527928325
2020,Texas,Potter County,116004,-814,1570,1162,408,278,-1491,-1213,-9,6521,13.486697992,9.9818745651,3.5048234273,2.3880904725,-12.80806797,-10.41997749
2020,Texas,Presidio County,6508,-104,96,57,39,4,-145,-141,-2,0,14.634146341,8.6890243902,5.9451219512,0.6097560976,-22.10365854,-21.49390244
2020,Texas,Rains County,12552,151,121,143,-22,7,166,173,0,63,9.6982326774,11.46154771,-1.763315032,0.561054783,13.305013425,13.866068208
2020,Texas,Randall County,139899,2129,1645,1223,422,47,1667,1714,-7,2384,11.848639927,8.8090496238,3.0395903036,0.3385325694,12.007101981,12.34563455
2020,Texas,Reagan County,3833,-9,67,17,50,33,-92,-59,0,22,17.459283388,4.4299674267,13.029315961,8.5993485342,-23.97394137,-15.37459283
2020,Texas,Real County,3411,-49,39,63,-24,0,-25,-25,0,71,11.35205938,18.337942075,-6.985882695,0.0,-7.276961141,-7.276961141
2020,Texas,Red River County,11995,-100,118,206,-88,1,-11,-10,-2,163,9.796596098,17.102532171,-7.305936073,0.0830220008,-0.913242009,-0.830220008
2020,Texas,Reeves County,15949,-2,192,115,77,39,-119,-80,1,3137,12.037617555,7.210031348,4.8275862069,2.4451410658,-7.460815047,-5.015673981
2020,Texas,Refugio County,6877,53,59,43,16,2,35,37,0,121,8.6125100358,6.2769140939,2.3355959419,0.2919494927,5.1091161229,5.4010656156
2020,Texas,Roberts County,813,-24,6,10,-4,0,-19,-19,-1,0,7.2727272727,12.121212121,-4.848484848,0.0,-23.03030303,-23.03030303
2020,Texas,Robertson County,17155,51,199,186,13,14,26,40,-2,174,11.617385213,10.858460551,0.7589246621,0.8173034823,1.5178493243,2.3351528066
2020,Texas,Rockwall County,109888,5026,1150,689,461,77,4522,4599,-34,625,10.710128056,6.4167636787,4.2933643772,0.717112922,42.114086147,42.831199069
2020,Texas,Runnels County,10401,136,116,121,-5,2,140,142,-1,165,11.226168586,11.710055163,-0.483886577,0.1935546308,13.548824156,13.742378786
2020,Texas,Rusk County,54324,-62,556,623,-67,-8,10,2,3,6179,10.229049765,11.461687057,-1.232637292,-0.147180572,0.1839757152,0.036795143
2020,Texas,Sabine County,10507,17,97,153,-56,-4,77,73,0,111,9.2394151545,14.573510502,-5.334095347,-0.38100681,7.3343811021,6.9533742916
2020,Texas,San Augustine County,8248,28,72,151,-79,3,105,108,-1,182,8.7442312363,18.338596065,-9.594364829,0.3643429682,12.752003886,13.116346855
2020,Texas,San Jacinto County,29301,434,277,346,-69,-12,520,508,-5,127,9.5241369825,11.896575437,-2.372438454,-0.412597992,17.879246321,17.466648329
2020,Texas,San Patricio County,67069,413,917,598,319,48,41,89,5,483,13.71471303,8.9437277996,4.7709852309,0.7178911946,0.6131987287,1.3310899234
2020,Texas,San Saba County,6039,30,70,82,-12,5,37,42,0,689,11.620185923,13.612217795,-1.992031873,0.8300132802,6.1420982736,6.9721115538
2020,Texas,Schleicher County,2761,-40,24,19,5,1,-46,-45,0,1,8.6299892125,6.8320747932,1.7979144193,0.3595828839,-16.54081266,-16.18122977
2020,Texas,Scurry County,16662,7,199,188,11,15,-19,-4,0,1594,11.945853468,11.28552991,0.6603235585,0.9004412162,-1.140558874,-0.240117658
2020,Texas,Shackelford County,3300,28,34,40,-6,0,34,34,0,11,10.346926354,12.172854534,-1.82592818,0.0,10.346926354,10.346926354
2020,Texas,Shelby County,24915,-382,340,340,0,-2,-378,-380,-2,145,13.542579463,13.542579463,0.0,-0.079662232,-15.05616187,-15.13582411
2020,Texas,Sherman County,3027,10,42,13,29,5,-23,-18,-1,27,13.898080741,4.3017868961,9.5962938451,1.6545334216,-7.610853739,-5.956320318
2020,Texas,Smith County,235806,2890,2921,2312,609,76,2207,2283,-2,5181,12.46367783,9.86512261,2.5985552204,0.3242860374,9.4170958479,9.7413818852
2020,Texas,Somervell County,9139,16,90,124,-34,-2,50,48,2,286,9.8565326908,13.580111707,-3.723579017,-0.21903406,5.4758514949,5.2568174351
2020,Texas,Starr County,64266,-28,1156,401,755,-40,-740,-780,-3,818,17.983820784,6.2383322962,11.745488488,-0.622277536,-11.51213441,-12.13441195
2020,Texas,Stephens County,9334,-30,105,98,7,0,-37,-37,0,668,11.231147716,10.482404535,0.7487431811,0.0,-3.957642529,-3.957642529
2020,Texas,Sterling County,1315,20,12,30,-18,0,40,40,-2,34,9.1954022989,22.988505747,-13.79310345,0.0,30.651340996,30.651340996
2020,Texas,Stonewall County,1348,12,13,15,-2,0,14,14,0,24,9.6870342772,11.177347243,-1.490312966,0.0,10.43219076,10.43219076
2020,Texas,Sutton County,3738,-41,49,35,14,12,-66,-54,-1,13,13.037115871,9.3122256219,3.7248902488,3.1927630704,-17.56019689,-14.36743382
2020,Texas,Swisher County,7340,-59,83,58,25,-4,-81,-85,1,639,11.262636543,7.8702761381,3.3923604044,-0.542777665,-10.99124771,-11.53402537
2020,Texas,Tarrant County,2123347,22065,27220,15107,12113,3826,5987,9813,139,25670,12.886338658,7.151870614,5.7344680444,1.8112833103,2.8343317248,4.6456150351
2020,Texas,Taylor County,139200,1059,2029,1485,544,146,359,505,10,4866,14.631807053,10.708838578,3.9229684756,1.05285551,2.5888707404,3.6417262504
2020,Texas,Terrell County,702,-50,4,10,-6,1,-43,-42,-2,0,5.5020632737,13.755158184,-8.253094911,1.3755158184,-59.14718019,-57.77166437
2020,Texas,Terry County,12183,-171,178,130,48,-3,-217,-220,1,1041,14.508701145,10.596242409,3.9124587358,-0.244528671,-17.68757387,-17.93210254
2020,Texas,Throckmorton County,1487,14,14,22,-8,0,22,22,0,13,9.4594594595,14.864864865,-5.405405405,0.0,14.864864865,14.864864865
2020,Texas,Titus County,32926,182,432,272,160,12,9,21,1,426,13.156692554,8.2838434597,4.872849094,0.365463682,0.2740977615,0.6395614436
2020,Texas,Tom Green County,120010,581,1465,1097,368,15,190,205,8,4984,12.236937174,9.1630853787,3.0738517952,0.1252928721,1.5870430465,1.7123359185
2020,Texas,Travis County,1300503,26936,15463,6880,8583,3430,14914,18344,9,22367,12.014436282,5.3456199715,6.6688163104,2.6650401893,11.587874456,14.252914645
2020,Texas,Trinity County,14883,208,138,221,-83,4,289,293,-2,153,9.3375735841,14.95365045,-5.616076866,0.2706543068,19.554773665,19.825427972
2020,Texas,Tyler County,21591,68,183,277,-94,-2,164,162,0,2287,8.489121863,12.849654405,-4.360532542,-0.092777288,7.6077376258,7.5149603377
2020,Texas,Upshur County,42166,461,438,467,-29,0,493,493,-3,465,10.444611367,11.136149563,-0.691538196,0.0,11.756149325,11.756149325
2020,Texas,Upton County,3623,-21,38,22,16,5,-41,-36,-1,63,10.458235861,6.0547681299,4.4034677308,1.3760836659,-11.28388606,-9.907802394
2020,Texas,Uvalde County,26742,-52,383,277,106,4,-160,-156,-2,529,14.308129109,10.348176928,3.9599521817,0.1494321578,-5.977286312,-5.827854154
2020,Texas,Val Verde County,49028,-13,752,396,356,15,-381,-366,-3,1892,15.33614088,8.0759465274,7.260194353,0.3059070654,-7.770039462,-7.464132397
2020,Texas,Van Zandt County,57533,789,650,726,-76,38,831,869,-4,532,11.37586741,12.70596883,-1.33010142,0.6650507101,14.54360895,15.20865966
2020,Texas,Victoria County,91936,-85,1185,918,267,16,-370,-354,2,1902,12.883445588,9.9805932908,2.902852297,0.1739536957,-4.022679213,-3.848725517
2020,Texas,Walker County,72164,464,578,687,-109,101,467,568,5,16621,8.0353667352,9.5506867597,-1.515320024,1.4041038759,6.4922426736,7.8963465495
2020,Texas,Waller County,57452,2141,683,386,297,26,1830,1856,-12,4611,12.11390261,6.8462172876,5.2676853223,0.4611441696,32.457455016,32.918599186
2020,Texas,Ward County,12097,112,216,82,134,7,-28,-21,-1,124,17.93870941,6.8100656092,11.1286438,0.5813470642,-2.325388257,-1.744041193
2020,Texas,Washington County,35771,145,363,435,-72,-5,222,217,0,2293,10.168494475,12.185385941,-2.016891466,-0.140061907,6.2187486869,6.0786867796
2020,Texas,Webb County,277681,1294,4638,1482,3156,433,-2299,-1866,4,3647,16.741627381,5.3495238852,11.392103496,1.5629850488,-8.298620386,-6.735635337
2020,Texas,Wharton County,41685,14,598,430,168,5,-160,-155,1,477,14.348097318,10.317193723,4.0309035942,0.1199673689,-3.838955804,-3.718988435
2020,Texas,Wheeler County,4946,-80,42,63,-21,-1,-58,-59,0,45,8.4235860409,12.635379061,-4.21179302,-0.200561572,-11.6325712,-11.83313277
2020,Texas,Wichita County,133205,877,1570,1440,130,138,601,739,8,12698,11.825272188,10.846109523,0.9791626653,1.0394188293,4.5267443218,5.5661631511
2020,Texas,Wilbarger County,12552,-143,164,153,11,3,-157,-154,0,632,12.991642571,12.120251911,0.8713906603,0.2376519983,-12.43712124,-12.19946924
2020,Texas,Willacy County,21161,-119,242,202,40,4,-162,-158,-1,3303,11.404066822,9.5190970995,1.8849697227,0.1884969723,-7.634127377,-7.445630405
2020,Texas,Williamson County,617855,26032,6979,3288,3691,697,21763,22460,-119,4187,11.538607795,5.4361573906,6.1024504042,1.1523727802,35.981476062,37.133848842
2020,Texas,Wilson County,52023,1073,514,456,58,23,997,1020,-5,441,9.9831994795,8.8566905888,1.1265088907,0.4467190429,19.364299379,19.811018422
2020,Texas,Winkler County,7887,-83,133,49,84,13,-181,-168,1,97,16.7749259,6.180235858,10.594690042,1.6396544113,-22.8290345,-21.18938008
2020,Texas,Wise County,71084,1207,794,693,101,16,1091,1107,-1,770,11.265527344,9.8325068636,1.4330204808,0.2270131455,15.479458857,15.706472003
2020,Texas,Wood County,46291,670,392,734,-342,11,1009,1020,-8,1674,8.5298981635,15.971799112,-7.441900949,0.2393593872,21.955783793,22.19514318
2020,Texas,Yoakum County,8702,16,180,49,131,38,-151,-113,-2,54,20.703933747,5.6360708535,15.067862894,4.3708304578,-17.36829998,-12.99746952
2020,Texas,Young County,17904,-33,181,246,-65,8,24,32,0,267,10.100164616,13.727295555,-3.627130939,0.4464161156,1.3392483469,1.7856644625
2020,Texas,Zapata County,14172,-49,200,115,85,12,-145,-133,-1,32,14.087979432,8.1005881731,5.9873912584,0.8452787659,-10.21378509,-9.368506322
2020,Texas,Zavala County,11840,33,163,87,76,19,-64,-45,2,412,13.786103946,7.3582272593,6.4278766863,1.6069691716,-5.412948788,-3.805979617
2020,Utah,Utah,3249879,46496,47611,19080,28531,2189,15689,17878,87,48669,14.755638311,5.9132885043,8.842349807,0.6784165899,4.8623471354,5.5407637254
2020,Utah,Beaver County,6761,36,106,55,51,7,-22,-15,0,23,15.720005932,8.1566068515,7.5633990805,1.0381135993,-3.262642741,-2.224529141
2020,Utah,Box Elder County,57007,1050,827,409,418,16,617,633,-1,331,14.641832796,7.2412449984,7.4005877979,0.283276088,10.923834142,11.20711023
2020,Utah,Cache County,130004,1695,2093,601,1492,149,44,193,10,3932,16.20514647,4.6532694831,11.551876986,1.1536391897,0.3406719755,1.4943111651
2020,Utah,Carbon County,20760,284,249,195,54,5,227,232,-2,526,12.076826074,9.4577553594,2.6190707149,0.2425065477,11.009797265,11.252303812
2020,Utah,Daggett County,1026,62,6,7,-1,0,62,62,1,0,6.0301507538,7.0351758794,-1.005025126,0.0,62.311557789,62.311557789
2020,Utah,Davis County,359232,3928,5223,1859,3364,37,498,535,29,2990,14.619277405,5.2033767368,9.4159006684,0.1035637113,1.3939115734,1.4974752847
2020,Utah,Duchesne County,19894,17,336,143,193,2,-177,-175,-1,283,16.896733801,7.1911694451,9.7055643559,0.1005757964,-8.900957984,-8.800382188
2020,Utah,Emery County,10147,86,121,101,20,1,66,67,-1,43,11.975455265,9.9960411718,1.9794140934,0.0989707047,6.5320665083,6.631037213
2020,Utah,Garfield County,5050,50,55,35,20,0,31,31,-1,181,10.945273632,6.9651741294,3.9800995025,0.0,6.1691542289,6.1691542289
2020,Utah,Grand County,9796,23,97,80,17,-1,7,6,0,143,9.9136389187,8.1761970463,1.7374418723,-0.102202463,0.7154172416,0.6132147785
2020,Utah,Iron County,56814,1545,825,347,478,-9,1078,1069,-2,1143,14.721233372,6.1918399757,8.529393396,-0.160595273,19.235744939,19.075149666
2020,Utah,Juab County,12122,120,192,92,100,4,17,21,-1,122,15.917758249,7.627259161,8.290499088,0.3316199635,1.409384845,1.7410048085
2020,Utah,Kane County,7914,41,86,80,6,-2,37,35,0,255,10.895040223,10.134921138,0.7601190853,-0.253373028,4.6874010262,4.4340279977
2020,Utah,Millard County,13327,227,180,104,76,-1,154,153,-2,177,13.622431604,7.8707382601,5.7516933439,-0.075680176,11.654747039,11.579066863
2020,Utah,Morgan County,12462,347,133,53,80,3,267,270,-3,0,10.823127314,4.3129755462,6.5101517679,0.2441306913,21.727631525,21.971762217
2020,Utah,Piute County,1473,1,20,10,10,0,-8,-8,-1,37,13.582342954,6.7911714771,6.7911714771,0.0,-5.432937182,-5.432937182
2020,Utah,Rich County,2452,-16,29,11,18,1,-35,-34,0,1,11.788617886,4.4715447154,7.3170731707,0.406504065,-14.22764228,-13.82113821
2020,Utah,Salt Lake County,1165517,6932,16105,7338,8767,1491,-3394,-1903,68,14737,13.859116338,6.3146970314,7.5444193069,1.2830762161,-2.920697973,-1.637621757
2020,Utah,San Juan County,15278,50,180,135,45,-2,6,4,1,336,11.800957189,8.8507178916,2.9502392972,-0.131121747,0.3933652396,0.2622434931
2020,Utah,Sanpete County,31393,407,374,206,168,12,227,239,0,2947,11.991214992,6.6047868674,5.3864281248,0.3847448661,7.278090383,7.662835249
2020,Utah,Sevier County,21780,144,281,223,58,2,84,86,0,309,12.944536576,10.272710521,2.6718260549,0.0921319329,3.869541183,3.9616731159
2020,Utah,Summit County,42499,418,392,175,217,46,155,201,0,106,9.2693308111,4.1380941121,5.131236699,1.0877275952,3.6651690707,4.7528966659
2020,Utah,Tooele County,74512,2402,1004,402,602,29,1785,1814,-14,326,13.695079865,5.4834881532,8.211591712,0.395575016,24.348324262,24.743899278
2020,Utah,Uintah County,35970,164,543,260,283,-1,-118,-119,0,276,15.130405707,7.2447614802,7.8856442265,-0.027864467,-3.288007133,-3.315871601
2020,Utah,Utah County,651059,15384,11840,2695,9145,380,5833,6213,26,14075,18.40318201,4.1888999591,14.214282051,0.5906426659,9.0663649208,9.6570075866
2020,Utah,Wasatch County,35300,1090,416,160,256,32,805,837,-3,250,11.969500791,4.6036541505,7.3658466408,0.9207308301,23.162134945,24.082865775
2020,Utah,Washington County,184913,6975,2213,1511,702,-12,6317,6305,-32,2259,12.197844294,8.3284874508,3.8693568434,-0.066142852,34.818699687,34.752556835
2020,Utah,Wayne County,2759,56,24,20,4,2,49,51,1,9,8.7879897473,7.3233247895,1.4646649579,0.7323324789,17.942145734,18.674478213
2020,Utah,Weber County,262658,2978,3661,1773,1888,-2,1077,1075,15,2852,14.0177433,6.788707695,7.2290356053,-0.007657877,4.1237666032,4.1161087265
2020,Vermont,Vermont,623347,-699,5331,6129,-798,542,-462,80,19,25691,8.5474265127,9.8268949722,-1.279468459,0.8690124123,-0.740744898,0.1282675147
2020,Vermont,Addison County,36851,-143,288,349,-61,47,-129,-82,0,2965,7.8001218769,9.4522310244,-1.652109148,1.2729365563,-3.493804591,-2.220868034
2020,Vermont,Bennington County,35338,-194,303,474,-171,32,-55,-23,0,1473,8.5508677861,13.376605052,-4.825737265,0.9030619444,-1.552137717,-0.649075773
2020,Vermont,Caledonia County,29705,-155,256,321,-65,1,-91,-90,0,1186,8.5956518089,10.778141526,-2.182489717,0.0335767649,-3.055485604,-3.021908839
2020,Vermont,Chittenden County,164306,388,1389,1242,147,325,-97,228,13,10030,8.4637320854,7.5680023399,0.8957297455,1.9803548796,-0.591059764,1.3892951155
2020,Vermont,Essex County,6123,-22,43,79,-36,0,15,15,-1,16,7.010107597,12.879034888,-5.868927291,0.0,2.445386371,2.445386371
2020,Vermont,Franklin County,49685,301,538,430,108,40,151,191,2,575,10.861116999,8.6808184195,2.1802985798,0.8075179925,3.0483804217,3.8558984142
2020,Vermont,Grand Isle County,7169,-39,64,60,4,0,-42,-42,-1,0,8.9031091326,8.3466648119,0.5564443208,0.0,-5.842665368,-5.842665368
2020,Vermont,Lamoille County,25341,-79,235,207,28,17,-123,-106,-1,738,9.2590768503,8.1558676937,1.1032091566,0.6698055594,-4.846240224,-4.176434664
2020,Vermont,Orange County,28837,28,245,305,-60,4,84,88,0,661,8.5001561253,10.581827013,-2.081670888,0.1387780592,2.914339243,3.0531173022
2020,Vermont,Orleans County,26897,-37,262,319,-57,8,13,21,-1,780,9.7341680444,11.851906894,-2.117738849,0.2972265052,0.4829930709,0.7802195761
2020,Vermont,Rutland County,57764,-361,453,701,-248,3,-118,-115,2,2186,7.817825678,12.097783224,-4.279957546,0.05177368,-2.036431413,-1.984657733
2020,Vermont,Washington County,58328,-130,489,579,-90,4,-48,-44,4,2960,8.374291439,9.915572072,-1.541280633,0.0685013615,-0.822016338,-0.753514976
2020,Vermont,Windham County,42015,-212,335,475,-140,17,-90,-73,1,1364,7.9532774625,11.277035208,-3.323757746,0.4035991548,-2.136701408,-1.733102253
2020,Vermont,Windsor County,54988,-44,431,588,-157,44,68,112,1,757,7.834939102,10.688965643,-2.854026541,0.7998545719,1.2361388838,2.0359934557
2020,Virginia,Virginia,8590563,33921,98147,75821,22326,20721,-9130,11591,4,245393,11.447579941,8.8435403904,2.6040395505,2.4168370297,-1.064896582,1.3519404474
2020,Virginia,Accomack County,32238,-87,339,478,-139,52,0,52,0,429,10.501370754,14.807242538,-4.305871784,1.6108297322,0.0,1.6108297322
2020,Virginia,Albemarle County,110652,809,1094,973,121,255,428,683,5,6680,9.9231275086,8.8255969523,1.0975305562,2.3129776185,3.882174199,6.1951518175
2020,Virginia,Alleghany County,14701,-197,118,252,-134,-1,-61,-62,-1,281,7.9732423393,17.027602284,-9.054359945,-0.06756985,-4.12176087,-4.189330721
2020,Virginia,Amelia County,13014,-44,129,181,-52,1,7,8,0,128,9.8956735195,13.884627186,-3.988953667,0.0767106474,0.5369745321,0.6136851795
2020,Virginia,Amherst County,31667,-11,314,423,-109,10,87,97,1,1401,9.9139632173,13.355434525,-3.441471308,0.3157313127,2.7468624201,3.0625937327
2020,Virginia,Appomattox County,16043,141,200,194,6,8,128,136,-1,56,12.521521365,12.145875724,0.3756456409,0.5008608546,8.0137736735,8.5146345281
2020,Virginia,Arlington County,240119,1727,2732,1099,1633,1437,-1357,80,14,2955,11.418755264,4.5934158253,6.8253394384,6.0061315205,-5.671760942,0.3343705787
2020,Virginia,Augusta County,76544,424,613,875,-262,46,644,690,-4,2915,8.03070796,11.463082325,-3.432374365,0.6026306136,8.4368285909,9.0394592045
2020,Virginia,Bath County,4119,-50,43,58,-15,5,-39,-34,-1,53,10.376447876,13.996138996,-3.61969112,1.2065637066,-9.411196911,-8.204633205
2020,Virginia,Bedford County,79811,380,677,892,-215,50,549,599,-4,545,8.5027819294,11.203074566,-2.700292636,0.6279750317,6.8951658482,7.5231408799
2020,Virginia,Bland County,6239,-53,45,80,-35,0,-18,-18,0,676,7.1821881733,12.76833453,-5.586146357,0.0,-2.872875269,-2.872875269
2020,Virginia,Botetourt County,33633,133,255,401,-146,12,268,280,-1,287,7.5968599645,11.946434689,-4.349574725,0.3574992924,7.9841508647,8.3416501572
2020,Virginia,Brunswick County,16037,-139,124,242,-118,14,-35,-21,0,2190,7.698755161,15.024989911,-7.32623475,0.8692142924,-2.173035731,-1.303821439
2020,Virginia,Buchanan County,20613,-418,169,308,-139,19,-295,-276,-3,1028,8.1164153299,14.792046873,-6.675631544,0.912496398,-14.16770723,-13.25521083
2020,Virginia,Buckingham County,17168,34,145,193,-48,1,80,81,1,2218,8.4543175325,11.252988164,-2.798670631,0.0583056382,4.6644510524,4.7227566906
2020,Virginia,Campbell County,55304,-67,547,619,-72,61,-58,3,2,457,9.8847978315,11.185904676,-1.301106844,1.102326632,-1.048113847,0.0542127852
2020,Virginia,Caroline County,30860,115,338,320,18,11,85,96,1,513,10.973135297,10.388767146,0.5843681519,0.3571138706,2.759516273,3.1166301437
2020,Virginia,Carroll County,30074,52,240,399,-159,37,174,211,0,337,7.9872204473,13.278753994,-5.291533546,1.2313631523,5.7907348243,7.0220979766
2020,Virginia,Charles City County,6821,-148,52,116,-64,0,-83,-83,-1,0,7.5416968818,16.823785352,-9.28208847,0.0,-12.03770848,-12.03770848
2020,Virginia,Charlotte County,11820,-29,131,181,-50,6,14,20,1,175,11.069331193,15.294266762,-4.22493557,0.5069922684,1.1829819595,1.6899742279
2020,Virginia,Chesterfield County,358245,4869,3970,2954,1016,412,3453,3865,-12,4579,11.157624634,8.3021720832,2.8554525513,1.1579197354,9.7046039957,10.862523731
2020,Virginia,Clarke County,14622,46,128,164,-36,6,75,81,1,180,8.7677238167,11.23364614,-2.465922323,0.4109870539,5.1373381738,5.5483252278
2020,Virginia,Craig County,5077,-50,41,75,-34,0,-15,-15,-1,9,8.0360642885,14.700117601,-6.664053312,0.0,-2.94002352,-2.94002352
2020,Virginia,Culpeper County,53569,847,651,484,167,85,597,682,-2,1475,12.249390823,9.1070739762,3.1423168471,1.5993828264,11.233312322,12.832695148
2020,Virginia,Cumberland County,9933,-34,93,121,-28,0,-7,-7,1,37,9.3467336683,12.16080402,-2.814070352,0.0,-0.703517588,-0.703517588
2020,Virginia,Dickenson County,14078,-217,115,202,-87,0,-130,-130,0,512,8.1062982413,14.238889085,-6.132590843,0.0,-9.16364149,-9.16364149
2020,Virginia,Dinwiddie County,28688,-116,233,315,-82,2,-36,-34,0,864,8.1054755444,10.958046337,-2.852570792,0.0695748974,-1.252348153,-1.182773255
2020,Virginia,Essex County,10943,7,108,139,-31,8,30,38,0,190,9.8724804607,12.706248,-2.83376754,0.7312948489,2.7423556835,3.4736505325
2020,Virginia,Fairfax County,1150847,-1512,13523,6215,7308,6371,-15196,-8825,5,10443,11.742762046,5.3968251212,6.3459369244,5.5322884709,-13.19551964,-7.663231166
2020,Virginia,Fauquier County,71361,64,767,650,117,21,-77,-56,3,389,10.752989668,9.1127031081,1.6402865595,0.2944104081,-1.07950483,-0.785094422
2020,Virginia,Floyd County,15777,-19,139,175,-36,-1,18,17,0,85,8.8049916068,11.085421088,-2.280429481,-0.063345263,1.1402147404,1.0768694771
2020,Virginia,Fluvanna County,27422,156,255,254,1,14,140,154,1,1251,9.3256290228,9.2890579286,0.0365710942,0.5119953189,5.119953189,5.6319485079
2020,Virginia,Franklin County,56167,-18,493,719,-226,-6,214,208,0,1161,8.7759897465,12.799060097,-4.02307035,-0.106807177,3.8094559954,3.702648818
2020,Virginia,Frederick County,91119,1636,958,828,130,70,1441,1511,-5,1176,10.608963356,9.1693336729,1.4396296829,0.7751852139,15.957741332,16.732926546
2020,Virginia,Giles County,16663,-30,151,258,-107,0,76,76,1,136,9.0538433865,15.469480753,-6.415637367,0.0,4.5569013071,4.5569013071
2020,Virginia,Gloucester County,37459,-40,339,474,-135,2,93,95,0,293,9.0450652365,12.647082366,-3.60201713,0.0533632167,2.4813895782,2.5347527949
2020,Virginia,Goochland County,24431,482,184,226,-42,-1,528,527,-3,983,7.6064489458,9.3427035965,-1.736254651,-0.041339396,21.827201323,21.785861926
2020,Virginia,Grayson County,15493,-81,126,195,-69,4,-15,-11,-1,1066,8.1115009496,12.553513374,-4.442012425,0.2575079667,-0.965654875,-0.708146908
2020,Virginia,Greene County,20131,230,214,173,41,19,172,191,-2,137,10.691446843,8.6430855316,2.048361311,0.9492406075,8.5931254996,9.5423661071
2020,Virginia,Greensville County,11280,-9,93,123,-30,3,18,21,0,3416,8.2413930613,10.899906952,-2.658513891,0.2658513891,1.5951083344,1.8609597235
2020,Virginia,Halifax County,33633,-402,351,535,-184,1,-218,-217,-1,757,10.374179819,15.812496305,-5.438316486,0.0295560679,-6.443222794,-6.413666726
2020,Virginia,Hanover County,108262,727,952,1032,-80,67,739,806,1,1951,8.8231069014,9.5645444561,-0.741437555,0.6209539521,6.8490294119,7.469983364
2020,Virginia,Henrico County,333766,1253,3897,3067,830,1237,-828,409,14,2750,11.697802272,9.2063534946,2.4914487775,3.7131592021,-2.485445286,1.2277139156
2020,Virginia,Henry County,50309,-415,428,782,-354,8,-70,-62,1,562,8.4724792889,15.480090663,-7.007611375,0.1583640989,-1.385685865,-1.227321766
2020,Virginia,Highland County,2200,24,14,31,-17,0,40,40,1,0,6.3985374771,14.168190128,-7.769652651,0.0,18.281535649,18.281535649
2020,Virginia,Isle of Wight County,37725,325,349,428,-79,73,334,407,-3,310,9.2911813644,11.394342762,-2.103161398,1.9434276206,8.8918469218,10.835274542
2020,Virginia,James City County,77612,774,671,770,-99,102,776,878,-5,1140,8.6888960829,9.9708643574,-1.281968275,1.320815798,10.048559404,11.369375202
2020,Virginia,King and Queen County,6942,-69,60,105,-45,3,-26,-23,-1,0,8.6003010105,15.050526768,-6.450225758,0.4300150505,-3.726797105,-3.296782054
2020,Virginia,King George County,27381,400,306,200,106,20,274,294,0,301,11.257863949,7.3580810125,3.8997829366,0.7358081012,10.080570987,10.816379088
2020,Virginia,King William County,17641,443,206,164,42,7,397,404,-3,72,11.825827377,9.4147363587,2.4110910187,0.4018485031,22.790550819,23.192399323
2020,Virginia,Lancaster County,10618,-1,84,219,-135,13,122,135,-1,183,7.9107218534,20.624381975,-12.71366012,1.2242783821,11.489381739,12.713660121
2020,Virginia,Lee County,23238,-302,200,296,-96,0,-206,-206,0,1457,8.5510282611,12.655521826,-4.104493565,0.0,-8.807559109,-8.807559109
2020,Virginia,Loudoun County,422784,7912,5075,1749,3326,1361,3207,4568,18,1693,12.117145941,4.1759385714,7.9412073691,3.2495439655,7.6570811885,10.906625154
2020,Virginia,Louisa County,38132,655,376,424,-48,12,695,707,-4,211,9.9459059107,11.215596027,-1.269690116,0.3174225291,18.384054808,18.701477337
2020,Virginia,Lunenburg County,12267,16,103,177,-74,23,67,90,0,1002,8.4019903744,14.438371808,-6.036381434,1.8761726079,5.4653723795,7.3415449874
2020,Virginia,Madison County,13312,99,135,149,-14,8,106,114,-1,193,10.179076343,11.23468426,-1.055607917,0.603204524,7.9924599434,8.5956644675
2020,Virginia,Mathews County,8766,-16,60,132,-72,0,58,58,-2,86,6.8383861409,15.04444951,-8.206063369,0.0,6.6104399362,6.6104399362
2020,Virginia,Mecklenburg County,30679,-44,314,497,-183,6,133,139,0,925,10.22767988,16.188397772,-5.960717892,0.1954333735,4.332106446,4.5275398195
2020,Virginia,Middlesex County,10569,8,78,153,-75,-1,85,84,-1,377,7.3828679602,14.48177946,-7.0989115,-0.094652153,8.0454330336,7.9507808803
2020,Virginia,Montgomery County,98391,-481,773,725,48,337,-870,-533,4,9832,7.8372528046,7.3505928633,0.4866599413,3.4167583379,-8.820711436,-5.403953098
2020,Virginia,Nelson County,14755,-112,138,185,-47,5,-68,-63,-2,102,9.3173992303,12.490716359,-3.173317129,0.3375869286,-4.591182229,-4.253595301
2020,Virginia,New Kent County,23648,664,221,199,22,5,639,644,-2,552,9.4784697204,8.5349116487,0.9435580717,0.2144450163,27.406073083,27.620518099
2020,Virginia,Northampton County,11673,-127,116,194,-78,7,-56,-49,0,252,9.8836961615,16.529629787,-6.645933626,0.5964299408,-4.771439526,-4.175009585
2020,Virginia,Northumberland County,12069,0,82,216,-134,0,136,136,-2,0,6.7942663021,17.897091723,-11.10282542,0.0,11.268539233,11.268539233
2020,Virginia,Nottoway County,15160,-46,155,227,-72,14,12,26,0,2244,10.208786142,14.950931963,-4.742145821,0.9220839096,0.7903576368,1.7124415465
2020,Virginia,Orange County,37695,754,398,417,-19,31,746,777,-4,601,10.665094592,11.174232274,-0.509137682,0.8306983225,19.990353181,20.821051503
2020,Virginia,Page County,23933,-4,256,340,-84,6,75,81,-1,194,10.695634009,14.205138918,-3.509504909,0.2506789221,3.133486526,3.3841654481
2020,Virginia,Patrick County,17493,-99,127,240,-113,-3,16,13,1,295,7.239561066,13.681060282,-6.441499216,-0.171013254,0.9120706855,0.741057432
2020,Virginia,Pittsylvania County,59850,-620,481,809,-328,8,-301,-293,1,1066,7.9953457447,13.447473404,-5.45212766,0.1329787234,-5.003324468,-4.870345745
2020,Virginia,Powhatan County,30148,414,259,277,-18,2,434,436,-4,1119,8.6503456798,9.2515280051,-0.601182325,0.0667980361,14.495173842,14.561971878
2020,Virginia,Prince Edward County,23006,179,220,263,-43,36,186,222,0,4060,9.6000698187,11.476447101,-1.876377283,1.5709205158,8.1164226649,9.6873431807
2020,Virginia,Prince George County,38686,158,386,302,84,22,49,71,3,3990,9.9981868573,7.8224156241,2.1757712332,0.5698448468,1.269199886,1.8390447328
2020,Virginia,Prince William County,475533,3759,6300,2325,3975,1700,-1952,-252,36,3074,13.300862339,4.9086515776,8.3922107617,3.5891215836,-4.121156077,-0.532034494
2020,Virginia,Pulaski County,33935,-74,296,519,-223,6,143,149,0,1088,8.7130578123,15.277287178,-6.564229365,0.1766160367,4.2093488755,4.3859649123
2020,Virginia,Rappahannock County,7260,-112,57,86,-29,6,-90,-84,1,35,7.7911427009,11.755057408,-3.963914707,0.8201202843,-12.30180426,-11.48168398
2020,Virginia,Richmond County,9071,5,72,110,-38,8,36,44,-1,1665,7.9395710426,12.129900204,-4.190329161,0.8821745603,3.9697855213,4.8519600816
2020,Virginia,Roanoke County,94509,86,773,1064,-291,96,282,378,-1,2347,8.1828382699,11.263311668,-3.080473398,1.0162386467,2.9852010247,4.0014396714
2020,Virginia,Rockbridge County,22757,-17,147,267,-120,19,84,103,0,502,6.457139092,11.728273045,-5.271133953,0.8345962092,3.6897937669,4.5243899761
2020,Virginia,Rockingham County,82346,206,889,837,52,62,90,152,2,1633,10.80943059,10.177157934,0.6322726554,0.7538635507,1.0943180575,1.8481816082
2020,Virginia,Russell County,26647,-92,260,366,-106,0,14,14,0,432,9.7403813734,13.711459933,-3.97107856,0.0,0.524482074,0.524482074
2020,Virginia,Scott County,21629,51,155,267,-112,2,163,165,-2,794,7.1747633485,12.359108478,-5.184345129,0.0925775916,7.5450737149,7.6376513065
2020,Virginia,Shenandoah County,43905,348,478,543,-65,35,378,413,0,427,10.930461229,12.416821019,-1.486359791,0.8003475795,8.6437538588,9.4441014383
2020,Virginia,Smyth County,30090,-92,256,489,-233,16,126,142,-1,770,8.4948234669,16.226440138,-7.731616671,0.5309264667,4.1810459251,4.7119723918
2020,Virginia,Southampton County,17636,-161,155,219,-64,4,-101,-97,0,1576,8.7489063867,12.361358056,-3.612451669,0.2257782293,-5.700900291,-5.475122061
2020,Virginia,Spotsylvania County,138449,2002,1560,1104,456,83,1467,1550,-4,524,11.349746813,8.0321285141,3.3176182993,0.6038647343,10.673127292,11.276992026
2020,Virginia,Stafford County,156748,2973,1763,920,843,130,2010,2140,-10,4424,11.355036503,5.925487001,5.429549502,0.8372970762,12.945900948,13.783198024
2020,Virginia,Surry County,6385,-22,60,78,-18,0,-2,-2,-2,0,9.3808630394,12.195121951,-2.814258912,0.0,-0.312695435,-0.312695435
2020,Virginia,Sussex County,10925,-167,78,151,-73,1,-94,-93,-1,2601,7.0854339828,13.71667348,-6.631239497,0.0908388972,-8.538856338,-8.448017441
2020,Virginia,Tazewell County,40529,-205,370,629,-259,8,47,55,-1,1762,9.10623531,15.480600027,-6.374364717,0.1968915743,1.1567379988,1.3536295731
2020,Virginia,Warren County,40475,240,508,438,70,21,146,167,3,679,12.588279024,10.853673646,1.7346053773,0.5203816132,3.6178912155,4.1382728286
2020,Virginia,Washington County,53695,-157,461,656,-195,5,32,37,1,1782,8.5729959924,12.199317508,-3.626321515,0.092982603,0.5950886589,0.6880712619
2020,Virginia,Westmoreland County,18149,120,177,254,-77,-5,203,198,-1,70,9.7849521809,14.041682791,-4.25673061,-0.276411079,11.222289789,10.945878711
2020,Virginia,Wise County,37206,-221,358,478,-120,9,-111,-102,1,2909,9.5936114051,12.809347072,-3.215735667,0.241180175,-2.974555492,-2.733375317
2020,Virginia,Wythe County,28620,2,265,406,-141,-2,145,143,0,260,9.2595827946,14.186379678,-4.926796883,-0.069883644,5.0665641707,4.9966805269
2020,Virginia,York County,69199,620,635,586,49,120,451,571,0,646,9.2177270682,8.5064378928,0.7112891753,1.7419326743,6.5467636343,8.2886963086
2020,Virginia,Alexandria city,158726,-324,2572,893,1679,1186,-3172,-1986,-17,1830,16.187503147,5.6203111626,10.567191984,7.4643774231,-19.96374805,-12.49937063
2020,Virginia,Bristol city,17329,293,171,204,-33,-1,328,327,-1,224,9.9519860323,11.87254474,-1.920558708,-0.058198749,19.089189582,19.030990834
2020,Virginia,Buena Vista city,6402,-79,88,90,-2,3,-80,-77,0,489,13.661414267,13.971900955,-0.310486688,0.4657300318,-12.41946752,-11.95373748
2020,Virginia,Charlottesville city,46950,-333,546,347,199,211,-742,-531,-1,2423,11.588297093,7.3647236106,4.2235734828,4.478261331,-15.74819861,-11.26993728
2020,Virginia,Chesapeake city,247011,1608,2930,2153,777,272,549,821,10,4313,11.900555224,8.7446741969,3.1558810269,1.1047614406,2.2298309959,3.3345924364
2020,Virginia,Colonial Heights city,17205,116,236,217,19,9,88,97,0,171,13.763340526,12.655274975,1.1080655508,0.5248731557,5.1320930775,5.6569662332
2020,Virginia,Covington city,5639,17,81,70,11,9,-4,5,1,87,14.385933754,12.432288429,1.9536453246,1.5984370837,-0.710416482,0.8880206021
2020,Virginia,Danville city,39869,-167,461,710,-249,34,49,83,-1,1578,11.538702209,17.771103185,-6.232400976,0.8510105751,1.226456417,2.0774669921
2020,Virginia,Emporia city,5257,-152,74,87,-13,-1,-137,-138,-1,246,13.875867242,16.313519595,-2.437652353,-0.187511719,-25.68910557,-25.87661729
2020,Virginia,Fairfax city,23429,135,514,256,258,176,-299,-123,0,521,22.002011857,10.958200458,11.043811399,7.5337628149,-12.79883569,-5.265072876
2020,Virginia,Falls Church city,14631,80,179,110,69,37,-26,11,0,42,12.267836337,7.5388938387,4.7289424988,2.5358097457,-1.781920362,0.7538893839
2020,Virginia,Franklin city,7833,-34,128,109,19,0,-54,-54,1,129,16.305732484,13.885350318,2.4203821656,0.0,-6.878980892,-6.878980892
2020,Virginia,Fredericksburg city,29492,238,383,258,125,118,-7,111,2,2676,13.039185647,8.7835767542,4.2556088925,4.0172947945,-0.238314098,3.7789806966
2020,Virginia,Galax city,6296,-28,88,93,-5,-2,-20,-22,-1,377,13.946117274,14.738510301,-0.792393027,-0.316957211,-3.169572108,-3.486529319
2020,Virginia,Hampton city,135464,416,1665,1429,236,164,7,171,9,4915,12.309989945,10.565150529,1.7448394156,1.2125155261,0.0517537115,1.2642692376
2020,Virginia,Harrisonburg city,53204,-175,605,303,302,343,-819,-476,-1,7690,11.352654739,5.6857097286,5.66694501,6.4362984716,-15.36830451,-8.932006042
2020,Virginia,Hopewell city,22375,-148,333,322,11,44,-201,-157,-2,237,14.833622879,14.343623324,0.4899995545,1.9599982182,-8.953628224,-6.993630006
2020,Virginia,Lexington city,7279,33,78,66,12,4,15,19,2,2753,10.74010327,9.0877796902,1.65232358,0.5507745267,2.065404475,2.6161790017
2020,Virginia,Lynchburg city,81561,-192,1067,857,210,249,-651,-402,0,11044,13.066852811,10.495119831,2.5717329806,3.0493405342,-7.97237224,-4.923031706
2020,Virginia,Manassas city,40869,-38,678,234,444,155,-634,-479,-3,46,16.581882215,5.7229504989,10.858931716,3.7908432792,-15.50577186,-11.71492859
2020,Virginia,Manassas Park city,18004,-67,175,59,116,92,-276,-184,1,6,9.702009702,3.270963271,6.431046431,5.1004851005,-15.3014553,-10.2009702
2020,Virginia,Martinsville city,12355,-88,190,245,-55,13,-46,-33,0,377,15.323816437,19.759658037,-4.4358416,1.0484716509,-3.709976611,-2.66150496
2020,Virginia,Newport News city,179062,-674,2674,1721,953,356,-1977,-1621,-6,7958,14.905322772,9.5931415448,5.3121812273,1.9844034805,-11.02012832,-9.035724837
2020,Virginia,Norfolk city,242803,-778,3358,2266,1092,468,-2337,-1869,-1,34025,13.808020001,9.3177407152,4.4902792855,1.9244054081,-9.609691108,-7.6852857
2020,Virginia,Norton city,3985,2,43,31,12,2,-12,-10,0,68,10.793172691,7.781124498,3.0120481928,0.5020080321,-3.012048193,-2.510040161
2020,Virginia,Petersburg city,30446,-147,593,526,67,8,-222,-214,0,884,19.430200364,17.234882616,2.1953177477,0.2621274923,-7.27403791,-7.011910418
2020,Virginia,Poquoson city,12257,29,97,119,-22,4,50,54,-3,51,7.9232182969,9.7202368797,-1.797018583,0.3267306514,4.0841331427,4.4108637942
2020,Virginia,Portsmouth city,95094,512,1418,1088,330,138,42,180,2,3013,14.951812565,11.47219469,3.4796178747,1.4551129294,0.4428604568,1.8979733862
2020,Virginia,Radford city,18255,148,115,105,10,12,123,135,3,3469,6.3252846378,5.7752598867,0.5500247511,0.6600297013,6.7653044387,7.42533414
2020,Virginia,Richmond city,232226,1199,3036,2351,685,583,-51,532,-18,12511,13.107308533,10.149961252,2.9573472811,2.5169831604,-0.22018206,2.2968011
2020,Virginia,Roanoke city,99058,-158,1393,1295,98,296,-549,-253,-3,2100,14.051262394,13.062731372,0.9885310227,2.9857671707,-5.537791138,-2.552023967
2020,Virginia,Salem city,25340,131,227,348,-121,20,233,253,-1,1996,8.9813843993,13.768818374,-4.787433975,0.7913114008,9.2187778195,10.01008922
2020,Virginia,Staunton city,25190,274,348,365,-17,64,227,291,0,992,13.89055203,14.569113479,-0.67856145,2.5545842813,9.0607911228,11.615375404
2020,Virginia,Suffolk city,93913,1636,1150,931,219,43,1378,1421,-4,996,12.35297277,10.000537086,2.352435684,0.4618937644,14.802083893,15.263977657
2020,Virginia,Virginia Beach city,451231,465,5466,3751,1715,643,-1910,-1267,17,9620,12.119774234,8.3171008329,3.8026734014,1.4257253627,-4.235047345,-2.809321982
2020,Virginia,Waynesboro city,22741,325,306,276,30,61,234,295,0,192,13.552716079,12.224018425,1.3286976548,2.7016852315,10.363841708,13.065526939
2020,Virginia,Williamsburg city,15259,240,96,126,-30,38,231,269,1,4282,6.3412378625,8.3228746945,-1.981636832,2.5100733206,15.258603607,17.768676927
2020,Virginia,Winchester city,27700,-336,355,286,69,103,-505,-402,-3,1079,12.738624946,10.262666858,2.4759580881,3.6959954069,-18.12114253,-14.42514712
2020,Washington,Washington,7693612,79588,86443,63769,22674,18301,38473,56774,140,148802,11.294101846,8.3316587878,2.9624430578,2.3910942225,5.0266416055,7.4177358281
2020,Washington,Adams County,20027,68,383,124,259,73,-263,-190,-1,162,19.156704847,6.2021707598,12.954534087,3.6512779473,-13.15460411,-9.503326164
2020,Washington,Asotin County,22820,133,229,291,-62,-5,199,194,1,174,10.064385699,12.789241216,-2.724855517,-0.219746413,8.7459072231,8.5261608104
2020,Washington,Benton County,206426,2253,2590,1623,967,218,1062,1280,6,1421,12.615715089,7.9055233939,4.7101916955,1.0618632778,5.1729302799,6.2347935577
2020,Washington,Chelan County,77574,521,879,760,119,6,396,402,0,931,11.369295143,9.8301072904,1.5391878521,0.0776061102,5.1220032724,5.1996093826
2020,Washington,Clallam County,78067,610,595,1171,-576,73,1121,1194,-8,1815,7.651552172,15.058769065,-7.407216893,0.9387618631,14.415781487,15.35454335
2020,Washington,Clark County,496865,7594,5621,4207,1414,275,5913,6188,-8,3437,11.400050297,8.532291692,2.8677586053,0.557732402,11.992260702,12.549993104
2020,Washington,Columbia County,4048,25,29,48,-19,14,29,43,1,75,7.1862222773,11.894436873,-4.708214595,3.4692107546,7.1862222773,10.655433032
2020,Washington,Cowlitz County,111371,982,1256,1275,-19,9,994,1003,-2,1208,11.327561328,11.498917749,-0.171356421,0.0811688312,8.9646464646,9.0458152958
2020,Washington,Douglas County,43560,309,492,363,129,80,99,179,1,190,11.334969071,8.3629954729,2.9719735978,1.8430844017,2.2808169472,4.1239013489
2020,Washington,Ferry County,7759,83,67,84,-17,1,100,101,-1,251,8.6815678652,10.884353741,-2.202785876,0.1295756398,12.957563978,13.087139618
2020,Washington,Franklin County,97075,1629,1530,486,1044,209,372,581,4,2818,15.894369965,5.0487998712,10.845570094,2.1711917142,3.8645134816,6.0357051958
2020,Washington,Garfield County,2290,24,19,23,-4,3,25,28,0,36,8.3406496927,10.096575944,-1.755926251,1.3169446883,10.974539069,12.291483758
2020,Washington,Grant County,99377,1418,1474,754,720,322,373,695,3,1255,14.938987311,7.6417886245,7.2971986865,3.2634694126,3.7803543195,7.0438237321
2020,Washington,Grays Harbor County,75950,903,748,978,-230,0,1136,1136,-3,2717,9.9074816056,12.953899746,-3.046418141,0.0,15.046656556,15.046656556
2020,Washington,Island County,86014,670,885,817,68,59,550,609,-7,1998,10.329252209,9.5355921521,0.7936600567,0.6886168139,6.4193092823,7.1079260962
2020,Washington,Jefferson County,32700,353,192,437,-245,9,596,605,-7,630,5.9034236783,13.436438268,-7.533014589,0.2767229849,18.325211001,18.601933986
2020,Washington,King County,2274315,24662,24583,15094,9489,11943,3111,15054,119,40296,10.867892965,6.6729030798,4.194989885,5.2798781954,1.3753412933,6.6552194887
2020,Washington,Kitsap County,272787,488,3001,2647,354,89,38,127,7,9538,11.011106504,9.712228896,1.2988776083,0.326553975,0.1394275399,0.4659815148
2020,Washington,Kittitas County,49204,1348,407,363,44,37,1275,1312,-8,2815,8.3865650113,7.4799093344,0.9066556769,0.762415001,26.272408819,27.03482382
2020,Washington,Klickitat County,22697,264,217,234,-17,10,273,283,-2,198,9.6166629736,10.370042101,-0.753379127,0.4431641923,12.098382451,12.541546643
2020,Washington,Lewis County,82109,1510,908,964,-56,63,1512,1575,-9,901,11.161098409,11.849448091,-0.688349682,0.7743933918,18.585441404,19.359834796
2020,Washington,Lincoln County,11090,152,102,123,-21,1,175,176,-3,94,9.260940621,11.167604867,-1.906664246,0.0907935355,15.888868713,15.979662248
2020,Washington,Mason County,68224,1285,638,738,-100,112,1282,1394,-9,2588,9.4404533785,10.920148265,-1.479694887,1.6572582733,18.96968845,20.626946724
2020,Washington,Okanogan County,42620,217,469,530,-61,112,168,280,-2,640,11.032308905,12.467214754,-1.434905849,2.634581231,3.9518718464,6.5864530774
2020,Washington,Pacific County,22984,467,173,364,-191,59,604,663,-5,280,7.6042284785,15.999648359,-8.395419881,2.5933495967,26.548867058,29.142216655
2020,Washington,Pend Oreille County,14144,418,119,167,-48,1,469,470,-4,98,8.5396483674,11.984212415,-3.444564047,0.071761751,33.656261213,33.728022964
2020,Washington,Pierce County,913890,8171,11333,7842,3491,925,3709,4634,46,20763,12.456522253,8.6194341751,3.8370880777,1.0167019398,4.0766999943,5.0934019342
2020,Washington,San Juan County,17492,140,93,146,-53,22,173,195,-2,132,5.3380782918,8.3802089312,-3.042130639,1.2627712088,9.9299735966,11.192744805
2020,Washington,Skagit County,130789,1608,1406,1374,32,290,1289,1579,-3,1627,10.816632688,10.570450437,0.2461822518,2.2310266569,9.9165288302,12.147555487
2020,Washington,Skamania County,12107,11,86,106,-20,13,19,32,-1,25,7.1065570384,8.7592447217,-1.652687683,1.0742469942,1.5700532992,2.6443002934
2020,Washington,Snohomish County,830393,7980,9814,6318,3496,1806,2627,4433,51,10327,11.875561923,7.6451803781,4.2303815451,2.1853744481,3.1788364757,5.3642109237
2020,Washington,Spokane County,528225,5994,5863,5147,716,199,5084,5283,-5,14257,11.162771216,9.7995537176,1.3632174979,0.3788830755,9.6796058093,10.058488885
2020,Washington,Stevens County,46360,545,412,516,-104,2,651,653,-4,266,8.9395172227,11.196094386,-2.256577163,0.0433957147,14.125305126,14.168700841
2020,Washington,Thurston County,294074,4413,3122,2608,514,170,3739,3909,-10,4074,10.696634603,8.9355615134,1.7610730897,0.5824560802,12.810607553,13.393063633
2020,Washington,Wahkiakum County,4498,78,30,58,-28,0,108,108,-2,16,6.7279659116,13.007400763,-6.279434851,0.0,24.220677282,24.220677282
2020,Washington,Walla Walla County,61292,230,614,621,-7,82,155,237,0,4653,10.036451608,10.150873694,-0.114422087,1.340373016,2.5336319205,3.8740049365
2020,Washington,Whatcom County,231016,2341,2122,1931,191,289,1859,2148,2,5861,9.2322886461,8.4012956529,0.8309929931,1.2573663613,8.0880417498,9.3454081111
2020,Washington,Whitman County,49500,-636,348,264,84,275,-994,-719,-1,6767,6.9854269541,5.2992894135,1.6861375406,5.520093139,-19.95262756,-14.43253443
2020,Washington,Yakima County,251879,327,3594,2173,1421,455,-1555,-1100,6,3468,14.278024198,8.6327619872,5.6452622107,1.8075962744,-6.177609245,-4.370012971
2020,West Virginia,West Virginia,1784787,-10476,17571,24297,-6726,996,-4742,-3746,-4,46883,9.8160640215,13.573553442,-3.757489421,0.5564168098,-2.649125012,-2.092708202
2020,West Virginia,Barbour County,16444,-22,152,217,-65,2,41,43,0,853,9.2373138864,13.187481009,-3.950167122,0.1215436038,2.4916438772,2.613187481
2020,West Virginia,Berkeley County,122125,2502,1472,1177,295,36,2179,2215,-8,911,12.177970449,9.7374125122,2.4405579364,0.297830799,18.027036418,18.324867217
2020,West Virginia,Boone County,21055,-297,188,323,-135,-2,-160,-162,0,133,8.8664607258,15.233334119,-6.366873394,-0.09432405,-7.545924022,-7.640248072
2020,West Virginia,Braxton County,13702,-192,111,191,-80,5,-116,-111,-1,383,8.0446441513,13.842585882,-5.797941731,0.3623713582,-8.407015509,-8.044644151
2020,West Virginia,Brooke County,21674,-250,178,326,-148,1,-102,-101,-1,673,8.1655121795,14.954814441,-6.789302262,0.0458736639,-4.679113721,-4.633240057
2020,West Virginia,Cabell County,91589,-308,1013,1177,-164,48,-196,-148,4,3808,11.041714354,12.829316678,-1.787602324,0.5232006802,-2.136402777,-1.613202097
2020,West Virginia,Calhoun County,6945,-132,49,94,-45,0,-87,-87,0,22,6.9890172586,13.407502496,-6.418485237,0.0,-12.40907146,-12.40907146
2020,West Virginia,Clay County,8341,-165,86,115,-29,0,-135,-135,-1,74,10.209532855,13.652282305,-3.442749451,0.0,-16.02659227,-16.02659227
2020,West Virginia,Doddridge County,8368,-83,62,104,-42,3,-46,-43,2,1096,7.3726143053,12.366965931,-4.994351626,0.3567394019,-5.470004162,-5.11326476
2020,West Virginia,Fayette County,42062,-438,396,712,-316,20,-143,-123,1,1817,9.3659090372,16.839715239,-7.473806201,0.4730257089,-3.382133819,-2.90910811
2020,West Virginia,Gilmer County,7811,-77,60,80,-20,8,-64,-56,-1,1759,7.6437989681,10.191731957,-2.547932989,1.0191731957,-8.153385566,-7.13421237
2020,West Virginia,Grant County,11510,24,107,140,-33,0,58,58,-1,126,9.305966255,12.176030614,-2.870064359,0.0,5.0443555401,5.0443555401
2020,West Virginia,Greenbrier County,34319,-315,300,532,-232,21,-103,-82,-1,611,8.7015793366,15.43080069,-6.729221354,0.6091105536,-2.987542239,-2.378431685
2020,West Virginia,Hampshire County,23190,-23,217,287,-70,-2,49,47,0,418,9.3528435661,12.369889878,-3.017046312,-0.086201323,2.1119324182,2.025731095
2020,West Virginia,Hancock County,28571,-263,245,466,-221,-3,-40,-43,1,226,8.5358418256,16.235519554,-7.699677728,-0.104520512,-1.393606829,-1.498127341
2020,West Virginia,Hardy County,13633,-192,162,181,-19,37,-209,-172,-1,58,11.799839755,13.183771578,-1.383931823,2.6950251293,-15.22325005,-12.52822493
2020,West Virginia,Harrison County,66870,-469,705,943,-238,13,-244,-231,0,884,10.506001833,14.052708835,-3.546707002,0.1937276934,-3.636119783,-3.44239209
2020,West Virginia,Jackson County,28453,-208,303,397,-94,20,-133,-113,-1,180,10.610358231,13.90202052,-3.291662289,0.7003536786,-4.657351963,-3.956998284
2020,West Virginia,Jefferson County,57486,139,520,576,-56,55,137,192,3,1078,9.0566300628,10.031959454,-0.975329391,0.9579127951,2.3860736896,3.3439864847
2020,West Virginia,Kanawha County,176253,-2140,1790,2633,-843,118,-1413,-1295,-2,3305,10.09457318,14.848609599,-4.754036419,0.6654523102,-7.968509443,-7.303057133
2020,West Virginia,Lewis County,15805,-72,168,243,-75,-1,2,1,2,247,10.605391074,15.33994066,-4.734549587,-0.063127328,0.1262546556,0.0631273278
2020,West Virginia,Lincoln County,20043,-410,214,331,-117,8,-299,-291,-2,65,10.568945081,16.34729356,-5.778348479,0.3951007507,-14.76689056,-14.37178981
2020,West Virginia,Logan County,31688,-301,318,529,-211,0,-89,-89,-1,681,9.9879077218,16.615104355,-6.627196633,0.0,-2.795357822,-2.795357822
2020,West Virginia,McDowell County,16916,-684,165,353,-188,25,-517,-492,-4,139,9.5607834048,20.454282072,-10.89349867,1.4486035462,-29.95712134,-28.50851779
2020,West Virginia,Marion County,55962,-115,558,716,-158,9,31,40,3,1401,9.9608172154,12.781263667,-2.820446452,0.1606583422,0.5533787342,0.7140370764
2020,West Virginia,Marshall County,30103,-455,269,417,-148,11,-318,-307,0,550,8.8689602875,13.748536951,-4.879576664,0.3626712385,-10.4844958,-10.12182457
2020,West Virginia,Mason County,26335,-237,254,387,-133,5,-109,-104,0,683,9.6017540212,14.629444119,-5.027690098,0.1890109059,-4.120437749,-3.931426843
2020,West Virginia,Mercer County,58258,-565,642,958,-316,8,-259,-251,2,1114,10.966766597,16.364738941,-5.397972344,0.1366575277,-4.424287459,-4.287629931
2020,West Virginia,Mineral County,26722,-182,240,373,-133,0,-48,-48,-1,519,8.9508820348,13.911162496,-4.960280461,0.0,-1.790176407,-1.790176407
2020,West Virginia,Mingo County,22951,-439,252,400,-148,0,-289,-289,-2,85,10.875898233,17.263330528,-6.387432295,0.0,-12.47275631,-12.47275631
2020,West Virginia,Monongalia County,106819,538,975,788,187,387,-45,342,9,6380,9.1506335054,7.3955889254,1.75504458,3.6320976068,-0.422336931,3.2097606757
2020,West Virginia,Monroe County,13229,-66,127,175,-48,7,-25,-18,0,57,9.5762328457,13.195596441,-3.619363595,0.5278238576,-1.885085206,-1.357261348
2020,West Virginia,Morgan County,17873,-2,123,240,-117,-4,119,115,0,123,6.8815038604,13.427324606,-6.545820745,-0.223788743,6.6577151169,6.4339263735
2020,West Virginia,Nicholas County,24340,-229,219,380,-161,16,-83,-67,-1,162,8.9554069803,15.53906234,-6.58365536,0.6542763091,-3.394058353,-2.739782044
2020,West Virginia,Ohio County,41182,-444,408,623,-215,7,-235,-228,-1,2390,9.8541203748,15.046855376,-5.192735001,0.1690657907,-5.675780118,-5.506714327
2020,West Virginia,Pendleton County,6932,-28,59,76,-17,0,-11,-11,0,117,8.4940973222,10.941549093,-2.447451771,0.0,-1.583645263,-1.583645263
2020,West Virginia,Pleasants County,7438,22,72,80,-8,0,31,31,-1,697,9.694358422,10.771509358,-1.077150936,0.0,4.1739598761,4.1739598761
2020,West Virginia,Pocahontas County,8190,-84,70,139,-69,0,-15,-15,0,319,8.5034013605,16.885325559,-8.381924198,0.0,-1.822157434,-1.822157434
2020,West Virginia,Preston County,33380,-99,321,387,-66,21,-56,-35,2,1822,9.6022973721,11.576601505,-1.974304133,0.6281876785,-1.675167143,-1.046979464
2020,West Virginia,Putnam County,56428,-79,495,641,-146,9,59,68,-1,249,8.7661043963,11.351662461,-2.585558064,0.1593837163,1.0448488068,1.2042325231
2020,West Virginia,Raleigh County,72920,-739,766,1112,-346,24,-417,-393,0,3660,10.451701813,15.172705504,-4.721003691,0.3274684641,-5.689764564,-5.3622961
2020,West Virginia,Randolph County,28387,-283,253,409,-156,8,-134,-126,-1,2306,8.8683246578,14.336540652,-5.468215995,0.2804213331,-4.697057329,-4.416635996
2020,West Virginia,Ritchie County,9499,-117,90,165,-75,17,-59,-42,0,106,9.4166884646,17.263928852,-7.847240387,1.7787078211,-6.173162438,-4.394454617
2020,West Virginia,Roane County,13482,-169,122,203,-81,8,-96,-88,0,98,8.9927394685,14.963328788,-5.970589319,0.589687834,-7.076254008,-6.486566174
2020,West Virginia,Summers County,12444,-92,94,166,-72,-1,-19,-20,0,1025,7.5260208167,13.290632506,-5.764611689,-0.080064051,-1.521216974,-1.601281025
2020,West Virginia,Taylor County,16699,-8,138,223,-85,1,76,77,0,509,8.2619888643,13.350895049,-5.088906185,0.0598694845,4.5500808238,4.6099503083
2020,West Virginia,Tucker County,6816,-75,54,136,-82,0,7,7,0,181,7.8791858175,19.843875392,-11.96468957,0.0,1.0213759393,1.0213759393
2020,West Virginia,Tyler County,8533,-89,80,117,-37,7,-58,-51,-1,67,9.3267269018,13.640338094,-4.313611192,0.8160886039,-6.761877004,-5.9457884
2020,West Virginia,Upshur County,24230,-85,242,304,-62,15,-38,-23,0,1225,9.9701308065,12.52446184,-2.554331033,0.6179833145,-1.56555773,-0.947574415
2020,West Virginia,Wayne County,39054,-498,327,582,-255,20,-263,-243,0,246,8.3199755744,14.808029921,-6.488054347,0.5088670076,-6.69160115,-6.182734142
2020,West Virginia,Webster County,8058,-121,82,128,-46,0,-75,-75,0,58,10.100388003,15.766459321,-5.666071319,0.0,-9.238159759,-9.238159759
2020,West Virginia,Wetzel County,14904,-226,168,255,-87,5,-144,-139,0,124,11.187321036,16.980755144,-5.793434108,0.3329559832,-9.589132317,-9.256176333
2020,West Virginia,Wirt County,5705,-78,52,58,-6,0,-71,-71,-1,0,9.0529247911,10.097493036,-1.044568245,0.0,-12.36072423,-12.36072423
2020,West Virginia,Wood County,82938,-730,870,1159,-289,3,-445,-442,1,1007,10.443801544,13.913064355,-3.469262812,0.0360131088,-5.341944468,-5.305931359
2020,West Virginia,Wyoming County,20123,-326,168,373,-205,1,-123,-122,1,56,8.281573499,18.387064971,-10.10549147,0.0492950804,-6.063294883,-6.013999803
2020,Wisconsin,Wisconsin,5832655,8074,63122,54407,8715,4287,-5055,-768,127,142304,10.829668371,9.3344597296,1.4952086412,0.735508829,-0.867272482,-0.131763653
2020,Wisconsin,Adams County,20498,230,133,268,-135,8,360,368,-3,1114,6.525045381,13.148211745,-6.623166364,0.3924839327,17.661776971,18.054260904
2020,Wisconsin,Ashland County,15415,-91,158,190,-32,6,-67,-61,2,578,10.219591863,12.28938262,-2.069790757,0.388085767,-4.333624398,-3.945538631
2020,Wisconsin,Barron County,45090,-136,483,534,-51,31,-117,-86,1,581,10.695779264,11.825147261,-1.129367997,0.6864785863,-2.590903052,-1.904424465
2020,Wisconsin,Bayfield County,15242,70,130,188,-58,3,127,130,-2,113,8.5486946801,12.362727691,-3.814033011,0.1972775695,8.3514171105,8.5486946801
2020,Wisconsin,Brown County,264610,711,3101,2062,1039,155,-499,-344,16,6397,11.7348995,7.8030837696,3.9318157307,0.5865557635,-1.888331135,-1.301775372
2020,Wisconsin,Buffalo County,13033,21,122,134,-12,1,32,33,0,87,9.3684008447,10.289882895,-0.92148205,0.0767901709,2.4572854675,2.5340756383
2020,Wisconsin,Burnett County,15557,167,117,182,-65,0,234,234,-2,135,7.5613145054,11.762044786,-4.200730281,0.0,15.122629011,15.122629011
2020,Wisconsin,Calumet County,50209,97,477,373,104,9,-17,-8,1,167,9.5094745866,7.4361300226,2.0733445639,0.1794240488,-0.338912092,-0.159488043
2020,Wisconsin,Chippewa County,64737,45,689,641,48,3,-8,-5,2,2723,10.646763863,9.9050444645,0.7417193983,0.0463574624,-0.1236199,-0.077262437
2020,Wisconsin,Clark County,34720,-65,579,338,241,15,-320,-305,-1,466,16.660671894,9.7259189986,6.9347528955,0.4316236242,-9.20797065,-8.776347025
2020,Wisconsin,Columbia County,57668,131,592,575,17,16,95,111,3,1362,10.277331713,9.9822056334,0.2951260796,0.277765722,1.6492339742,1.9269996962
2020,Wisconsin,Crawford County,16021,-100,154,191,-37,1,-64,-63,0,759,9.582477755,11.884761371,-2.302283616,0.0622238815,-3.982328418,-3.920104536
2020,Wisconsin,Dane County,552536,4899,5729,3565,2164,1178,1523,2701,34,13436,10.414725684,6.4807989289,3.9339267552,2.1414813852,2.7686554751,4.9101368603
2020,Wisconsin,Dodge County,87336,-290,772,966,-194,15,-113,-98,2,6249,8.8247733794,11.042397778,-2.217624398,0.171465804,-1.291709057,-1.120243253
2020,Wisconsin,Door County,27889,137,203,364,-161,2,300,302,-4,339,7.2967775561,13.083876997,-5.787099441,0.0718894341,10.783415108,10.855304542
2020,Wisconsin,Douglas County,43702,196,401,438,-37,31,202,233,0,1306,9.1964039996,10.044950005,-0.848546005,0.7109439501,4.6326025135,5.3435464636
2020,Wisconsin,Dunn County,45452,68,407,348,59,38,-31,7,2,3282,8.9612048087,7.6621603769,1.2990444317,0.8366726848,-0.682548769,0.1541239156
2020,Wisconsin,Eau Claire County,105260,794,1094,841,253,99,438,537,4,4585,10.432659756,8.0199879843,2.4126717717,0.9440889542,4.1768784032,5.1209673574
2020,Wisconsin,Florence County,4298,-2,25,57,-32,0,30,30,0,54,5.8153058851,13.258897418,-7.443591533,0.0,6.9783670621,6.9783670621
2020,Wisconsin,Fond du Lac County,102902,-177,1042,998,44,65,-290,-225,4,3311,10.117438016,9.690214146,0.4272238702,0.6311261718,-2.81579369,-2.184667518
2020,Wisconsin,Forest County,8960,-74,97,122,-25,1,-50,-49,0,312,10.781371568,13.560075581,-2.778704012,0.1111481605,-5.557408025,-5.446259864
2020,Wisconsin,Grant County,51021,-488,557,526,31,16,-534,-518,-1,4041,10.86511265,10.260411587,0.6047010631,0.3121037745,-10.41646347,-10.1043597
2020,Wisconsin,Green County,36603,-250,343,374,-31,3,-221,-218,-1,350,9.3389239817,10.182966674,-0.844042692,0.0816815509,-6.01720758,-5.935526029
2020,Wisconsin,Green Lake County,18908,-2,193,237,-44,2,39,41,1,177,10.20677984,12.533714104,-2.326934264,0.1057697393,2.0625099159,2.1682796552
2020,Wisconsin,Iowa County,23640,-8,243,205,38,2,-49,-47,1,176,10.277448824,8.6702757571,1.6071730672,0.0845880562,-2.072407376,-1.98781932
2020,Wisconsin,Iron County,5698,10,37,95,-58,0,67,67,1,90,6.4992095556,16.68715967,-10.18795011,0.0,11.768838925,11.768838925
2020,Wisconsin,Jackson County,20630,-46,235,193,42,2,-90,-88,0,1299,11.378492229,9.3448893623,2.0336028664,0.0968382317,-4.357720428,-4.260882196
2020,Wisconsin,Jefferson County,85038,209,774,749,25,10,170,180,4,3159,9.1130119446,8.8186640136,0.294347931,0.1177391724,2.001565931,2.1193051034
2020,Wisconsin,Juneau County,26908,220,254,294,-40,2,261,263,-3,1629,9.4783192776,10.970967983,-1.492648705,0.0746324353,9.739532801,9.8141652362
2020,Wisconsin,Kenosha County,169671,-89,1802,1497,305,8,-411,-403,9,4219,10.617769149,8.82064396,1.7971251889,0.0471377099,-2.421699845,-2.374562135
2020,Wisconsin,Kewaunee County,20386,-65,190,199,-9,8,-63,-55,-1,158,9.3052868722,9.7460636188,-0.440776747,0.3918015525,-3.085437226,-2.693635674
2020,Wisconsin,La Crosse County,118502,351,1147,1080,67,25,251,276,8,5387,9.693517513,9.1272876321,0.5662298809,0.2112798063,2.1212492552,2.3325290615
2020,Wisconsin,Lafayette County,16646,-21,221,156,65,0,-86,-86,0,98,13.268093537,9.365713085,3.9023804521,0.0,-5.163149521,-5.163149521
2020,Wisconsin,Langlade County,19119,-89,200,270,-70,12,-31,-19,0,276,10.436506901,14.089284317,-3.652777415,0.6261904141,-1.61765857,-0.991468156
2020,Wisconsin,Lincoln County,27566,-30,252,323,-71,0,41,41,0,588,9.1367245568,11.710960444,-2.574235887,0.0,1.4865305826,1.4865305826
2020,Wisconsin,Manitowoc County,78757,-28,754,889,-135,19,89,108,-1,983,9.5720506278,11.285879321,-1.713828693,0.2412055198,1.1298574348,1.3710629546
2020,Wisconsin,Marathon County,135593,-104,1532,1228,304,45,-458,-413,5,1429,11.294187032,9.0530428693,2.2411441631,0.3317483136,-3.376460614,-3.0447123
2020,Wisconsin,Marinette County,40262,6,353,560,-207,5,211,216,-3,589,8.7682257383,13.909933183,-5.141707444,0.124195832,5.2410641099,5.3652599419
2020,Wisconsin,Marquette County,15585,48,150,182,-32,0,81,81,-1,137,9.6394833237,11.695906433,-2.056423109,0.0,5.2053209948,5.2053209948
2020,Wisconsin,Menominee County,4546,-7,85,73,12,0,-18,-18,-1,57,18.683371799,16.04571931,2.6376524893,0.0,-3.956478734,-3.956478734
2020,Wisconsin,Milwaukee County,945016,-1995,12911,8761,4150,1397,-7555,-6158,13,22370,13.647796781,9.2609672061,4.3868295748,1.4767231123,-7.986143961,-6.509420849
2020,Wisconsin,Monroe County,46582,-92,567,449,118,23,-233,-210,0,1125,12.160075491,9.6294072231,2.530668268,0.4932658488,-4.996997512,-4.503731663
2020,Wisconsin,Oconto County,38383,326,388,405,-17,3,341,344,-1,257,10.151753009,10.596546311,-0.444793302,0.0784929356,8.9220303506,9.0005232862
2020,Wisconsin,Oneida County,35751,144,309,479,-170,1,316,317,-3,599,8.66055663,13.425264161,-4.764707531,0.0280276914,8.8567504695,8.8847781608
2020,Wisconsin,Outagamie County,188766,839,2193,1504,689,106,32,138,12,2866,11.643433778,7.9852824449,3.6581513328,0.5627925127,0.1698996265,0.7326921392
2020,Wisconsin,Ozaukee County,90043,446,829,879,-50,68,430,498,-2,1929,9.2295702516,9.786239145,-0.556668893,0.7570696949,4.7873524827,5.5444221777
2020,Wisconsin,Pepin County,7271,6,78,87,-9,2,12,14,1,61,10.731975784,11.970280682,-1.238304898,0.2751788663,1.6510731976,1.9262520638
2020,Wisconsin,Pierce County,42700,-68,361,302,59,25,-156,-131,4,2756,8.4476061216,7.0669724341,1.3806336875,0.5850142743,-3.650489072,-3.065474798
2020,Wisconsin,Polk County,43794,89,387,485,-98,4,183,187,0,385,8.8458153807,11.085840981,-2.2400256,0.0914296163,4.1829049475,4.2743345638
2020,Wisconsin,Portage County,71032,89,631,551,80,102,-95,7,2,3037,8.8888888889,7.7619299172,1.1269589716,1.4368726889,-1.338263779,0.09860891
2020,Wisconsin,Price County,13245,-102,108,171,-63,4,-41,-37,-2,157,8.1227436823,12.86101083,-4.738267148,0.3008423586,-3.083634176,-2.782791817
2020,Wisconsin,Racine County,195802,-402,2267,1885,382,82,-872,-790,6,4910,11.566149498,9.6171997367,1.948949761,0.4183609435,-4.448911496,-4.030550553
2020,Wisconsin,Richland County,17258,-55,162,186,-24,14,-45,-31,0,295,9.3720170085,10.760463973,-1.388446964,0.8099273958,-2.603338058,-1.793410662
2020,Wisconsin,Rock County,163084,-36,1832,1578,254,23,-319,-296,6,2512,11.232235043,9.6749273461,1.557307697,0.1410160513,-1.95583132,-1.814815269
2020,Wisconsin,Rusk County,14022,-69,143,180,-37,4,-36,-32,0,161,10.173229467,12.805463664,-2.632234198,0.2845658592,-2.561092733,-2.276526874
2020,Wisconsin,St. Croix County,91838,1147,995,666,329,-3,819,816,2,749,10.902377157,7.2974705389,3.6049066176,-0.032871489,8.9739164735,8.9410449846
2020,Wisconsin,Sauk County,64449,29,725,650,75,36,-83,-47,1,724,11.251736259,10.087763543,1.1639727165,0.5587069039,-1.288129806,-0.729422902
2020,Wisconsin,Sawyer County,16700,160,136,222,-86,2,246,248,-2,314,8.182912154,13.357400722,-5.174488568,0.1203369434,14.801444043,14.921780987
2020,Wisconsin,Shawano County,40786,-8,430,452,-22,4,9,13,1,661,10.541799461,11.08114734,-0.539347879,0.0980632508,0.2206423143,0.3187055651
2020,Wisconsin,Sheboygan County,115240,8,1229,1150,79,48,-122,-74,3,2818,10.665069943,9.9795202888,0.6855496546,0.416536499,-1.058696935,-0.642160436
2020,Wisconsin,Taylor County,20318,-22,212,193,19,4,-44,-40,-1,186,10.428451965,9.4938265532,0.934625412,0.1967632446,-2.164395691,-1.967632446
2020,Wisconsin,Trempealeau County,29681,98,404,281,123,12,-37,-25,0,450,13.633909287,9.4829913607,4.1509179266,0.4049676026,-1.248650108,-0.843682505
2020,Wisconsin,Vernon County,30861,-16,409,329,80,4,-102,-98,2,323,13.249538372,10.657941624,2.5915967475,0.1295798374,-3.304285853,-3.174706016
2020,Wisconsin,Vilas County,22356,203,179,332,-153,2,358,360,-4,231,8.0433170819,14.918331124,-6.875014042,0.0898694646,16.086634164,16.176503628
2020,Wisconsin,Walworth County,103953,55,933,1021,-88,-9,149,140,3,3029,8.9775849046,9.8243453243,-0.84676042,-0.086600497,1.433719347,1.3471188496
2020,Wisconsin,Washburn County,15712,-52,117,238,-121,3,67,70,-1,201,7.4342356081,15.122633117,-7.688397509,0.1906214258,4.2572118439,4.4478332698
2020,Wisconsin,Washington County,136445,143,1280,1259,21,41,77,118,4,977,9.3859877469,9.2319988854,0.1539888615,0.30064492,0.5646258254,0.8652707454
2020,Wisconsin,Waukesha County,406172,1627,3810,3765,45,322,1261,1583,-1,5335,9.3990874744,9.2880746302,0.1110128442,0.794358574,3.1108265893,3.9051851633
2020,Wisconsin,Waupaca County,50664,-199,527,742,-215,5,10,15,1,1389,10.381474879,14.616801442,-4.235326563,0.0984959666,0.1969919332,0.2954878998
2020,Wisconsin,Waushara County,24326,-62,195,283,-88,4,23,27,-1,1178,8.0059120581,11.618836474,-3.612924416,0.1642238371,0.9442870633,1.1085109004
2020,Wisconsin,Winnebago County,171631,-170,1770,1598,172,109,-458,-349,7,7408,10.307717394,9.3060635002,1.0016538936,0.6347690372,-2.66719467,-2.032425633
2020,Wisconsin,Wood County,72560,-235,778,819,-41,9,-204,-195,1,713,10.704826115,11.268962196,-0.564136081,0.1238347494,-2.806920987,-2.683086237
2020,Wyoming,Wyoming,582328,2212,6367,5464,903,174,1129,1303,6,14365,10.954506196,9.4008829673,1.5536232283,0.2993692599,1.9424591636,2.2418284236
2020,Wyoming,Albany County,38950,131,335,213,122,45,-39,6,3,2262,8.6152580077,5.4777610616,3.1374969461,1.1572734637,-1.002970335,0.1543031285
2020,Wyoming,Big Horn County,11575,-171,116,153,-37,1,-133,-132,-2,183,9.9481154324,13.121221217,-3.173105784,0.0857596158,-11.4060289,-11.32026929
2020,Wyoming,Campbell County,46676,256,583,367,216,-12,49,37,3,518,12.52470568,7.8843344505,4.6403712297,-0.257798402,1.0526768067,0.7948784051
2020,Wyoming,Carbon County,14711,-121,168,143,25,9,-155,-146,0,752,11.373252547,9.6808042514,1.6924482957,0.6092813865,-10.49317943,-9.883898047
2020,Wyoming,Converse County,13804,-61,161,126,35,4,-100,-96,0,103,11.637572735,9.1076656186,2.5299071163,0.2891322419,-7.228306046,-6.939173805
2020,Wyoming,Crook County,7593,20,104,73,31,2,-14,-12,1,34,13.714888567,9.6267967823,4.0880917843,0.263747857,-1.846234999,-1.582487142
2020,Wyoming,Fremont County,39317,-150,493,525,-32,-5,-113,-118,0,1059,12.515231519,13.327579204,-0.812347685,-0.126929326,-2.868602762,-2.995532088
2020,Wyoming,Goshen County,13235,10,112,149,-37,2,45,47,0,1239,8.4656084656,11.262282691,-2.796674225,0.1511715797,3.4013605442,3.552532124
2020,Wyoming,Hot Springs County,4425,10,45,85,-40,1,49,50,0,86,10.180995475,19.230769231,-9.049773756,0.2262443439,11.085972851,11.312217195
2020,Wyoming,Johnson County,8588,40,71,88,-17,0,56,56,1,71,8.2866479925,10.270774977,-1.984126984,0.0,6.5359477124,6.5359477124
2020,Wyoming,Laramie County,100595,730,1212,960,252,-6,480,474,4,2076,12.092187968,9.5779706675,2.5142173002,-0.059862317,4.7889853337,4.7291230171
2020,Wyoming,Lincoln County,20253,319,231,162,69,3,248,251,-1,71,11.496255008,8.0623087068,3.433946301,0.1493020131,12.342299749,12.491601762
2020,Wyoming,Natrona County,80815,1081,931,804,127,19,938,957,-3,1668,11.597705373,10.015633856,1.5820715171,0.2366878648,11.684906166,11.92159403
2020,Wyoming,Niobrara County,2275,-65,26,14,12,0,-77,-77,0,249,11.267605634,6.0671722644,5.2004333694,0.0,-33.36944745,-33.36944745
2020,Wyoming,Park County,29331,139,269,306,-37,0,178,178,-2,547,9.1929668677,10.457426995,-1.264460127,0.0,6.0830784478,6.0830784478
2020,Wyoming,Platte County,8578,103,76,98,-22,-1,127,126,-1,102,8.9133876737,11.493578842,-2.580191169,-0.117281417,14.894739928,14.777458512
2020,Wyoming,Sheridan County,30863,266,293,352,-59,45,282,327,-2,1049,9.5346566873,11.454604621,-1.919947934,1.464367068,9.1767002929,10.641067361
2020,Wyoming,Sublette County,9856,-11,77,75,2,5,-18,-13,0,550,7.8081427775,7.6053338742,0.2028089033,0.5070222583,-1.82528013,-1.318257872
2020,Wyoming,Sweetwater County,42673,-244,481,319,162,47,-454,-407,1,807,11.239630798,7.454141839,3.785488959,1.0982591424,-10.60871597,-9.510456829
2020,Wyoming,Teton County,23497,112,225,124,101,18,-9,9,2,269,9.5985666141,5.2898767117,4.3086899023,0.7678853291,-0.383942665,0.3839426646
2020,Wyoming,Uinta County,20215,19,232,171,61,-2,-42,-44,2,217,11.482022222,8.463042241,3.0189799807,-0.09898295,-2.078641954,-2.177624904
2020,Wyoming,Washakie County,7760,-64,73,85,-12,-3,-50,-53,1,140,9.3685831622,10.90862423,-1.540041068,-0.385010267,-6.416837782,-6.801848049
2020,Wyoming,Weston County,6743,-137,53,72,-19,2,-119,-117,-1,313,7.7809586728,10.570358952,-2.789400279,0.293621082,-17.47045438,-17.1768333
2024,Alabama,Alabama,5108468,34565,58251,59813,-1562,5384,30744,36128,-1,144014,11.4415395,11.748344271,-0.306804771,1.0575140112,6.0386721325,7.0961861437
2024,Alabama,Autauga County,60342,616,714,621,93,34,491,525,-2,484,11.893260486,10.344138322,1.5491221641,0.5663457374,8.1786987374,8.7450444748
2024,Alabama,Baldwin County,253507,6976,2531,2640,-109,291,6804,7095,-10,3493,10.123230634,10.559197501,-0.435966867,1.1639115427,27.213931741,28.377843284
2024,Alabama,Barbour County,24585,-115,267,350,-83,13,-45,-32,0,2702,10.834939637,14.203104393,-3.368164756,0.5275438774,-1.826113422,-1.298569544
2024,Alabama,Bibb County,21868,-118,240,290,-50,1,-69,-68,0,1894,10.945409769,13.225703471,-2.280293702,0.045605874,-3.146805309,-3.101199434
2024,Alabama,Blount County,59816,300,698,776,-78,24,358,382,-4,616,11.698454731,13.005731908,-1.307277176,0.4022391312,6.0000670399,6.402306171
2024,Alabama,Bullock County,9897,-246,102,133,-31,6,-219,-213,-2,1615,10.179640719,13.273453094,-3.093812375,0.5988023952,-21.85628743,-21.25748503
2024,Alabama,Butler County,18382,-286,212,299,-87,8,-207,-199,0,285,11.443994602,16.140350877,-4.696356275,0.4318488529,-11.17408907,-10.74224022
2024,Alabama,Calhoun County,116429,649,1346,1649,-303,29,923,952,0,5936,11.593004578,14.202722547,-2.60971797,0.2497749872,7.9497349371,8.1995099242
2024,Alabama,Chambers County,34079,-85,398,511,-113,55,-26,29,-1,860,11.664199991,14.975894964,-3.311694972,1.6118869335,-0.761982914,0.8499040195
2024,Alabama,Cherokee County,25666,313,230,409,-179,14,482,496,-4,278,9.0162488485,16.033242517,-7.016993669,0.5488151473,18.8949215,19.443736647
2024,Alabama,Chilton County,46431,583,548,588,-40,49,577,626,-3,388,11.877025109,12.743961248,-0.866936139,1.0619967707,12.50555381,13.56755058
2024,Alabama,Choctaw County,12252,-179,108,200,-92,2,-88,-86,-1,66,8.7509622007,16.205485557,-7.454523356,0.1620548556,-7.130413645,-6.968358789
2024,Alabama,Clarke County,22337,-237,293,366,-73,0,-165,-165,1,372,13.048028323,16.298902273,-3.250873951,0.0,-7.347865779,-7.347865779
2024,Alabama,Clay County,14111,-72,159,230,-71,-3,2,-1,0,258,11.239131971,16.257863858,-5.018731887,-0.212059094,0.1413727292,-0.070686365
2024,Alabama,Cleburne County,15639,267,177,229,-52,-1,322,321,-2,174,11.415304247,14.768952952,-3.353648705,-0.064493244,20.766824675,20.702331431
2024,Alabama,Coffee County,55643,803,676,630,46,68,695,763,-6,761,12.23717676,11.404469466,0.8327072943,1.230958609,12.581121077,13.812079686
2024,Alabama,Colbert County,58361,368,636,801,-165,47,489,536,-3,407,10.932155319,13.76832769,-2.836172371,0.8078794025,8.4053835708,9.2132629733
2024,Alabama,Conecuh County,11174,-50,134,205,-71,0,20,20,1,128,11.965354049,18.305205822,-6.339851772,0.0,1.7858737387,1.7858737387
2024,Alabama,Coosa County,10268,-39,89,174,-85,-1,49,48,-2,310,8.6512758202,16.913730255,-8.262454435,-0.097205346,4.7630619684,4.6658566221
2024,Alabama,Covington County,37952,349,418,653,-235,-1,589,588,-4,778,11.064787241,17.285421216,-6.220633975,-0.026470783,15.591291112,15.56482033
2024,Alabama,Crenshaw County,13101,53,157,225,-68,27,95,122,-1,153,12.008107385,17.209071093,-5.200963708,2.0650885311,7.2660522391,9.3311407702
2024,Alabama,Cullman County,92016,1353,1015,1146,-131,16,1471,1487,-3,1257,11.112388397,12.546598131,-1.434209734,0.1751706545,16.104752051,16.279922706
2024,Alabama,Dale County,49871,376,692,623,69,49,257,306,1,757,13.928305457,12.539500433,1.3888050239,0.986252843,5.1727955236,6.1590483666
2024,Alabama,Dallas County,36165,-564,428,572,-144,37,-458,-421,1,476,11.743078991,15.694021456,-3.950942464,1.0151727165,-12.566192,-11.55101929
2024,Alabama,DeKalb County,72569,487,835,945,-110,100,495,595,2,848,11.54502907,13.065931103,-1.520902033,1.382638212,6.8440591493,8.2266973612
2024,Alabama,Elmore County,90441,841,935,942,-7,29,822,851,-3,5429,10.38652307,10.464283136,-0.077760066,0.3221488439,9.1312534367,9.4534022806
2024,Alabama,Escambia County,36558,-78,428,582,-154,2,74,76,0,2067,11.694947673,15.902942864,-4.207995191,0.0546492882,2.0220236631,2.0766729513
2024,Alabama,Etowah County,103241,338,1170,1630,-460,69,733,802,-4,1592,11.35128842,15.81418814,-4.462899721,0.6694349581,7.1115336852,7.7809686433
2024,Alabama,Fayette County,15967,-115,180,276,-96,0,-18,-18,-1,303,11.232799775,17.223626322,-5.990826547,0.0,-1.123279978,-1.123279978
2024,Alabama,Franklin County,31802,-108,430,449,-19,54,-144,-90,1,424,13.498242089,14.094676042,-0.596433953,1.6951280763,-4.520341537,-2.825213461
2024,Alabama,Geneva County,26988,228,294,451,-157,17,369,386,-1,266,10.939941951,16.782019796,-5.842077845,0.6325816775,13.73074347,14.363325147
2024,Alabama,Greene County,7341,-111,84,126,-42,0,-68,-68,-1,60,11.356722774,17.035084161,-5.678361387,0.0,-9.193537484,-9.193537484
2024,Alabama,Hale County,14888,289,213,251,-38,1,327,328,-1,181,14.44704446,17.024451453,-2.577406993,0.0678264998,22.179265439,22.247091939
2024,Alabama,Henry County,17899,229,173,261,-88,0,319,319,-2,140,9.7275717619,14.675700751,-4.948128989,0.0,17.936967584,17.936967584
2024,Alabama,Houston County,108462,415,1306,1349,-43,83,374,457,1,822,12.064163614,12.46137574,-0.397212125,0.7667117764,3.4548217395,4.2215335159
2024,Alabama,Jackson County,53467,544,549,841,-292,29,809,838,-2,603,10.320518846,15.809756556,-5.48923771,0.5451640192,15.208196259,15.753360278
2024,Alabama,Jefferson County,662895,-2189,7967,7573,394,818,-3417,-2599,16,20631,11.998683714,11.405300837,0.5933828773,1.2319471919,-5.146165715,-3.914218523
2024,Alabama,Lamar County,13661,-45,155,238,-83,-1,38,37,1,152,11.327511236,17.393210801,-6.065699565,-0.073080718,2.7770672708,2.7039865531
2024,Alabama,Lauderdale County,96814,939,948,1183,-235,58,1103,1161,13,4676,9.8396898629,12.278853489,-2.439163626,0.6020063418,11.448499914,12.050506256
2024,Alabama,Lawrence County,33502,315,386,492,-106,-1,420,419,2,219,11.576121999,14.755057056,-3.178935057,-0.029989953,12.595780414,12.56579046
2024,Alabama,Lee County,183215,2517,1899,1313,586,575,1357,1932,-1,5213,10.436560387,7.2160104201,3.2205499666,3.160095957,7.4578264585,10.617922416
2024,Alabama,Limestone County,114654,3786,1204,1040,164,104,3523,3627,-5,3054,10.677450537,9.2230469755,1.4544035615,0.9223046975,31.243071629,32.165376327
2024,Alabama,Lowndes County,9717,-66,120,169,-49,1,-17,-16,-1,183,12.307692308,17.333333333,-5.025641026,0.1025641026,-1.743589744,-1.641025641
2024,Alabama,Macon County,18370,-162,162,241,-79,24,-107,-83,0,2053,8.7800119235,13.061622676,-4.281610753,1.3007425072,-5.799143678,-4.498401171
2024,Alabama,Madison County,412600,8995,4470,3616,854,789,7340,8129,12,11879,10.953130647,8.8605191098,2.0926115375,1.9333378257,17.985677618,19.919015443
2024,Alabama,Marengo County,18684,-107,220,301,-81,14,-41,-27,1,239,11.741160774,16.064042695,-4.322881921,0.7471647765,-2.188125417,-1.44096064
2024,Alabama,Marion County,29244,62,309,441,-132,1,192,193,1,734,10.577482628,15.096018896,-4.518536268,0.0342313354,6.57241639,6.6066477253
2024,Alabama,Marshall County,100756,1328,1535,1256,279,181,866,1047,2,1020,15.33589098,12.548455421,2.7874355593,1.8083363306,8.6520401231,10.460376454
2024,Alabama,Mobile County,411640,242,5075,4765,310,325,-405,-80,12,7773,12.332358895,11.579052243,0.7533066517,0.7897569736,-0.98415869,-0.194401717
2024,Alabama,Monroe County,19229,-183,231,319,-88,1,-98,-97,2,193,11.956212313,16.510959861,-4.554747548,0.0517584949,-5.072332497,-5.020574002
2024,Alabama,Montgomery County,224980,-1321,3003,2360,643,439,-2418,-1979,15,8732,13.308781003,10.459115274,2.8496657293,1.9455727141,-10.71616133,-8.770588613
2024,Alabama,Morgan County,125133,902,1461,1506,-45,106,840,946,1,2229,11.717810109,12.078728285,-0.360918176,0.8501628142,6.7371392823,7.5873020965
2024,Alabama,Perry County,7738,-166,89,141,-52,1,-114,-113,-1,314,11.379618975,18.028385117,-6.648766142,0.1278608874,-14.57614116,-14.44828027
2024,Alabama,Pickens County,18688,-61,186,283,-97,14,22,36,0,1983,9.9366936453,15.118732804,-5.182039159,0.7479231776,1.1753078505,1.9232310281
2024,Alabama,Pike County,33137,129,360,396,-36,66,100,166,-1,2079,10.885176506,11.973694157,-1.088517651,1.9956156928,3.0236601406,5.0192758334
2024,Alabama,Randolph County,22786,326,249,336,-87,10,404,414,-1,590,11.006497812,14.852141626,-3.845643814,0.4420280246,17.857932193,18.299960217
2024,Alabama,Russell County,58744,150,688,710,-22,24,149,173,-1,530,11.72680632,12.101791406,-0.374985086,0.4090746391,2.5396717176,2.9487463567
2024,Alabama,St. Clair County,95552,1671,1032,1156,-124,18,1777,1795,0,2109,10.895672876,12.204842873,-1.309169997,0.190040806,18.76125068,18.951291486
2024,Alabama,Shelby County,233000,2967,2390,1727,663,248,2078,2326,-22,3330,10.323238301,7.4595115251,2.8637267754,1.0711979492,8.9756021709,10.04680012
2024,Alabama,Sumter County,11727,-162,114,161,-47,21,-136,-115,0,922,9.6544715447,13.634823848,-3.980352304,1.7784552846,-11.51761518,-9.739159892
2024,Alabama,Talladega County,81132,384,871,1147,-276,25,633,658,2,2516,10.761057574,14.170990857,-3.409933284,0.3088707685,7.8206078577,8.1294786261
2024,Alabama,Tallapoosa County,40677,-236,392,637,-245,19,-11,8,1,680,9.6090207133,15.614658659,-6.005637946,0.4657433509,-0.269640887,0.1961024635
2024,Alabama,Tuscaloosa County,237373,683,2510,2004,506,298,-128,170,7,21021,10.58930986,8.4545724935,2.1347373661,1.2572168678,-0.540012614,0.7172042534
2024,Alabama,Walker County,64728,290,808,1096,-288,39,539,578,0,1081,12.511032315,16.97041017,-4.459377855,0.6038740845,8.345849527,8.9497236115
2024,Alabama,Washington County,15022,-72,187,229,-42,-1,-29,-30,0,125,12.418647895,15.20786293,-2.789215035,-0.066409882,-1.925886572,-1.992296454
2024,Alabama,Wilcox County,9944,-195,116,166,-50,2,-147,-145,0,228,11.552058955,16.531394712,-4.979335757,0.1991734303,-14.63924712,-14.44007369
2024,Alabama,Winston County,23611,-130,249,388,-139,18,-8,10,-1,343,10.516979219,16.387903362,-5.870924143,0.760263558,-0.337894915,0.4223686434
2024,Alaska,Alaska,733406,130,9266,5581,3685,2004,-5543,-3539,-16,29815,12.635322449,7.6103749824,5.0249474665,2.7326987036,-7.558557342,-4.825858639
2024,Alaska,Aleutians East Borough,3461,31,17,10,7,77,-53,24,0,2216,4.9339718473,2.9023363808,2.0316354666,22.347990132,-15.38238282,6.9656073139
2024,Alaska,Aleutians West Census Area,5160,70,25,16,9,131,-67,64,-3,2931,4.8780487805,3.1219512195,1.756097561,25.56097561,-13.07317073,12.487804878
2024,Alaska,Anchorage Municipality,286075,-908,3573,2177,1396,1115,-3412,-2297,-7,8916,12.46994196,7.5978347741,4.8721071864,3.8914036625,-11.90804421,-8.016640549
2024,Alaska,Bethel Census Area,18224,-35,389,155,234,5,-276,-271,2,486,21.325000685,8.4971082422,12.827892443,0.2741002659,-15.13033468,-14.85623441
2024,Alaska,Bristol Bay Borough,844,-26,11,7,4,6,-34,-28,-2,27,12.835472579,8.1680280047,4.6674445741,7.0011668611,-39.67327888,-32.67211202
2024,Alaska,Chugach Census Area,6769,-130,62,24,38,15,-183,-168,0,273,9.0722856307,3.5118525022,5.5604331285,2.1949078139,-26.77787533,-24.58296752
2024,Alaska,Copper River Census Area,2674,65,32,18,14,-1,53,52,-1,25,12.11432898,6.8143100511,5.3000189286,-0.378572781,20.064357373,19.685784592
2024,Alaska,Denali Borough,1584,9,20,9,11,6,-9,-3,1,23,12.662234884,5.698005698,6.9642291865,3.7986704653,-5.698005698,-1.899335233
2024,Alaska,Dillingham Census Area,4607,-117,75,47,28,12,-156,-144,-1,42,16.075447433,10.073947058,6.0015003751,2.5720715893,-33.43693066,-30.86485907
2024,Alaska,Fairbanks North Star Borough,94840,-362,1427,606,821,214,-1391,-1177,-6,3297,15.017732922,6.377537597,8.6401953252,2.2521337389,-14.6388693,-12.38673556
2024,Alaska,Haines Borough,2070,0,24,17,7,6,-12,-6,-1,22,11.594202899,8.2125603865,3.3816425121,2.8985507246,-5.797101449,-2.898550725
2024,Alaska,Hoonah-Angoon Census Area,2262,-17,18,28,-10,3,-9,-6,-1,28,7.9277692138,12.332085444,-4.40431623,1.321294869,-3.963884607,-2.642589738
2024,Alaska,Juneau City and Borough,31555,-185,284,214,70,58,-314,-256,1,902,8.973852595,6.7619875188,2.2118650762,1.832688206,-9.921794771,-8.089106564
2024,Alaska,Kenai Peninsula Borough,61223,612,636,549,87,38,486,524,1,1802,10.440435346,9.0122625868,1.4281727597,0.6237995962,7.9780685195,8.6018681156
2024,Alaska,Ketchikan Gateway Borough,13738,-34,119,109,10,29,-72,-43,-1,380,8.6513994911,7.9243911305,0.7270083606,2.1083242457,-5.234460196,-3.126135951
2024,Alaska,Kodiak Island Borough,12565,-74,158,88,70,91,-234,-143,-1,457,12.53769243,6.9830185685,5.5546738613,7.2210760197,-18.56848119,-11.34740517
2024,Alaska,Kusilvak Census Area,8001,-213,216,72,144,1,-356,-355,-2,14,26.64199815,8.88066605,17.7613321,0.123342584,-43.90995991,-43.78661733
2024,Alaska,Lake and Peninsula Borough,1331,-46,16,11,5,1,-51,-50,-1,31,11.816838996,8.1240768095,3.6927621861,0.7385524372,-37.6661743,-36.92762186
2024,Alaska,Matanuska-Susitna Borough,115239,1767,1370,862,508,57,1198,1255,4,2823,11.9801846,7.5378971715,4.4422874282,0.4984456366,10.47610303,10.974548666
2024,Alaska,Nome Census Area,9763,-28,169,84,85,8,-124,-116,3,283,17.285465889,8.591592513,8.6938733763,0.818246906,-12.68282704,-11.86458014
2024,Alaska,North Slope Borough,10603,-208,126,63,63,43,-313,-270,-1,3193,11.768002242,5.8840011208,5.8840011208,4.016064257,-29.23321192,-25.21714766
2024,Alaska,Northwest Arctic Borough,7361,-92,141,79,62,-1,-154,-155,1,237,19.036046983,10.665586607,8.3704603753,-0.135007425,-20.79114351,-20.92615094
2024,Alaska,Petersburg Borough,3427,57,25,28,-3,25,37,62,-2,186,7.3561865529,8.2389289392,-0.882742386,7.3561865529,10.887156098,18.243342651
2024,Alaska,Prince of Wales-Hyder Census Area,5696,46,73,76,-3,2,48,50,-1,37,12.867971091,13.396791821,-0.52882073,0.3525471532,8.4611316764,8.8136788295
2024,Alaska,Sitka City and Borough,8282,-71,76,69,7,21,-98,-77,-1,330,9.1373609859,8.2957619477,0.8415990382,2.5247971145,-11.78238653,-9.25758942
2024,Alaska,Skagway Municipality,1095,3,9,8,1,4,-4,0,2,29,8.2304526749,7.3159579332,0.9144947417,3.6579789666,-3.657978967,0.0
2024,Alaska,Southeast Fairbanks Census Area,7077,61,98,54,44,23,-8,15,2,638,13.907613709,7.6633789825,6.2442347265,3.2640317888,-1.135315405,2.128716384
2024,Alaska,Wrangell City and Borough,2064,-7,19,24,-5,0,-1,-1,-1,25,9.1898428053,11.608222491,-2.418379686,0.0,-0.483675937,-0.483675937
2024,Alaska,Yakutat City and Borough,687,2,3,2,1,1,0,1,0,36,4.3731778426,2.915451895,1.4577259475,1.4577259475,0.0,1.4577259475
2024,Alaska,Yukon-Koyukuk Census Area,5129,-40,55,75,-20,14,-34,-20,0,126,10.681685764,14.565935133,-3.884249369,2.7189745582,-6.603223927,-3.884249369
2024,Arizona,Arizona,7431344,65660,78494,70792,7702,21635,36179,57814,144,162728,10.609427785,9.5684079262,1.0410198589,2.9242358668,4.8900360262,7.814271893
2024,Arizona,Apache County,65036,-497,724,975,-251,56,-302,-246,0,1203,11.089921804,14.934632263,-3.84471046,0.8577840069,-4.625906609,-3.768122602
2024,Arizona,Cochise County,124640,-847,1246,1612,-366,228,-695,-467,-14,3421,9.9629388271,12.889452158,-2.926513331,1.8230738785,-5.557176954,-3.734103076
2024,Arizona,Coconino County,144472,249,1315,1059,256,292,-296,-4,-3,11776,9.1099603388,7.3364623565,1.7734979823,2.0228961361,-2.050607042,-0.027710906
2024,Arizona,Gila County,54003,81,453,931,-478,-6,562,556,3,829,8.3947185546,17.252721798,-8.858003243,-0.111188325,10.414639796,10.303451471
2024,Arizona,Graham County,39525,703,493,408,85,-2,614,612,6,2455,12.585038355,10.415204156,2.1698341991,-0.051054922,15.673861156,15.622806234
2024,Arizona,Greenlee County,9369,42,118,98,20,31,-9,22,0,1,12.623020967,10.483525888,2.1394950792,3.3162173727,-0.962772786,2.3534445871
2024,Arizona,La Paz County,16710,175,165,376,-211,78,312,390,-4,176,9.9263047075,22.619942849,-12.69363814,4.6924349526,18.76973981,23.462174763
2024,Arizona,Maricopa County,4585871,30038,50795,38287,12508,15217,2179,17396,134,77694,11.112807853,8.3763377156,2.7364701373,3.3291386376,0.4767163759,3.8058550135
2024,Arizona,Mohave County,223682,2777,1736,3993,-2257,81,4952,5033,1,4527,7.8094951044,17.962738452,-10.15324335,0.3643831241,22.276854699,22.641237823
2024,Arizona,Navajo County,109175,375,1228,1597,-369,38,707,745,-1,1550,11.267347173,14.653056543,-3.38570937,0.3486638376,6.4869824521,6.8356462897
2024,Arizona,Pima County,1063162,5686,10006,11276,-1270,3105,3823,6928,28,26988,9.4367827041,10.634535456,-1.197752752,2.9283640112,3.6055187165,6.5338827277
2024,Arizona,Pinal County,484239,19202,5015,4293,722,1033,17463,18496,-16,20632,10.565947101,9.0447878172,1.5211592835,2.1763954846,36.792250094,38.968645578
2024,Arizona,Santa Cruz County,49158,478,554,382,172,332,-27,305,1,115,11.324843108,7.8088268362,3.5160162718,6.7867290828,-0.551932787,6.2347962959
2024,Arizona,Yavapai County,249081,2851,1777,3587,-1810,153,4514,4667,-6,3989,7.1752898684,14.483829352,-7.308539483,0.617793669,18.22693217,18.844725839
2024,Arizona,Yuma County,213221,4347,2869,1918,951,999,2382,3381,15,7372,13.594096116,9.0880015162,4.5060945996,4.733531551,11.286558713,16.020090264
2024,Arkansas,Arkansas,3067732,21328,35566,36473,-907,4096,18106,22202,33,85120,11.634023188,11.930712696,-0.296689508,1.3398458916,5.9226683868,7.2625142784
2024,Arkansas,Arkansas County,16307,-191,186,305,-119,-1,-71,-72,0,322,11.339734797,18.594726414,-7.254991617,-0.060966316,-4.328608444,-4.38957476
2024,Arkansas,Ashley County,18262,-86,199,315,-116,-2,36,34,-4,154,10.871346627,17.208413002,-6.337066375,-0.109259765,1.9666757716,1.8574160066
2024,Arkansas,Baxter County,42875,390,349,801,-452,-4,843,839,3,522,8.1771321462,18.767572634,-10.59044049,-0.093720712,19.751640112,19.6579194
2024,Arkansas,Benton County,311013,8191,3908,2211,1697,1096,5376,6472,22,3030,12.733063445,7.2038902963,5.5291731491,3.5709922047,17.516107749,21.087099954
2024,Arkansas,Boone County,38530,250,406,526,-120,-2,376,374,-4,445,10.571540164,13.696133316,-3.124593152,-0.052076553,9.7903918761,9.7383153235
2024,Arkansas,Bradley County,10104,-64,118,154,-36,-5,-24,-29,1,218,11.641673244,15.193370166,-3.551696922,-0.493291239,-2.367797948,-2.861089187
2024,Arkansas,Calhoun County,4641,-46,51,88,-37,0,-8,-8,-1,149,10.934819897,18.867924528,-7.933104631,0.0,-1.715265866,-1.715265866
2024,Arkansas,Carroll County,28814,97,326,371,-45,36,104,140,2,230,11.333020459,12.897394448,-1.56437399,1.2514991917,3.6154421095,4.8669413012
2024,Arkansas,Chicot County,9538,-296,88,173,-85,-1,-209,-210,-1,690,9.0852777204,17.860830064,-8.775552344,-0.103241792,-21.57753459,-21.68077638
2024,Arkansas,Clark County,21274,-2,239,289,-50,8,40,48,0,2767,11.233842538,13.584018801,-2.350176263,0.3760282021,1.8801410106,2.2561692127
2024,Arkansas,Clay County,14201,-70,157,242,-85,-2,17,15,0,151,11.028378758,16.999157067,-5.970778309,-0.140488901,1.1941556617,1.0536667603
2024,Arkansas,Cleburne County,25445,192,223,427,-204,-3,399,396,0,259,8.7971912107,16.844845951,-8.04765474,-0.118347864,15.740265888,15.621918024
2024,Arkansas,Cleveland County,7378,-89,82,129,-47,1,-41,-40,-2,72,11.047490738,17.379589087,-6.33209835,0.1347254968,-5.523745369,-5.389019872
2024,Arkansas,Columbia County,22150,-136,256,298,-42,20,-114,-94,0,1902,11.522189216,13.412548384,-1.890359168,0.9001710325,-5.130974885,-4.230803853
2024,Arkansas,Conway County,21077,56,228,298,-70,26,98,124,2,171,10.831868497,14.157442159,-3.325573661,1.2352130743,4.655803126,5.8910162003
2024,Arkansas,Craighead County,113993,1130,1540,1091,449,61,617,678,3,3181,13.576894594,9.6184363649,3.958458229,0.5377860846,5.4395740029,5.9773600875
2024,Arkansas,Crawford County,61891,850,727,779,-52,151,752,903,-1,673,11.82767709,12.67367325,-0.84599616,2.4566426968,12.234406013,14.69104871
2024,Arkansas,Crittenden County,47139,88,570,620,-50,32,106,138,0,586,12.103195668,13.164879499,-1.061683831,0.6794776516,2.2507697208,2.9302473723
2024,Arkansas,Cross County,16420,-170,183,265,-82,30,-120,-90,2,145,11.087549228,16.055740685,-4.968191457,1.8176310209,-7.270524084,-5.452893063
2024,Arkansas,Dallas County,6185,-11,57,120,-63,-1,54,53,-1,232,9.2076568936,19.384540829,-10.17688394,-0.16153784,8.7230433729,8.5615055327
2024,Arkansas,Desha County,10479,-279,113,164,-51,9,-235,-226,-2,42,10.641804398,15.444742666,-4.802938268,0.8475773414,-22.13118614,-21.2836088
2024,Arkansas,Drew County,16945,33,193,226,-33,9,56,65,1,590,11.400891987,13.350267301,-1.949375314,0.5316478129,3.3080308356,3.8396786484
2024,Arkansas,Faulkner County,129951,2386,1468,1117,351,145,1892,2037,-2,5105,11.401233321,8.6751891145,2.726044207,1.1261436183,14.694232591,15.82037621
2024,Arkansas,Franklin County,17468,198,188,258,-70,0,270,270,-2,277,10.823881628,14.85405032,-4.030168691,0.0,15.544936381,15.544936381
2024,Arkansas,Fulton County,12421,66,117,235,-118,-1,184,183,1,162,9.4446238295,18.96997094,-9.52534711,-0.080723281,14.853083629,14.772360349
2024,Arkansas,Garland County,99784,-198,970,1535,-565,74,295,369,-2,1652,9.7113622939,15.367980537,-5.656618243,0.7408668142,2.953455543,3.6943223572
2024,Arkansas,Grant County,18383,254,184,258,-74,7,324,331,-3,152,10.078878177,14.132340053,-4.053461876,0.3834355828,17.747589833,18.131025416
2024,Arkansas,Greene County,46743,335,526,562,-36,6,361,367,4,849,11.293491213,12.066429775,-0.772938562,0.1288230937,7.7508561368,7.8796792305
2024,Arkansas,Hempstead County,19343,-138,214,281,-67,17,-91,-74,3,293,11.024108799,14.475582114,-3.451473315,0.8757469606,-4.687821966,-3.812075005
2024,Arkansas,Hot Spring County,33258,109,304,475,-171,-1,279,278,2,2577,9.1556613008,14.305720782,-5.150059482,-0.030117307,8.402728628,8.3726113211
2024,Arkansas,Howard County,12533,-89,139,175,-36,4,-58,-54,1,172,11.051480819,13.913734844,-2.862254025,0.318028225,-4.611409263,-4.293381038
2024,Arkansas,Independence County,38320,66,474,487,-13,2,78,80,-1,1183,12.380181263,12.719722099,-0.339540836,0.0522370517,2.0372450179,2.0894820696
2024,Arkansas,Izard County,14169,140,113,238,-125,-2,266,264,1,1210,8.0147528193,16.880629832,-8.865877013,-0.141854032,18.866586283,18.724732251
2024,Arkansas,Jackson County,16784,130,157,252,-95,7,217,224,1,2498,9.3905137867,15.072671811,-5.682158024,0.4186853281,12.97924517,13.397930498
2024,Arkansas,Jefferson County,63661,-634,723,916,-193,83,-524,-441,0,5488,11.300759636,14.317421614,-3.016661978,1.2973209541,-8.190315421,-6.892994467
2024,Arkansas,Johnson County,26129,159,296,334,-38,20,177,197,0,541,11.362982015,12.82174322,-1.458761205,0.7677690551,6.7947561374,7.5625251924
2024,Arkansas,Lafayette County,6095,-34,42,106,-64,28,3,31,-1,59,6.8717277487,17.342931937,-10.47120419,4.5811518325,0.4908376963,5.0719895288
2024,Arkansas,Lawrence County,16318,124,192,239,-47,9,164,173,-2,549,11.811023622,14.70226378,-2.891240157,0.5536417323,10.088582677,10.642224409
2024,Arkansas,Lee County,8201,-166,82,139,-57,11,-118,-107,-2,1709,9.8985997103,16.779333655,-6.880733945,1.3278609367,-14.24432641,-12.91646548
2024,Arkansas,Lincoln County,12898,-12,100,170,-70,-2,59,57,1,4001,7.7495350279,13.174209547,-5.42467452,-0.154990701,4.5722256665,4.4172349659
2024,Arkansas,Little River County,11805,-60,95,194,-99,-2,41,39,0,174,8.0270384453,16.392057457,-8.365019011,-0.168990283,3.4643008027,3.2953105196
2024,Arkansas,Logan County,21400,142,260,362,-102,2,244,246,-2,370,12.189976089,16.972197478,-4.782221389,0.0937690468,11.439823714,11.533592761
2024,Arkansas,Lonoke County,75944,745,886,789,97,43,606,649,-1,720,11.72399648,10.440443818,1.283552662,0.5689975718,8.0188960124,8.5878935842
2024,Arkansas,Madison County,17775,312,217,248,-31,13,331,344,-1,149,12.316249503,14.075713718,-1.759464215,0.737839832,18.786537261,19.524377093
2024,Arkansas,Marion County,17514,225,137,301,-164,-2,392,390,-1,159,7.8728845214,17.297359423,-9.424474902,-0.114932621,22.526793667,22.411861046
2024,Arkansas,Miller County,42415,-193,356,573,-217,-29,52,23,1,1511,8.374204627,13.478705762,-5.104501135,-0.682168354,1.2231984287,0.5410300742
2024,Arkansas,Mississippi County,38663,-200,526,571,-45,17,-173,-156,1,840,13.569641153,14.730542012,-1.160900859,0.4385625468,-4.463018858,-4.024456311
2024,Arkansas,Monroe County,6512,-56,86,134,-48,0,-8,-8,0,79,13.149847095,20.489296636,-7.339449541,0.0,-1.22324159,-1.22324159
2024,Arkansas,Montgomery County,8620,77,80,162,-82,-1,163,162,-3,118,9.3223795374,18.877818563,-9.555439026,-0.116529744,18.994348307,18.877818563
2024,Arkansas,Nevada County,8120,-59,75,121,-46,-2,-10,-12,-1,194,9.2030185901,14.847536659,-5.644518069,-0.245413829,-1.227069145,-1.472482974
2024,Arkansas,Newton County,7071,-30,67,123,-56,0,26,26,0,65,9.4552639006,17.358171041,-7.902907141,0.0,3.6692068868,3.6692068868
2024,Arkansas,Ouachita County,21793,-201,247,370,-123,0,-79,-79,1,371,11.281887318,16.899993149,-5.61810583,0.0,-3.608376916,-3.608376916
2024,Arkansas,Perry County,10184,111,99,151,-52,6,157,163,0,90,9.7743989732,14.908426717,-5.134027743,0.5923878166,15.500814533,16.09320235
2024,Arkansas,Phillips County,14961,-389,208,278,-70,31,-350,-319,0,215,13.724390485,18.343175745,-4.618785259,2.0454620435,-23.0939263,-21.04846425
2024,Arkansas,Pike County,10208,49,113,170,-57,2,105,107,-1,221,11.096381401,16.693671135,-5.597289733,0.196396131,10.310796877,10.507193008
2024,Arkansas,Poinsett County,22397,-56,292,398,-106,35,15,50,0,313,13.021181717,17.748049052,-4.726867336,1.5607580825,0.6688963211,2.2296544036
2024,Arkansas,Polk County,19436,102,202,316,-114,11,208,219,-3,96,10.420428166,16.301263864,-5.880835698,0.5674490586,10.729945834,11.297394893
2024,Arkansas,Pope County,64593,540,729,682,47,23,478,501,-8,2603,11.333426613,10.6027393,0.7306873125,0.357570387,7.4312454332,7.7888158202
2024,Arkansas,Prairie County,8036,-41,79,143,-64,-1,23,22,1,135,9.8057469124,17.749643145,-7.943896233,-0.124123379,2.8548377087,2.73071433
2024,Arkansas,Pulaski County,400009,622,5002,4064,938,489,-804,-315,-1,9372,12.514448409,10.167676596,2.3467718127,1.2234236849,-2.011518697,-0.788095012
2024,Arkansas,Randolph County,18907,55,246,265,-19,32,41,73,1,338,13.030006091,14.036388676,-1.006382584,1.694960142,2.1716676819,3.8666278238
2024,Arkansas,St. Francis County,22101,-301,269,329,-60,42,-282,-240,-1,3436,12.089072647,14.785520077,-2.696447431,1.8875132014,-12.67330292,-10.78578972
2024,Arkansas,Saline County,129574,2159,1414,1385,29,86,2050,2136,-6,1290,11.004362054,10.778671461,0.2256905938,0.669289347,15.953990249,16.623279596
2024,Arkansas,Scott County,9851,55,122,178,-56,1,107,108,3,130,12.41919886,18.11981473,-5.70061587,0.101796712,10.89224818,10.994044892
2024,Arkansas,Searcy County,7806,-100,74,154,-80,1,-21,-20,0,59,9.4195519348,19.602851324,-10.18329939,0.1272912424,-2.67311609,-2.545824847
2024,Arkansas,Sebastian County,129098,-11,1604,1511,93,181,-286,-105,1,2012,12.424140322,11.703788046,0.7203522755,1.401975934,-2.21527689,-0.813300956
2024,Arkansas,Sevier County,15632,-106,180,201,-21,5,-91,-86,1,110,11.47593242,12.814791202,-1.338858782,0.3187759005,-5.80172139,-5.482945489
2024,Arkansas,Sharp County,17968,132,180,302,-122,0,254,254,0,179,10.054742487,16.869623506,-6.814881019,0.0,14.188358843,14.188358843
2024,Arkansas,Stone County,12671,86,126,220,-94,-6,188,182,-2,136,9.977827051,17.421602787,-7.443775736,-0.475134621,14.887551473,14.412416851
2024,Arkansas,Union County,37397,-416,462,573,-111,53,-358,-305,0,618,12.285600319,15.237335461,-2.951735142,1.4093870496,-9.520010637,-8.110623587
2024,Arkansas,Van Buren County,16142,39,140,298,-158,7,189,196,1,61,8.6835168243,18.483485812,-9.799968987,0.4341758412,11.722747713,12.156923554
2024,Arkansas,Washington County,261549,4867,3279,1869,1410,1125,2296,3421,36,11102,12.654588398,7.2129996083,5.4415887896,4.3416931832,8.8609133765,13.20260656
2024,Arkansas,White County,78452,836,902,990,-88,42,886,928,-4,2496,11.559063998,12.686777559,-1.127713561,0.5382269267,11.354025169,11.892252095
2024,Arkansas,Woodruff County,5964,-93,70,102,-32,0,-61,-61,0,108,11.646285667,16.970301972,-5.324016305,0.0,-10.14890608,-10.14890608
2024,Arkansas,Yell County,20044,-47,254,277,-23,27,-53,-26,2,242,12.657281674,13.80341348,-1.146131805,1.3454590756,-2.641086334,-1.295627258
2024,California,California,38965193,-75423,414120,302704,111416,150982,-338371,-187389,550,891995,10.617670794,7.7610630254,2.8566077688,3.8710450397,-8.675533382,-4.804488343
2024,California,Alameda County,1622188,-6071,16418,10571,5847,12740,-24633,-11893,-25,50861,10.101995203,6.5043361728,3.5976590297,7.8389218467,-15.1566846,-7.317762757
2024,California,Alpine County,1141,-49,7,22,-15,1,-33,-32,-2,53,6.006006006,18.876018876,-12.87001287,0.858000858,-28.31402831,-27.45602746
2024,California,Amador County,41811,318,331,553,-222,25,517,542,-2,4202,7.9467972726,13.276673389,-5.329876116,0.6002112744,12.412369154,13.012580428
2024,California,Butte County,207172,-197,1947,2388,-441,238,12,250,-6,4566,9.3935219918,11.521176434,-2.127654442,1.1482579528,0.057895359,1.2061533117
2024,California,Calaveras County,46565,9,376,594,-218,15,214,229,-2,399,8.075514653,12.757594957,-4.682080304,0.3221614888,4.5961705738,4.9183320626
2024,California,Colusa County,22037,128,283,188,95,31,2,33,0,160,12.879442953,8.5559550357,4.323487917,1.4108223729,0.0910207983,1.5018431712
2024,California,Contra Costa County,1155025,-1994,11573,8599,2974,5258,-10314,-5056,88,11066,10.011055153,7.4384397529,2.5726154001,4.5483563462,-8.921975533,-4.373619187
2024,California,Del Norte County,26589,-523,236,359,-123,2,-404,-402,2,1981,8.7894080185,13.370328299,-4.580920281,0.0744865086,-15.04627474,-14.97178823
2024,California,El Dorado County,192215,-572,1495,1748,-253,216,-530,-314,-5,1216,7.7661934224,9.0804723092,-1.314278887,1.1220720931,-2.753232451,-1.631160358
2024,California,Fresno County,1017162,1803,13879,8384,5495,2261,-6015,-3754,62,18565,13.656931466,8.249853261,5.4070782049,2.2248232614,-5.918758035,-3.693934774
2024,California,Glenn County,28129,-231,354,327,27,28,-287,-259,1,162,12.533413585,11.577475261,0.9559383243,0.9913434474,-10.16127034,-9.169926888
2024,California,Humboldt County,133985,-959,1225,1566,-341,131,-744,-613,-5,4411,9.1102112453,11.64619658,-2.535985334,0.9742348352,-5.533058911,-4.558824076
2024,California,Imperial County,179057,117,2424,1403,1021,493,-1410,-917,13,7571,13.542012922,7.8380545088,5.7039584131,2.7542130241,-7.877160982,-5.122947958
2024,California,Inyo County,18527,-215,161,222,-61,1,-154,-153,-1,553,8.6398883791,11.913386461,-3.273498082,0.053663903,-8.264241058,-8.210577155
2024,California,Kern County,913820,-2931,12077,7622,4455,1659,-9169,-7510,124,20400,13.194790041,8.3274562964,4.8673337445,1.8125491991,-10.0176393,-8.205090106
2024,California,Kings County,152682,-305,2084,1116,968,188,-1465,-1277,4,15626,13.635664722,7.3020162332,6.3336484891,1.2300887561,-9.585532062,-8.355443306
2024,California,Lake County,67878,-294,683,972,-289,57,-61,-4,-1,601,10.040426314,14.288864388,-4.248438074,0.8379272326,-0.896729144,-0.058801911
2024,California,Lassen County,28861,-1159,264,287,-23,36,-1179,-1143,7,5483,8.9672390075,9.7484757392,-0.781236732,1.2228053192,-40.0468742,-38.82406888
2024,California,Los Angeles County,9663345,-56420,95354,73138,22216,40388,-119037,-78649,13,207185,9.8388751857,7.546570184,2.2923050016,4.1673395033,-12.28254909,-8.115209582
2024,California,Madera County,162858,2529,2078,1419,659,119,1744,1863,7,6865,12.859428133,8.781293802,4.0781343309,0.7364157593,10.792513313,11.528929072
2024,California,Marin County,254407,-1747,2255,2088,167,1038,-2953,-1915,1,7595,8.8334204924,8.1792381322,0.6541823602,4.0661155082,-11.56766772,-7.501552214
2024,California,Mariposa County,16919,-134,145,225,-80,54,-106,-52,-2,190,8.5364417756,13.246202755,-4.70976098,3.1790886613,-6.240433298,-3.061344637
2024,California,Mendocino County,89108,-899,856,1013,-157,129,-871,-742,0,1432,9.558105128,11.311168802,-1.753063674,1.4404153756,-9.725595288,-8.285179912
2024,California,Merced County,291920,1710,3787,2169,1618,660,-593,67,25,5806,13.010839503,7.4519437239,5.5588957793,2.2675347431,-2.03734561,0.230189133
2024,California,Modoc County,8500,-119,34,115,-81,13,-50,-37,-1,164,3.9721946375,13.435364215,-9.463169578,1.5187803026,-5.841462702,-4.3226824
2024,California,Mono County,13066,64,114,61,53,90,-78,12,-1,292,8.7463556851,4.6800675157,4.0662881694,6.9050176462,-5.984348627,0.9206690195
2024,California,Monterey County,430723,-2161,5548,2857,2691,1340,-6190,-4850,-2,16757,12.848436847,6.6164354851,6.2320013617,3.1032634057,-14.33522424,-11.23196083
2024,California,Napa County,133216,-1154,1167,1262,-95,279,-1339,-1060,1,4969,8.7224294246,9.43248152,-0.710052095,2.0853108907,-10.00799743,-7.922686538
2024,California,Nevada County,102037,-364,741,1110,-369,50,-39,11,-6,1891,7.249141549,10.859037948,-3.609896399,0.4891458535,-0.381533766,0.1076120878
2024,California,Orange County,3135755,-14617,30677,22619,8058,12859,-35597,-22738,63,52887,9.760222789,7.196482031,2.563740758,4.0912313735,-11.32557455,-7.234343181
2024,California,Placer County,423561,5487,3607,3803,-196,790,4920,5710,-27,4485,8.5714115977,9.0371716956,-0.465760098,1.8772983538,11.691528988,13.568827342
2024,California,Plumas County,19131,-312,145,216,-71,19,-257,-238,-3,66,7.5180173174,11.199253383,-3.681236066,0.9851195106,-13.32503759,-12.33991808
2024,California,Riverside County,2492442,18201,27497,20536,6961,3378,7807,11185,55,36120,11.072581036,8.2695030063,2.8030780301,1.360263983,3.1437480508,4.5040120338
2024,California,Sacramento County,1584288,-92,17698,13202,4496,7784,-12390,-4606,18,33390,11.170624376,8.332838909,2.837785467,4.9131054437,-7.820320715,-2.907215272
2024,California,San Benito County,68175,532,850,462,388,17,126,143,1,445,12.516750357,6.8032219588,5.7135283983,0.2503350071,1.8554241706,2.1057591777
2024,California,San Bernardino County,2195611,703,26188,17486,8702,3211,-11384,-8173,174,40501,11.929341383,7.9653453271,3.963996056,1.4626972347,-5.185719501,-3.723022267
2024,California,San Diego County,3269973,-7203,37145,24263,12882,10767,-30745,-19978,-107,112078,11.346923676,7.411775721,3.9351479552,3.2890652099,-9.391874234,-6.102809024
2024,California,San Francisco County,808988,1214,7240,6200,1040,6201,-5925,276,-102,26584,8.9561728937,7.6696508206,1.2865220731,7.670887861,-7.329464695,0.3414231656
2024,California,San Joaquin County,800965,6672,9570,6313,3257,2983,386,3369,46,14988,11.998059248,7.9147072135,4.0833520346,3.7398339328,0.4839342602,4.223768193
2024,California,San Luis Obispo County,281639,-407,2389,2563,-174,332,-568,-236,3,15695,8.4763653459,9.093731428,-0.617366082,1.1779628693,-2.015309969,-0.8373471
2024,California,San Mateo County,726353,-2576,7394,4872,2522,5269,-10335,-5066,-32,9331,10.161604418,6.6956095107,3.4659949068,7.2412082332,-14.20343274,-6.962224504
2024,California,Santa Barbara County,441257,-2658,5560,3423,2137,1424,-6246,-4822,27,20051,12.56253022,7.7340900977,4.8284401224,3.217453783,-14.11251147,-10.89505768
2024,California,Santa Clara County,1877592,-743,18707,10741,7966,20405,-29077,-8672,-37,46758,9.9613224645,5.7194934832,4.2418289812,10.865493392,-15.48326152,-4.61776813
2024,California,Santa Cruz County,261547,-2693,2261,1903,358,396,-3455,-3059,8,14292,8.6004408629,7.2386726945,1.3617681685,1.5063133931,-13.14220397,-11.63589058
2024,California,Shasta County,180366,-571,1734,2543,-809,254,-15,239,-1,2831,9.5985917637,14.076827483,-4.478235719,1.4060220923,-0.083032801,1.3229892915
2024,California,Sierra County,3200,-22,23,34,-11,0,-11,-11,0,29,7.1628776082,10.588601682,-3.425724073,0.0,-3.425724073,-3.425724073
2024,California,Siskiyou County,42905,-881,323,644,-321,22,-579,-557,-3,483,7.4517539306,14.85736697,-7.405613039,0.5075498033,-13.35778801,-12.8502382
2024,California,Solano County,449218,333,4792,3819,973,1312,-1965,-653,13,9751,10.67138179,8.5045924577,2.1667893326,2.9217138791,-4.375890071,-1.454176191
2024,California,Sonoma County,481812,-857,4480,4388,92,813,-1765,-952,3,8311,9.2899704608,9.0991942817,0.1907761791,1.6858808001,-3.659999523,-1.974118723
2024,California,Stanislaus County,551430,204,7077,5013,2064,1229,-3144,-1915,55,6478,12.836278948,9.0925909803,3.743687968,2.2291630391,-5.702594463,-3.473431424
2024,California,Sutter County,97948,-621,1181,945,236,307,-1167,-860,3,931,12.019316395,9.6174885633,2.4018278317,3.1244116285,-11.87683508,-8.752423454
2024,California,Tehama County,64896,-403,745,870,-125,-7,-274,-281,3,764,11.444371904,13.364568532,-1.920196628,-0.107531011,-4.209071009,-4.31660202
2024,California,Trinity County,15670,-108,100,188,-88,-5,-14,-19,-1,215,6.3597049097,11.95624523,-5.596540321,-0.317985245,-0.890358687,-1.208343933
2024,California,Tulare County,479468,1584,6746,3712,3034,616,-2119,-1503,53,4829,14.093039969,7.7547234455,6.3383165231,1.2868829856,-4.426793907,-3.139910921
2024,California,Tuolumne County,54204,-383,437,791,-354,23,-50,-27,-2,3186,8.0337527921,14.54164407,-6.507891278,0.4228290943,-0.919193683,-0.496364589
2024,California,Ventura County,829590,-3281,8581,6524,2057,1390,-6754,-5364,26,11360,10.323249688,7.8486051703,2.474644518,1.6722196791,-8.125303391,-6.453083711
2024,California,Yolo County,220544,-1474,1900,1507,393,1523,-3414,-1891,24,11795,8.5863675598,6.8103452172,1.7760223426,6.8826514703,-15.42834676,-8.545695292
2024,California,Yuba County,85722,1369,1177,746,431,130,805,935,3,2339,13.840952521,8.7726003234,5.0683521976,1.5287373218,9.4664118771,10.995149199
2024,Colorado,Colorado,5877610,36571,62498,45099,17399,11931,7236,19167,5,125069,10.666417264,7.6969623376,2.9694549261,2.0362415497,1.2349546437,3.2711961933
2024,Colorado,Adams County,533365,5856,6534,3680,2854,1241,1717,2958,44,4519,12.318145227,6.9376759163,5.3804693112,2.3395803837,3.2369536816,5.5765340653
2024,Colorado,Alamosa County,16655,68,191,183,8,24,35,59,1,957,11.491486673,11.01016786,0.4813188135,1.4439564406,2.1057698093,3.5497262499
2024,Colorado,Arapahoe County,656061,-208,7639,4633,3006,3029,-6254,-3225,11,5476,11.641888854,7.0607240557,4.5811647985,4.6162169576,-9.531139271,-4.914922314
2024,Colorado,Archuleta County,14189,200,104,146,-42,7,236,243,-1,97,7.3816452552,10.362694301,-2.981049045,0.4968415076,16.750656541,17.247498048
2024,Colorado,Baca County,3344,-91,30,75,-45,7,-52,-45,-1,44,8.8508629591,22.127157398,-13.27629444,2.0652013571,-15.3414958,-13.27629444
2024,Colorado,Bent County,5681,242,39,73,-34,0,273,273,3,1500,7.0143884892,13.129496403,-6.115107914,0.0,49.100719424,49.100719424
2024,Colorado,Boulder County,326831,-508,2486,2038,448,960,-1919,-959,3,15232,7.6004708256,6.2307962762,1.3696745494,2.9350168916,-5.866976474,-2.931959582
2024,Colorado,Broomfield County,76860,665,643,461,182,142,341,483,0,477,8.4022083565,6.0239783085,2.378230048,1.8555421254,4.4559145405,6.3114566659
2024,Colorado,Chaffee County,20617,352,150,184,-34,5,379,384,2,1239,7.3381928477,9.0015165599,-1.663323712,0.2446064283,18.541167262,18.78577369
2024,Colorado,Cheyenne County,1727,-4,14,26,-12,10,-3,7,1,21,8.0971659919,15.037593985,-6.940427993,5.7836899942,-1.735106998,4.048582996
2024,Colorado,Clear Creek County,9147,-220,54,69,-15,2,-206,-204,-1,83,5.8334233553,7.4538187318,-1.620395376,0.2160527169,-22.25342984,-22.03737712
2024,Colorado,Conejos County,7521,-66,99,107,-8,-1,-56,-57,-1,57,13.105639396,14.164680964,-1.059041567,-0.132380196,-7.413290972,-7.545671168
2024,Colorado,Costilla County,3628,13,33,60,-27,0,39,39,1,13,9.1122463068,16.567720558,-7.455474251,0.0,10.769018363,10.769018363
2024,Colorado,Crowley County,5636,9,29,67,-38,-1,48,47,0,2612,5.149604901,11.897363047,-6.747758146,-0.177572583,8.5234839741,8.3459113913
2024,Colorado,Custer County,5534,197,41,61,-20,2,215,217,0,4,7.5430043234,11.222518628,-3.679514304,0.3679514304,39.554778769,39.9227302
2024,Colorado,Delta County,31746,186,273,475,-202,11,378,389,-1,240,8.6247749029,15.006476479,-6.381701576,0.3475184027,11.941996019,12.289514422
2024,Colorado,Denver County,716577,3124,8632,4981,3651,2150,-2599,-449,-78,15890,12.072474004,6.9662874205,5.1061865835,3.0069299245,-3.634888779,-0.627958854
2024,Colorado,Dolores County,2513,53,19,35,-16,0,69,69,0,260,7.6412628192,14.076010456,-6.434747637,0.0,27.749849186,27.749849186
2024,Colorado,Douglas County,383906,7969,3812,1954,1858,660,5465,6125,-14,1660,10.033651689,5.1431677333,4.8904839552,1.7372009744,14.384550493,16.121751467
2024,Colorado,Eagle County,54381,-837,515,185,330,75,-1242,-1167,0,100,9.3978959662,3.3759432112,6.021952755,1.3686256261,-22.66444037,-21.29581474
2024,Colorado,Elbert County,28806,964,263,219,44,2,924,926,-6,65,9.285411665,7.7319587629,1.5534529021,0.0706114956,32.622510945,32.69312244
2024,Colorado,El Paso County,744215,3619,9147,5702,3445,777,-619,158,16,19524,12.320760016,7.6804387899,4.6403212261,1.0465978498,-0.833776151,0.2128216992
2024,Colorado,Fremont County,50318,702,351,676,-325,6,1014,1020,7,8740,7.0246362599,13.528929093,-6.504292833,0.1200792523,20.29339364,20.413472892
2024,Colorado,Garfield County,62707,451,714,412,302,155,-6,149,0,1037,11.427382505,6.5939518097,4.8334306955,2.4807342974,-0.096028424,2.3847058729
2024,Colorado,Gilpin County,5926,40,48,41,7,28,5,33,0,42,8.1273281409,6.942092787,1.1852353539,4.7409414155,0.8465966813,5.5875380969
2024,Colorado,Grand County,15935,201,121,103,18,29,152,181,2,213,7.6415422022,6.504783858,1.1367583441,1.8314439989,9.5992926837,11.430736683
2024,Colorado,Gunnison County,17321,1,134,85,49,6,-53,-47,-1,1037,7.7364972143,4.9074795762,2.8290176381,0.346410323,-3.059957853,-2.71354753
2024,Colorado,Hinsdale County,765,-6,4,5,-1,0,-5,-5,0,0,5.2083333333,6.5104166667,-1.302083333,0.0,-6.510416667,-6.510416667
2024,Colorado,Huerfano County,7055,-42,40,135,-95,-1,53,52,1,120,5.6529112493,19.078575466,-13.42566422,-0.141322781,7.4901074053,7.3487846241
2024,Colorado,Jackson County,1309,-5,6,13,-7,0,2,2,0,1,4.5749142204,9.9123141441,-5.337399924,0.0,1.5249714068,1.5249714068
2024,Colorado,Jefferson County,576366,555,5493,4997,496,662,-584,78,-19,9341,9.5349933213,8.674014496,0.8609788253,1.1491289967,-1.013733133,0.1353958637
2024,Colorado,Kiowa County,1384,-50,20,21,-1,1,-50,-49,0,31,14.194464159,14.904187367,-0.709723208,0.7097232079,-35.4861604,-34.77643719
2024,Colorado,Kit Carson County,6994,11,93,95,-2,31,-17,14,-1,91,13.307576733,13.593761179,-0.286184446,4.4358589111,-2.43256779,2.0032911211
2024,Colorado,Lake County,7365,19,85,46,39,12,-31,-19,-1,120,11.555978519,6.2538236694,5.3021548501,1.6314322616,-4.214533342,-2.583101081
2024,Colorado,La Plata County,56407,-146,414,455,-41,29,-134,-105,0,1884,7.3300283286,8.0559490085,-0.72592068,0.5134560907,-2.372521246,-1.859065156
2024,Colorado,Larimer County,370771,3194,3094,2638,456,471,2249,2720,18,12321,8.3808718924,7.1456819819,1.2351899104,1.2758211575,6.0919783083,7.3677994658
2024,Colorado,Las Animas County,14348,37,111,243,-132,19,147,166,3,486,7.7462577201,16.958023657,-9.211765937,1.3259360061,10.258557521,11.584493527
2024,Colorado,Lincoln County,5480,-30,52,69,-17,4,-18,-14,1,860,9.4631483167,12.556869882,-3.093721565,0.7279344859,-3.275705187,-2.547770701
2024,Colorado,Logan County,20619,-173,192,270,-78,26,-121,-95,0,2709,9.2728985052,13.040013523,-3.767115018,1.2557050059,-5.843857912,-4.588152906
2024,Colorado,Mesa County,159681,1150,1454,1780,-326,68,1405,1473,3,4128,9.1385617136,11.187510213,-2.0489485,0.4273880306,8.8305909268,9.2579789574
2024,Colorado,Mineral County,944,13,7,11,-4,0,19,19,-2,0,7.4666666667,11.733333333,-4.266666667,0.0,20.266666667,20.266666667
2024,Colorado,Moffat County,13327,122,135,113,22,-3,105,102,-2,116,10.176390773,8.5180159807,1.6583747927,-0.226142017,7.9149706015,7.6888285844
2024,Colorado,Montezuma County,26531,64,240,357,-117,57,124,181,0,262,9.0569455451,13.472206498,-4.415260953,2.151024567,4.679421865,6.8304464319
2024,Colorado,Montrose County,44156,349,395,542,-147,72,424,496,0,684,8.9810488501,12.323363232,-3.342314382,1.6370519423,9.6404169935,11.277468936
2024,Colorado,Morgan County,29524,258,407,303,104,218,-64,154,0,408,13.845892159,10.307875489,3.5380166695,7.4162272495,-2.177241027,5.2389862221
2024,Colorado,Otero County,18136,-175,203,279,-76,-2,-98,-100,1,307,11.139462782,15.30990205,-4.170439268,-0.109748402,-5.377671688,-5.487420089
2024,Colorado,Ouray County,5176,73,32,40,-8,10,71,81,0,0,6.2262866038,7.7828582547,-1.556571651,1.9457145637,13.814573402,15.760287966
2024,Colorado,Park County,18117,196,138,132,6,11,177,188,2,25,7.6585826072,7.3256007548,0.3329818525,0.6104667296,9.8229646484,10.433431378
2024,Colorado,Phillips County,4476,28,51,70,-19,36,13,49,-2,60,11.429852084,15.688032273,-4.258180188,8.068130883,2.9134917078,10.981622591
2024,Colorado,Pitkin County,16640,-207,130,68,62,29,-299,-270,1,49,7.7642070057,4.0612775107,3.702929495,1.732015409,-17.85767611,-16.1256607
2024,Colorado,Prowers County,11751,-122,142,135,7,22,-151,-129,0,336,12.021672875,11.429055198,0.5926176769,1.862512699,-12.78360989,-10.92109719
2024,Colorado,Pueblo County,169422,-50,1646,2232,-586,47,485,532,4,3535,9.7139518552,13.172260353,-3.458308498,0.2773728659,2.8622519136,3.1396247794
2024,Colorado,Rio Blanco County,6569,20,58,70,-12,7,27,34,-2,210,8.8428114042,10.672358591,-1.829547187,1.0672358591,4.1164811709,5.18371703
2024,Colorado,Rio Grande County,11188,-149,121,168,-47,-2,-97,-99,-3,128,10.743618202,14.916759156,-4.173140954,-0.177580466,-8.612652608,-8.790233074
2024,Colorado,Routt County,25064,-8,206,137,69,26,-103,-77,0,359,8.2176479974,5.4651348333,2.7525131642,1.0371788735,-4.108823999,-3.071645125
2024,Colorado,Saguache County,6688,61,61,76,-15,2,73,75,1,13,9.162598573,11.415696583,-2.25309801,0.300413068,10.965076981,11.265490049
2024,Colorado,San Juan County,802,-4,6,7,-1,0,-4,-4,1,0,7.4626865672,8.7064676617,-1.243781095,0.0,-4.975124378,-4.975124378
2024,Colorado,San Miguel County,7868,-140,48,35,13,15,-169,-154,1,5,6.0468631897,4.4091710758,1.6376921139,1.8896447468,-21.28999748,-19.40035273
2024,Colorado,Sedgwick County,2299,13,14,40,-26,0,40,40,-1,27,6.106870229,17.448200654,-11.34133043,0.0,17.448200654,17.448200654
2024,Colorado,Summit County,30465,-171,262,89,173,84,-423,-339,-5,579,8.5759643868,2.9132092764,5.6627551104,2.7495458339,-13.84592724,-11.0963814
2024,Colorado,Teller County,24617,-243,179,243,-64,9,-184,-175,-4,115,7.2356852679,9.8227459223,-2.587060654,0.3638054045,-7.437799382,-7.073993977
2024,Colorado,Washington County,4855,8,52,66,-14,7,15,22,0,169,10.719439291,13.605442177,-2.886002886,1.443001443,3.0921459493,4.5351473923
2024,Colorado,Weld County,359442,9176,4658,2286,2372,527,6254,6781,23,4304,13.126525275,6.442086041,6.6844392342,1.4851178231,17.62414965,19.109267473
2024,Colorado,Yuma County,9862,-33,134,102,32,111,-176,-65,0,147,13.564812472,10.325454269,3.2393582022,11.236523764,-17.81647011,-6.579946348
2024,Connecticut,Connecticut,3617176,8470,34957,32842,2115,15264,-9016,6248,107,103382,9.6754970535,9.0901013883,0.5853956652,4.2248129709,-2.495473909,1.729339062
2024,Connecticut,Capitol Planning Region,975328,3260,9391,9135,256,4344,-1356,2988,16,33794,9.6446742214,9.3817590259,0.2629151955,4.4613422232,-1.392628926,3.0687132971
2024,Connecticut,Greater Bridgeport Planning Region,327651,526,3374,2400,974,2075,-2558,-483,35,10471,10.305814508,7.3307512798,2.9750632277,6.3380453774,-7.813359072,-1.475313695
2024,Connecticut,Lower Connecticut River Valley Planning Region,176215,233,1432,1723,-291,368,162,530,-6,6535,8.1318125935,9.7842968566,-1.652484263,2.0897395492,0.9199396928,3.009679242
2024,Connecticut,Naugatuck Valley Planning Region,456128,2538,4388,4215,173,1370,1016,2386,-21,6855,9.646945537,9.2666078939,0.3803376431,3.0119223759,2.2336592219,5.2455815978
2024,Connecticut,Northeastern Connecticut Planning Region,96692,544,827,1015,-188,97,631,728,4,1732,8.5770587015,10.526861647,-1.949802945,1.0060153495,6.544285418,7.5503007675
2024,Connecticut,Northwest Hills Planning Region,113463,186,921,1192,-271,214,249,463,-6,2365,8.1238422863,10.514245391,-2.390403105,1.887624592,2.1963482403,4.0839728323
2024,Connecticut,South Central Connecticut Planning Region,568158,-244,5674,5462,212,2246,-2722,-476,20,22486,9.9845146759,9.6114591399,0.373055536,3.9522770465,-4.789892307,-0.83761526
2024,Connecticut,Southeastern Connecticut Planning Region,279634,377,2595,2962,-367,583,157,740,4,11350,9.2862472289,10.599562348,-1.313315119,2.0862744256,0.5618269036,2.6481013292
2024,Connecticut,Western Connecticut Planning Region,623907,1050,6355,4738,1617,3967,-4595,-628,61,7794,10.19439124,7.6004761126,2.5939151275,6.36367428,-7.371082258,-1.007407978
2024,Delaware,Delaware,1031890,12431,10725,10897,-172,2277,10320,12597,6,23737,10.456533725,10.624228252,-0.167694527,2.2200025447,10.061671612,12.281674157
2024,Delaware,Kent County,189789,2031,2153,2169,-16,263,1788,2051,-4,5279,11.405202531,11.48996019,-0.084757659,1.3932040249,9.471668428,10.864872453
2024,Delaware,New Castle County,578592,3338,6080,5527,553,1582,1203,2785,0,15686,10.538668072,9.5801346107,0.9585334611,2.742133699,2.085200278,4.827333977
2024,Delaware,Sussex County,263509,7062,2492,3201,-709,432,7329,7761,10,2772,9.5854264592,12.312580295,-2.727153836,1.6616790652,28.190846918,29.852525983
2024,District of Columbia,District of Columbia,678972,8023,7627,5020,2607,6969,-1509,5460,-44,37601,11.299920514,7.4374722669,3.862448247,10.325048651,-2.235686385,8.0893622664
2024,District of Columbia,District of Columbia,678972,8023,7627,5020,2607,6969,-1509,5460,-44,37601,11.299920514,7.4374722669,3.862448247,10.325048651,-2.235686385,8.0893622664
2024,Florida,Florida,22610726,365205,223578,231181,-7603,178432,194438,372870,-62,480002,9.968644947,10.307638978,-0.338994031,7.9557257655,8.6693833303,16.625109096
2024,Florida,Alachua County,285994,1953,2679,2249,430,1606,-95,1511,12,19394,9.3994228425,7.8907435508,1.5086792916,5.6347417264,-0.333312867,5.3014288596
2024,Florida,Baker County,28368,582,354,345,9,20,553,573,0,1538,12.608184635,12.287637568,0.320547067,0.7123268155,19.69583645,20.408163265
2024,Florida,Bay County,190769,5559,2127,2188,-61,707,4911,5618,2,3180,11.314461712,11.63894792,-0.324486208,3.7608483453,26.123799468,29.884647813
2024,Florida,Bradford County,27858,562,306,367,-61,-7,632,625,-2,2618,11.096203358,13.308191609,-2.211988251,-0.253834717,22.917648765,22.663814048
2024,Florida,Brevard County,643979,13272,5217,8261,-3044,1440,14886,16326,-10,8543,8.1855453029,12.96162349,-4.776078187,2.2593799571,23.356340307,25.615720264
2024,Florida,Broward County,1962531,15642,21028,16483,4545,25427,-14303,11124,-27,15749,10.757605988,8.4324528958,2.3251530918,13.008067693,-7.317197948,5.6908697454
2024,Florida,Calhoun County,13470,5,138,225,-87,9,83,92,0,1564,10.246890663,16.70688695,-6.459996287,0.668275478,6.1629849638,6.8312604418
2024,Florida,Charlotte County,206134,3552,1095,3103,-2008,492,5057,5549,11,3763,5.3582438662,15.184137641,-9.825893775,2.4075397097,24.745789252,27.153328962
2024,Florida,Citrus County,166696,4188,1045,3149,-2104,113,6183,6296,-4,2843,6.3486470395,19.130994763,-12.78234772,0.6865044167,37.563334589,38.249839006
2024,Florida,Clay County,232439,5805,2303,2355,-52,333,5550,5883,-26,2456,10.033262684,10.259806175,-0.226543491,1.4507496629,24.179161048,25.629910711
2024,Florida,Collier County,404310,6794,3388,4166,-778,3382,4197,7579,-7,4934,8.4507112516,10.391281899,-1.940570647,8.4357454111,10.468605408,18.904350819
2024,Florida,Columbia County,73063,1193,751,1045,-294,163,1324,1487,0,4099,10.363409299,14.420456349,-4.057047049,2.2493152008,18.270511202,20.519826403
2024,Florida,DeSoto County,35979,659,409,435,-26,132,548,680,5,3129,11.47281168,12.202134672,-0.729322992,3.7027167281,15.371884599,19.074601327
2024,Florida,Dixie County,17465,345,156,285,-129,2,470,472,2,1647,9.0212519879,16.481133439,-7.459881451,0.1156570768,27.17941304,27.295070117
2024,Florida,Duval County,1030822,13811,12873,9766,3107,5507,5112,10619,85,24378,12.572314246,9.5378871226,3.0344271237,5.3783682556,4.992594611,10.370962867
2024,Florida,Escambia County,326928,3068,3761,4012,-251,823,2464,3287,32,18440,11.558295482,12.329668033,-0.771372551,2.5292414734,7.5723584332,10.101599907
2024,Florida,Flagler County,131439,4681,874,1695,-821,219,5286,5505,-3,781,6.7700244387,13.129509638,-6.359485199,1.6963791214,40.945479614,42.641858736
2024,Florida,Franklin County,12594,102,88,188,-100,8,194,202,0,1159,7.0158654229,14.988439767,-7.972574344,0.6378059475,15.466794228,16.104600175
2024,Florida,Gadsden County,43833,440,486,605,-119,67,493,560,-1,2036,11.143466398,13.872010639,-2.728544241,1.5362391947,11.303969,12.840208195
2024,Florida,Gilchrist County,19587,585,209,260,-51,63,575,638,-2,998,10.832102413,13.475342714,-2.643240302,3.2651791961,29.801238695,33.066417891
2024,Florida,Glades County,12786,323,72,162,-90,40,371,411,2,1939,5.7031961662,12.832191374,-7.128995208,3.1684423145,29.387302467,32.555744782
2024,Florida,Gulf County,15693,394,113,242,-129,19,502,521,2,1799,7.2922044399,15.616933402,-8.324728962,1.2261228704,32.395456892,33.621579763
2024,Florida,Hamilton County,13471,277,167,207,-40,2,315,317,0,1540,12.525782861,15.525970373,-3.000187512,0.1500093756,23.626476655,23.77648603
2024,Florida,Hardee County,25760,109,361,328,33,53,23,76,0,1922,14.043687149,12.759915193,1.2837719554,2.0618155648,0.8947501507,2.9565657155
2024,Florida,Hendry County,43333,1942,562,412,150,404,1392,1796,-4,2257,13.266606865,9.7256975591,3.5409093055,9.5368490628,32.859638355,42.396487418
2024,Florida,Hernando County,212807,5872,1649,3199,-1550,345,7086,7431,-9,2099,7.8572075227,15.242696704,-7.385489181,1.6438669468,33.763597639,35.407464585
2024,Florida,Highlands County,107614,1965,870,1907,-1037,307,2700,3007,-5,1413,8.1589399005,17.884021138,-9.725081238,2.8790741948,25.320847967,28.199922162
2024,Florida,Hillsborough County,1535564,22091,17429,12440,4989,13707,3301,17008,94,33899,11.432462118,8.1599534542,3.2725086642,8.9910355302,2.1652738225,11.156309353
2024,Florida,Holmes County,19944,291,229,320,-91,0,381,381,1,1658,11.566532818,16.162840619,-4.596307801,0.0,19.243882112,19.243882112
2024,Florida,Indian River County,169795,2528,1273,2501,-1228,465,3296,3761,-5,1441,7.5535064766,14.839999763,-7.286493286,2.7591363013,19.557232794,22.316369095
2024,Florida,Jackson County,48622,367,521,715,-194,50,511,561,0,6736,10.755906975,14.76098558,-4.005078605,1.0322367538,10.549459624,11.581696378
2024,Florida,Jefferson County,15450,381,136,209,-73,31,423,454,0,1205,8.9124807497,13.696385858,-4.783905108,2.0315213474,27.720436449,29.751957797
2024,Florida,Lafayette County,8078,301,71,112,-41,5,338,343,-1,934,8.9561652476,14.12803532,-5.171870073,0.6307158625,42.636392305,43.267108168
2024,Florida,Lake County,424462,14372,3689,5126,-1437,1150,14670,15820,-11,4373,8.8406714021,12.284435242,-3.44376384,2.75596967,35.156587007,37.912556677
2024,Florida,Lee County,834573,12182,7477,8597,-1120,4906,8374,13280,22,14019,9.0249395883,10.376809635,-1.351870047,5.9216736151,10.107642652,16.029316268
2024,Florida,Leon County,296913,-369,2791,2309,482,1075,-1941,-866,15,17867,9.3942224354,7.7718594064,1.622363029,3.6183407804,-6.533208795,-2.914868015
2024,Florida,Levy County,46545,1292,395,670,-275,75,1491,1566,1,279,8.6058519793,14.597267914,-5.991415935,1.6340225277,32.484367851,34.118390379
2024,Florida,Liberty County,7706,93,74,78,-4,0,96,96,1,1537,9.6612050395,10.183432339,-0.522227299,0.0,12.533455186,12.533455186
2024,Florida,Madison County,18519,289,173,302,-129,57,360,417,1,1555,9.4152221829,16.435821383,-7.0205992,3.1021252279,19.59236986,22.694495088
2024,Florida,Manatee County,441095,11926,3761,4744,-983,1597,11300,12897,12,6250,8.6433542006,10.9024388,-2.2590846,3.6701506669,25.969131206,29.639281873
2024,Florida,Marion County,409959,13522,3638,6118,-2480,848,15167,16015,-13,9084,9.0228622166,15.173686377,-6.150824161,2.1031850356,37.616754051,39.719939087
2024,Florida,Martin County,163315,1328,1294,2241,-947,441,1838,2279,-4,4789,7.9556842565,13.777966321,-5.822282064,2.7113267056,11.300268673,14.011595379
2024,Florida,Miami-Dade County,2686867,13811,29339,22335,7004,54457,-47597,6860,-53,42193,10.947545329,8.3340749485,2.6134703801,20.320068031,-17.76032977,2.5597382649
2024,Florida,Monroe County,80614,-1004,734,799,-65,482,-1413,-931,-8,984,9.0487696632,9.8500912274,-0.801321564,5.942107599,-17.419498,-11.4773904
2024,Florida,Nassau County,101501,3675,851,1126,-275,15,3940,3955,-5,733,8.538732836,11.29801783,-2.759284994,0.1505064542,39.533028641,39.683535096
2024,Florida,Okaloosa County,218464,2000,2686,2136,550,962,473,1435,15,4341,12.351469669,9.8223154177,2.5291542508,4.4237207078,2.1750726557,6.5987933635
2024,Florida,Okeechobee County,41427,1054,552,586,-34,59,1029,1088,0,2160,13.496332518,14.327628362,-0.831295844,1.4425427873,25.158924205,26.601466993
2024,Florida,Orange County,1471416,19655,16620,9597,7023,19160,-6560,12600,32,39527,11.371189634,6.566143617,4.8050460167,13.109024873,-4.488267389,8.6207574841
2024,Florida,Osceola County,437784,15241,4916,3104,1812,5994,7418,13412,17,2871,11.428212761,7.2158609459,4.2123518151,13.934236633,17.24460583,31.178842463
2024,Florida,Palm Beach County,1533801,13934,15166,15837,-671,14841,-162,14679,-74,30346,9.9329724122,10.372443894,-0.439471482,9.7201136469,-0.106101908,9.6140117393
2024,Florida,Pasco County,632996,23855,5625,7184,-1559,1691,23750,25441,-27,8227,9.0569719765,11.567162076,-2.5101901,2.7227270422,38.240548345,40.963275387
2024,Florida,Pinellas County,961596,-196,7488,12433,-4945,3087,1693,4780,-31,21292,7.7862604945,12.92822873,-5.141968235,3.2099607567,1.760435232,4.9703959887
2024,Florida,Polk County,818330,29948,8932,8352,580,3335,26029,29364,4,16855,11.118358486,10.396387156,0.7219713303,4.151335149,32.400330613,36.551665762
2024,Florida,Putnam County,75955,1219,821,1233,-412,82,1542,1624,7,1270,10.89647026,16.36461368,-5.468143419,1.0883198068,20.465721244,21.554041051
2024,Florida,St. Johns County,320110,13038,2469,2486,-17,804,12309,13113,-58,3979,7.8733126907,7.9275234302,-0.054210739,2.5638490901,39.251764241,41.815613331
2024,Florida,St. Lucie County,373586,14700,3605,4021,-416,1125,14011,15136,-20,2917,9.8433796787,10.979259275,-1.135879597,3.0717897749,38.256752477,41.328542251
2024,Florida,Santa Rosa County,203162,4963,2075,1929,146,128,4703,4831,-14,5434,10.339818767,9.6122941691,0.7275245976,0.6378297842,23.435261523,24.073091307
2024,Florida,Sarasota County,469013,6461,3003,6402,-3399,1354,8526,9880,-20,8576,6.4472151702,13.744612561,-7.29739739,2.9069361773,18.304680833,21.21161701
2024,Florida,Seminole County,484271,5648,4677,3987,690,3039,1923,4962,-4,4938,9.7144649359,8.2812853751,1.4331795608,6.3122212829,3.9942091237,10.306430407
2024,Florida,Sumter County,151565,6798,541,2530,-1989,104,8684,8788,-1,8389,3.6513100171,17.075442409,-13.42413239,0.7019154192,58.609937503,59.311852922
2024,Florida,Suwannee County,46130,725,442,709,-267,15,977,992,0,2618,9.657508057,15.49134211,-5.833834053,0.3277434861,21.347025728,21.674769214
2024,Florida,Taylor County,21582,269,223,329,-106,80,294,374,1,1635,10.397482224,15.339783192,-4.942300967,3.730038466,13.707891363,17.437929829
2024,Florida,Union County,15532,18,152,248,-96,0,114,114,0,3857,9.7919216646,15.976293242,-6.184371578,0.0,7.3439412485,7.3439412485
2024,Florida,Volusia County,590357,10692,5051,8054,-3003,1398,12284,13682,13,17947,8.634025685,13.767262496,-5.133236811,2.3896986552,20.997895766,23.387594421
2024,Florida,Wakulla County,36449,1280,342,410,-68,1,1349,1350,-2,2852,9.5506716189,11.449635566,-1.898963948,0.0279259404,37.672093608,37.700019548
2024,Florida,Walton County,86354,2950,958,863,95,94,2761,2855,0,2143,11.286655121,10.16741479,1.1192403304,1.1074588532,32.528658443,33.636117296
2024,Florida,Washington County,25602,197,278,370,-92,42,247,289,0,2074,10.900464642,14.507812653,-3.607348011,1.6468327877,9.6849452036,11.331777991
2024,Georgia,Georgia,11029227,116077,125664,97847,27817,30119,58206,88325,-65,254664,11.454000631,8.9185415053,2.5354591255,2.7452814251,5.3053504641,8.0506318892
2024,Georgia,Appling County,18457,20,207,238,-31,34,16,50,1,368,11.221336803,12.901826855,-1.680490053,1.8431181222,0.8673497046,2.7104678267
2024,Georgia,Atkinson County,8293,133,131,125,6,85,41,126,1,20,15.924147572,15.194797301,0.7293502705,10.332462165,4.9838935149,15.31635568
2024,Georgia,Bacon County,11124,-49,133,166,-33,2,-18,-16,0,391,11.929856034,14.889895502,-2.960039467,0.1793963313,-1.614566982,-1.435170651
2024,Georgia,Baker County,2743,-49,27,43,-16,5,-38,-33,0,0,9.756097561,15.537488708,-5.781391147,1.8066847335,-13.73080397,-11.92411924
2024,Georgia,Baldwin County,43396,-237,386,525,-139,13,-110,-97,-1,4892,8.8706063496,12.064943869,-3.19433752,0.298750991,-2.527893001,-2.22914201
2024,Georgia,Banks County,19789,447,245,241,4,0,444,444,-1,15,12.522041348,12.317599857,0.2044414914,0.0,22.693005545,22.693005545
2024,Georgia,Barrow County,92792,3547,1151,800,351,109,3087,3196,0,425,12.645780803,8.7894219307,3.8563588721,1.1975587381,33.916181875,35.113740613
2024,Georgia,Bartow County,115041,2226,1326,1139,187,79,1953,2032,7,1019,11.63892985,9.9975423074,1.641387543,0.6934204059,17.14240573,17.835826136
2024,Georgia,Ben Hill County,17128,71,211,273,-62,4,128,132,1,332,12.344595583,15.971917508,-3.627321925,0.2340207693,7.488664619,7.7226853883
2024,Georgia,Berrien County,18570,355,229,259,-30,1,387,388,-3,136,12.450727199,14.081826832,-1.631099633,0.0543699878,21.041185266,21.095555254
2024,Georgia,Bibb County,156512,386,2060,1916,144,106,133,239,3,5195,13.178180515,12.256987314,0.9211932011,0.6781005508,0.850824276,1.5289248268
2024,Georgia,Bleckley County,12465,186,128,171,-43,-2,232,230,-1,867,10.345942451,13.821532493,-3.475590042,-0.161655351,18.752020692,18.590365341
2024,Georgia,Brantley County,18401,191,208,246,-38,23,206,229,0,64,11.362705198,13.438584032,-2.075878834,1.2564529786,11.253448417,12.509901396
2024,Georgia,Brooks County,16245,-39,161,220,-59,36,-15,21,-1,415,9.8988594792,13.526391835,-3.627532356,2.213409573,-0.922253989,1.2911555842
2024,Georgia,Bryan County,49739,1521,628,340,288,62,1172,1234,-1,234,12.821952489,6.9418214114,5.8801310779,1.2658615515,23.928866748,25.194728299
2024,Georgia,Bulloch County,84327,1289,855,674,181,60,1047,1107,1,5986,10.217189974,8.0542526813,2.1629372927,0.7169957876,12.511576494,13.228572282
2024,Georgia,Burke County,24438,4,270,276,-6,3,6,9,1,206,11.049271567,11.294810935,-0.245539368,0.1227696841,0.2455393681,0.3683090522
2024,Georgia,Butts County,26887,142,293,343,-50,22,170,192,0,2930,10.926312649,12.790871122,-1.864558473,0.8204057279,6.3394988067,7.1599045346
2024,Georgia,Calhoun County,5457,-17,45,65,-20,3,0,3,0,1683,8.2334644589,11.892781996,-3.659317537,0.5488976306,0.0,0.5488976306
2024,Georgia,Camden County,58118,1147,767,491,276,35,832,867,4,2243,13.328815091,8.5325270008,4.7962880901,0.608224939,14.458375692,15.066600631
2024,Georgia,Candler County,11059,97,145,195,-50,-2,148,146,1,280,13.169247536,17.710367377,-4.54111984,-0.181644794,13.441714727,13.260069933
2024,Georgia,Carroll County,127098,2568,1567,1270,297,143,2131,2274,-3,3061,12.454893732,10.094266139,2.3606275931,1.1365984708,16.937701687,18.074300157
2024,Georgia,Catoosa County,68910,74,573,816,-243,-13,327,314,3,485,8.319660825,11.84789395,-3.528233125,-0.188753212,4.7478692666,4.5591160542
2024,Georgia,Charlton County,12934,146,122,154,-32,1,174,175,3,2507,9.486043076,11.974185522,-2.488142446,0.0777544514,13.529274551,13.607029002
2024,Georgia,Chatham County,303655,2630,3676,2829,847,811,972,1783,0,13396,12.158497056,9.3570152808,2.8014817755,2.6824105312,3.214923596,5.8973341271
2024,Georgia,Chattahoochee County,8661,-85,174,38,136,46,-262,-216,-5,2112,19.991957259,4.3660596312,15.625897627,5.2852300799,-30.10283219,-24.81760211
2024,Georgia,Chattooga County,25222,260,247,375,-128,33,353,386,2,1241,9.8437749083,14.945002391,-5.101227483,1.3151602104,14.068228918,15.383389128
2024,Georgia,Cherokee County,286602,5408,2944,1984,960,450,3993,4443,5,2219,10.369921592,6.9884254204,3.3814961712,1.5850763302,14.064910637,15.649986967
2024,Georgia,Clarke County,129933,207,1331,888,443,443,-672,-229,-7,11360,10.251907309,6.8397398126,3.4121674966,3.4121674966,-5.176019318,-1.763851821
2024,Georgia,Clay County,2853,0,28,45,-17,6,10,16,1,54,9.8142306344,15.772870662,-5.958640028,2.1030494217,3.5050823694,5.6081317911
2024,Georgia,Clayton County,298300,-99,3596,2194,1402,859,-2364,-1505,4,5101,12.052978135,7.3537914426,4.6991866921,2.8791735867,-7.923592967,-5.044419381
2024,Georgia,Clinch County,6746,67,94,85,9,4,55,59,-1,163,14.003724395,12.662942272,1.3407821229,0.5959031657,8.1936685289,8.7895716946
2024,Georgia,Cobb County,776743,4903,8847,4858,3989,3861,-3010,851,63,10307,11.425929382,6.2741228594,5.1518065225,4.9864941046,-3.887424826,1.0990692782
2024,Georgia,Coffee County,43317,70,566,498,68,86,-88,-2,4,2897,13.077029712,11.505937803,1.5710919089,1.9869691789,-2.033177764,-0.046208586
2024,Georgia,Colquitt County,46167,337,622,577,45,208,84,292,0,907,13.522180071,12.543887301,0.9782927704,4.5218865833,1.8261465048,6.348033088
2024,Georgia,Columbia County,165162,2691,1835,1211,624,246,1840,2086,-19,1257,11.201557841,7.3924177357,3.8091401049,1.5016802337,11.232079797,12.73376003
2024,Georgia,Cook County,17714,305,222,238,-16,57,264,321,0,272,12.641289184,13.552373089,-0.911083905,3.245736412,15.032884435,18.278620847
2024,Georgia,Coweta County,155892,3013,1688,1321,367,203,2452,2655,-9,951,10.933669289,8.5565030395,2.3771662494,1.3148903232,15.882320555,17.197210878
2024,Georgia,Crawford County,12277,108,100,202,-102,0,211,211,-1,125,8.1812975538,16.526221059,-8.344923505,0.0,17.262537839,17.262537839
2024,Georgia,Crisp County,19631,-98,242,282,-40,-3,-53,-56,-2,413,12.296747967,14.329268293,-2.032520325,-0.152439024,-2.693089431,-2.845528455
2024,Georgia,Dade County,16165,75,126,230,-104,6,176,182,-3,567,7.8127422105,14.261354829,-6.448612618,0.3720353434,10.913036738,11.285072082
2024,Georgia,Dawson County,31732,1543,333,298,35,21,1489,1510,-2,119,10.755640251,9.6251675522,1.1304726991,0.6782836195,48.093538541,48.77182216
2024,Georgia,Decatur County,29087,68,351,377,-26,10,84,94,0,911,12.081368533,12.976284721,-0.894916188,0.3441985337,2.8912676832,3.2354662169
2024,Georgia,DeKalb County,762992,1213,10127,5199,4928,4427,-8049,-3622,-93,12451,13.283306149,6.8193846814,6.4639214676,5.8067736073,-10.55765095,-4.750877345
2024,Georgia,Dodge County,19776,-97,182,291,-109,20,-7,13,-1,1803,9.1805594088,14.678806527,-5.498247118,1.0088526823,-0.353098439,0.6557542435
2024,Georgia,Dooly County,10981,396,98,158,-60,39,411,450,6,1772,9.0883798572,14.652694055,-5.564314198,3.6168042289,38.115552258,41.732356487
2024,Georgia,Dougherty County,82645,-250,1101,1066,35,70,-359,-289,4,2432,13.301920986,12.879062462,0.4228585236,0.8457170472,-4.337320285,-3.491603238
2024,Georgia,Douglas County,149160,1707,1698,1142,556,233,932,1165,-14,781,11.44926217,7.7002693746,3.7489927953,1.5710707218,6.2842828871,7.8553536089
2024,Georgia,Early County,10563,3,117,175,-58,0,60,60,1,183,11.077971879,16.569616058,-5.491644179,0.0,5.68101122,5.68101122
2024,Georgia,Echols County,3709,23,49,35,14,3,7,10,-1,0,13.252197431,9.4658553076,3.7863421231,0.8113590264,1.8931710615,2.7045300879
2024,Georgia,Effingham County,71541,2507,847,597,250,10,2250,2260,-3,366,12.050506847,8.4936866441,3.5568202027,0.1422728081,32.011381825,32.153654633
2024,Georgia,Elbert County,20013,140,223,306,-83,3,220,223,0,218,11.181868325,15.343729629,-4.161861305,0.1504287219,11.031439603,11.181868325
2024,Georgia,Emanuel County,23119,173,288,338,-50,21,200,221,2,1495,12.504070335,14.67491588,-2.170845544,0.9117551286,8.6833821774,9.595137306
2024,Georgia,Evans County,10754,95,122,133,-11,3,104,107,-1,618,11.394946995,12.422360248,-1.027413254,0.2802036146,9.7137253071,9.9939289217
2024,Georgia,Fannin County,25955,222,186,434,-248,-3,476,473,-3,82,7.1970283238,16.793066089,-9.596037765,-0.116081102,18.418201517,18.302120415
2024,Georgia,Fayette County,123351,1370,916,1061,-145,307,1236,1543,-28,703,7.4674318882,8.6495035299,-1.182071642,2.5027309931,10.076141718,12.578872711
2024,Georgia,Floyd County,100113,676,1119,1267,-148,216,608,824,0,4200,11.215234277,12.698571787,-1.483337509,2.1648709597,6.0937108494,8.2585818091
2024,Georgia,Forsyth County,272887,5575,2411,1559,852,1061,3704,4765,-42,1298,8.926340108,5.7719470047,3.1543931033,3.9281820218,13.713464853,17.641646875
2024,Georgia,Franklin County,24782,636,279,341,-62,36,668,704,-6,798,11.404512753,13.938848921,-2.534336167,1.4715500327,27.305428385,28.776978417
2024,Georgia,Fulton County,1079105,5407,11842,7153,4689,4986,-4327,659,59,33461,11.001471105,6.6452898849,4.3561812205,4.6321005684,-4.019875483,0.6122250852
2024,Georgia,Gilmer County,32860,457,297,424,-127,20,563,583,1,249,9.1016349233,12.993579823,-3.8919449,0.6129047086,17.253267548,17.866172257
2024,Georgia,Glascock County,2954,26,32,50,-18,0,45,45,-1,56,10.880652839,17.001020061,-6.120367222,0.0,15.300918055,15.300918055
2024,Georgia,Glynn County,86172,1027,900,1032,-132,114,1045,1159,0,2267,10.506838201,12.047841137,-1.541002936,1.3308661721,12.199606577,13.530472749
2024,Georgia,Gordon County,59757,902,660,688,-28,64,867,931,-1,490,11.12872222,11.60084983,-0.472127609,1.0791488214,14.619094189,15.698243011
2024,Georgia,Grady County,26066,72,298,328,-30,37,64,101,1,158,11.448328851,12.600845179,-1.152516327,1.4214368037,2.4587014983,3.880138302
2024,Georgia,Greene County,20722,611,141,254,-113,30,691,721,3,94,6.9061788259,12.440917885,-5.534739059,1.4693997502,33.845174246,35.314573997
2024,Georgia,Gwinnett County,983526,7353,11245,5081,6164,6165,-5069,1096,93,5934,11.47625222,5.1854902207,6.2907619997,6.2917825646,-5.173243442,1.1185391226
2024,Georgia,Habersham County,48757,1292,526,552,-26,107,1212,1319,-1,2739,10.933050654,11.473467606,-0.540416952,2.2240236121,25.191744092,27.415767704
2024,Georgia,Hall County,217267,4646,2694,1758,936,671,3027,3698,12,2396,12.533497097,8.1788744975,4.3546225994,3.1217433378,14.082737829,17.204481167
2024,Georgia,Hancock County,8676,259,51,148,-97,2,353,355,1,1315,5.9673550576,17.317030363,-11.34967531,0.2340139238,41.303457556,41.53747148
2024,Georgia,Haralson County,32038,683,345,418,-73,-1,759,758,-2,179,10.884482514,13.187575915,-2.303093401,-0.031549225,23.94586153,23.914312306
2024,Georgia,Harris County,36654,397,305,334,-29,19,410,429,-3,453,8.3663644718,9.1618548641,-0.795490392,0.5211833605,11.246588306,11.767771667
2024,Georgia,Hart County,27556,670,266,392,-126,7,790,797,-1,688,9.7718673083,14.40064656,-4.628779251,0.2571544029,29.021711179,29.278865582
2024,Georgia,Heard County,12034,318,114,167,-53,0,371,371,0,105,9.6,14.063157895,-4.463157895,0.0,31.242105263,31.242105263
2024,Georgia,Henry County,254613,6141,2777,1922,855,252,5076,5328,-42,1334,11.039883916,7.640855919,3.3990279973,1.0018187781,20.179492531,21.181311309
2024,Georgia,Houston County,171974,2199,2033,1454,579,131,1496,1627,-7,1887,11.897620768,8.50916901,3.3884517585,0.7666445257,8.7549634381,9.5216079637
2024,Georgia,Irwin County,9120,6,99,150,-51,2,57,59,-2,264,10.858835143,16.45278052,-5.593945377,0.2193704069,6.2520565976,6.4714270045
2024,Georgia,Jackson County,88615,4606,1040,756,284,126,4209,4335,-13,603,12.049309482,8.7589211234,3.2903883585,1.4598201872,48.764945778,50.224765965
2024,Georgia,Jasper County,16455,476,180,197,-17,13,484,497,-4,73,11.099463526,12.147746192,-1.048282666,0.8016279213,29.845224147,30.646852069
2024,Georgia,Jeff Davis County,14906,15,163,212,-49,3,61,64,0,105,10.940698728,14.229620432,-3.288921704,0.2013625533,4.0943719166,4.2957344699
2024,Georgia,Jefferson County,15183,-111,166,266,-100,8,-18,-10,-1,527,10.893460642,17.455786331,-6.562325688,0.5249860551,-1.181218624,-0.656232569
2024,Georgia,Jenkins County,8627,-28,94,129,-35,7,-1,6,1,1130,10.878370559,14.928827682,-4.050457123,0.8100914246,-0.115727346,0.6943640782
2024,Georgia,Johnson County,9282,71,97,138,-41,4,107,111,1,1853,10.490455848,14.924566052,-4.434110204,0.4325961174,11.571946142,12.004542259
2024,Georgia,Jones County,28969,457,253,354,-101,0,562,562,-4,303,8.8029087873,12.317113481,-3.514204694,0.0,19.554287504,19.554287504
2024,Georgia,Lamar County,20401,928,222,254,-32,6,952,958,2,740,11.135075488,12.740131414,-1.605055926,0.3009479862,47.750413803,48.05136179
2024,Georgia,Lanier County,10452,275,129,114,15,74,187,261,-1,356,12.506665374,11.052401958,1.4542634156,7.1743661835,18.129817248,25.304183431
2024,Georgia,Laurens County,49941,231,609,675,-66,69,229,298,-1,875,12.222657073,13.547280007,-1.324622934,1.3848330674,4.5960401802,5.9808732476
2024,Georgia,Lee County,33872,194,315,299,16,26,154,180,-2,988,9.3264248705,8.8527017024,0.473723168,0.769800148,4.5595854922,5.3293856403
2024,Georgia,Liberty County,69210,1291,1382,518,864,175,251,426,1,4433,20.156203283,7.5549300294,12.601273254,2.5523412261,3.6607865586,6.2131277848
2024,Georgia,Lincoln County,7879,20,87,113,-26,3,43,46,0,26,11.056042699,14.360147414,-3.304104715,0.3812428517,5.4644808743,5.845723726
2024,Georgia,Long County,19594,1199,278,145,133,12,1055,1067,-1,300,14.635815631,7.6337887283,7.0020269025,0.6317618258,55.542393851,56.174155677
2024,Georgia,Lowndes County,120712,1213,1618,1088,530,97,579,676,7,4791,13.471489649,9.0587025573,4.4127870913,0.8076232979,4.820761747,5.6283850448
2024,Georgia,Lumpkin County,35258,552,324,373,-49,74,526,600,1,3924,9.2619061231,10.662626494,-1.40072037,2.1153736207,15.036304385,17.151678006
2024,Georgia,McDuffie County,21799,109,265,298,-33,-6,147,141,1,198,12.186989814,13.70461496,-1.517625147,-0.275931845,6.7603301984,6.4843983536
2024,Georgia,McIntosh County,11501,318,96,193,-97,1,415,416,-1,55,8.4641156762,17.016399224,-8.552283548,0.0881678716,36.589666725,36.677834597
2024,Georgia,Macon County,11817,40,124,175,-51,9,83,92,-1,2009,10.511146902,14.834279902,-4.323133,0.7629058235,7.0356870391,7.7985928626
2024,Georgia,Madison County,32191,741,403,382,21,-1,721,720,0,144,12.664791565,12.004839647,0.6599519178,-0.031426282,22.658349177,22.626922896
2024,Georgia,Marion County,7440,4,71,122,-51,15,40,55,0,76,9.5455767679,16.402258672,-6.856681904,2.0166711482,5.3777897284,7.3944608766
2024,Georgia,Meriwether County,20931,41,241,327,-86,0,126,126,1,70,11.525310251,15.638076564,-4.112766314,0.0,6.025680878,6.025680878
2024,Georgia,Miller County,5747,-27,56,114,-58,-1,35,34,-3,156,9.7213783526,19.789948789,-10.06857044,-0.173596042,6.0758614704,5.9022654283
2024,Georgia,Mitchell County,21114,-78,234,282,-48,-3,-24,-27,-3,1319,11.062260672,13.331442349,-2.269181676,-0.141823855,-1.134590838,-1.276414693
2024,Georgia,Monroe County,30625,1156,268,359,-91,5,1247,1252,-5,1377,8.9193596699,11.947948214,-3.028588545,0.166405964,41.501647419,41.668053383
2024,Georgia,Montgomery County,8761,118,107,134,-27,17,128,145,0,714,12.296023903,15.398758906,-3.102735003,1.9535738911,14.709262239,16.66283613
2024,Georgia,Morgan County,21460,436,210,257,-47,3,483,486,-3,198,9.8860747576,12.098672441,-2.212597684,0.1412296394,22.737971942,22.879201582
2024,Georgia,Murray County,41035,625,454,490,-36,1,660,661,0,239,11.148627908,12.032660077,-0.884032169,0.0245564491,16.207256431,16.23181288
2024,Georgia,Muscogee County,201877,-555,2700,2140,560,368,-1488,-1120,5,6235,13.356121185,10.585962717,2.7701584679,1.8203898503,-7.360706786,-5.540316936
2024,Georgia,Newton County,120135,2383,1306,1055,251,280,1859,2139,-7,1526,10.980003111,8.8697574899,2.1102456208,2.3540588599,15.629269359,17.983328219
2024,Georgia,Oconee County,44182,558,356,333,23,54,491,545,-10,148,8.1087852766,7.5849030818,0.5238821948,1.2299842835,11.183745985,12.413730269
2024,Georgia,Oglethorpe County,15754,223,162,187,-25,4,245,249,-1,72,10.356400831,11.954610836,-1.598210005,0.2557136008,15.662458047,15.918171648
2024,Georgia,Paulding County,183164,4411,2007,1223,784,320,3326,3646,-19,648,11.090940741,6.758455668,4.3324850725,1.7683612541,18.379904785,20.148266039
2024,Georgia,Peach County,28805,319,310,362,-52,4,366,370,1,1459,10.82194411,12.637237961,-1.815293851,0.1396379885,12.776875949,12.916513938
2024,Georgia,Pickens County,35969,1144,317,456,-139,-5,1287,1282,1,303,8.9555612058,12.882447665,-3.926886459,-0.141254909,36.359013476,36.217758567
2024,Georgia,Pierce County,20425,235,253,276,-23,-1,258,257,1,193,12.458451311,13.591037794,-1.132586483,-0.049242891,12.704665764,12.655422873
2024,Georgia,Pike County,20461,506,196,245,-49,3,554,557,-2,230,9.6991290578,12.123911322,-2.424782264,0.148456057,27.414885194,27.563341251
2024,Georgia,Polk County,44223,554,584,574,10,22,519,541,3,269,13.289036545,13.061484549,0.2275519956,0.5006143904,11.809948573,12.310562964
2024,Georgia,Pulaski County,10095,132,96,158,-62,1,195,196,-2,1304,9.5722405025,15.754312494,-6.182071991,0.0997108386,19.443613521,19.543324359
2024,Georgia,Putnam County,23129,196,211,339,-128,7,317,324,0,151,9.1615648474,14.71929139,-5.557726542,0.3039381703,13.76405714,14.067995311
2024,Georgia,Quitman County,2280,21,18,43,-25,0,46,46,0,0,7.9312623926,18.946904605,-11.01564221,0.0,20.26878167,20.26878167
2024,Georgia,Rabun County,17442,175,151,256,-105,28,254,282,-2,187,8.7009133078,14.751217264,-6.050303956,1.6134143882,14.635973379,16.249387767
2024,Georgia,Randolph County,6078,-48,57,106,-49,3,-1,2,-1,146,9.3411996067,17.371353655,-8.030154048,0.4916420846,-0.163880695,0.3277613897
2024,Georgia,Richmond County,205414,-930,2688,2245,443,163,-1550,-1387,14,10973,13.05621263,10.904463301,2.1517493285,0.7917271796,-7.528694039,-6.736966859
2024,Georgia,Rockdale County,95987,1042,974,833,141,122,784,906,-5,899,10.202585214,8.7256195923,1.4769656213,1.2779418851,8.2123478516,9.4902897367
2024,Georgia,Schley County,4526,29,50,57,-7,0,35,35,1,0,11.08278843,12.63437881,-1.55159038,0.0,7.7579519007,7.7579519007
2024,Georgia,Screven County,14174,204,153,211,-58,0,264,264,-2,245,10.872654918,14.994314952,-4.121660034,0.0,18.760659466,18.760659466
2024,Georgia,Seminole County,9092,-52,96,143,-47,2,-7,-5,0,121,10.528624698,15.683263874,-5.154639175,0.2193463479,-0.767712218,-0.54836587
2024,Georgia,Spalding County,69946,938,848,927,-79,50,968,1018,-1,858,12.205478072,13.342545015,-1.137066943,0.7196626222,13.932668365,14.652330987
2024,Georgia,Stephens County,27228,482,297,422,-125,9,593,602,5,768,11.005298848,15.637158632,-4.631859784,0.3334939045,21.973542817,22.307036721
2024,Georgia,Stewart County,4674,70,33,80,-47,109,9,118,-1,776,7.1136020694,17.245095926,-10.13149386,23.496443199,1.9400732917,25.436516491
2024,Georgia,Sumter County,28890,26,349,390,-41,17,49,66,1,1557,12.085742979,13.505558057,-1.419815078,0.5887038127,1.6968521661,2.2855559788
2024,Georgia,Talbot County,5718,-39,46,93,-47,0,9,9,-1,0,8.0174291939,16.209150327,-8.191721133,0.0,1.568627451,1.568627451
2024,Georgia,Taliaferro County,1609,1,13,32,-19,0,22,22,-2,19,8.0820640348,19.89431147,-11.81224744,0.0,13.677339136,13.677339136
2024,Georgia,Tattnall County,24296,308,290,283,7,-7,307,300,1,4111,12.01226079,11.722309668,0.2899511225,-0.289951123,12.716427802,12.42647668
2024,Georgia,Taylor County,7758,-4,69,129,-60,9,48,57,-1,232,8.8917525773,16.62371134,-7.731958763,1.1597938144,6.1855670103,7.3453608247
2024,Georgia,Telfair County,10920,-1458,126,177,-51,32,-1455,-1423,16,1635,10.816379088,15.194437291,-4.378058202,2.7470169113,-124.9034252,-122.1564083
2024,Georgia,Terrell County,8718,-74,88,137,-49,1,-25,-24,-1,296,10.0513992,15.648201028,-5.596801828,0.1142204455,-2.855511136,-2.741290691
2024,Georgia,Thomas County,45649,98,526,602,-76,6,168,174,0,487,11.535087719,13.201754386,-1.666666667,0.1315789474,3.6842105263,3.8157894737
2024,Georgia,Tift County,41554,219,513,491,22,29,165,194,3,1014,12.377999493,11.847169106,0.5308303876,0.6997309655,3.9812279072,4.6809588727
2024,Georgia,Toombs County,27040,227,384,382,2,56,168,224,1,540,14.261043953,14.186767682,0.0742762706,2.0797355765,6.2392067294,8.3189423059
2024,Georgia,Towns County,13035,74,99,226,-127,5,196,201,0,570,7.6165563933,17.387290352,-9.770733959,0.3846745653,15.07924296,15.463917526
2024,Georgia,Treutlen County,6341,-18,79,97,-18,0,2,2,-2,482,12.440944882,15.275590551,-2.834645669,0.0,0.3149606299,0.3149606299
2024,Georgia,Troup County,70742,495,920,795,125,86,283,369,1,1280,13.050663527,11.277475548,1.7731879792,1.2199533297,4.0144975849,5.2344509146
2024,Georgia,Turner County,8909,73,115,131,-16,-1,90,89,0,326,12.961397577,14.764722457,-1.80332488,-0.112707805,10.143702451,10.030994646
2024,Georgia,Twiggs County,7691,15,56,153,-97,0,113,113,-1,104,7.2883451552,19.912800156,-12.624455,0.0,14.706839331,14.706839331
2024,Georgia,Union County,27124,734,175,399,-224,28,932,960,-2,527,6.5403445827,14.911985649,-8.371641066,1.0464551332,34.832006578,35.878461711
2024,Georgia,Upson County,28263,170,329,451,-122,-5,296,291,1,367,11.675775428,16.005394279,-4.329618852,-0.177443396,10.504649017,10.327205621
2024,Georgia,Walker County,69489,524,603,879,-276,7,794,801,-1,1293,8.7104742369,12.697357967,-3.98688373,0.1011166163,11.46951334,11.570629957
2024,Georgia,Walton County,106702,3638,1146,1035,111,89,3455,3544,-17,912,10.926460914,9.8681387832,1.0583221304,0.848564591,32.941468112,33.790032703
2024,Georgia,Ware County,36243,646,459,547,-88,34,696,730,4,2264,12.778396437,15.228285078,-2.449888641,0.9465478842,19.376391982,20.322939866
2024,Georgia,Warren County,5106,-51,51,84,-33,1,-20,-19,1,71,9.9386144402,16.369482607,-6.430868167,0.1948747929,-3.897495859,-3.702621066
2024,Georgia,Washington County,19820,55,205,273,-68,3,117,120,3,1888,10.357458633,13.793103448,-3.435644815,0.1515725654,5.9113300493,6.0629026146
2024,Georgia,Wayne County,31373,636,339,442,-103,43,696,739,0,1997,10.916116567,14.232812752,-3.316696184,1.3846401546,22.411849944,23.796490098
2024,Georgia,Webster County,2337,0,18,28,-10,6,4,10,0,0,7.702182285,11.981172443,-4.278990158,2.567394095,1.7115960633,4.2789901583
2024,Georgia,Wheeler County,7081,-229,70,76,-6,0,-225,-225,2,2100,9.7283024112,10.562156904,-0.833854492,0.0,-31.26954346,-31.26954346
2024,Georgia,White County,29026,222,272,408,-136,16,339,355,3,668,9.4068822411,14.110323362,-4.703441121,0.5533460142,11.724018675,12.27736469
2024,Georgia,Whitfield County,103687,592,1204,979,225,170,197,367,0,959,11.645114178,9.4689092861,2.1762048921,1.6442436963,1.9053882833,3.5496319796
2024,Georgia,Wilcox County,8779,28,83,146,-63,-2,93,91,0,2087,9.4694808899,16.657159156,-7.187678266,-0.228180262,10.610382202,10.38220194
2024,Georgia,Wilkes County,9518,-47,94,169,-75,7,22,29,-1,109,9.8517004664,17.712099775,-7.860399308,0.7336372688,2.3057171304,3.0393543992
2024,Georgia,Wilkinson County,8725,48,108,156,-48,2,94,96,0,107,12.412366395,17.928973681,-5.516607287,0.2298586369,10.803355936,11.033214573
2024,Georgia,Worth County,20273,-158,208,299,-91,-1,-67,-68,1,174,10.220125786,14.691430818,-4.471305031,-0.04913522,-3.292059748,-3.341194969
2024,Hawaii,Hawaii,1435138,-4261,15167,12812,2355,4627,-11193,-6566,-50,40128,10.552655958,8.9141312149,1.6385247433,3.2193010561,-7.787688939,-4.568387883
2024,Hawaii,Hawaii County,207615,1267,1945,2051,-106,583,784,1367,6,2683,9.396975092,9.9090981561,-0.512123064,2.8166768528,3.7877781348,6.6044549875
2024,Hawaii,Honolulu County,989408,-5420,10799,8770,2029,3399,-10794,-7395,-54,34281,10.884793946,8.8396743129,2.0451196329,3.4260037616,-10.87975422,-7.453750461
2024,Hawaii,Kalawao County,81,0,0,0,0,0,0,0,0,18,0.0,0.0,0.0,0.0,0.0,0.0
2024,Hawaii,Kauai County,73851,68,779,640,139,175,-247,-72,1,918,10.553124619,8.6700895458,1.8830350732,2.3707276102,-3.346112684,-0.975385074
2024,Hawaii,Maui County,164183,-176,1644,1351,293,470,-936,-466,-3,2228,10.007852877,8.2242148645,1.7836380128,2.8611258226,-5.697901638,-2.836775816
2024,Idaho,Idaho,1964726,25730,22456,16817,5639,4664,15389,20053,38,50256,11.504917615,8.6158799218,2.8890376927,2.3895144173,7.8842704475,10.273784865
2024,Idaho,Ada County,524673,5669,5080,3781,1299,1435,2916,4351,19,13711,9.7348125905,7.2455366938,2.4892758967,2.7498929266,5.5879357311,8.3378286577
2024,Idaho,Adams County,4903,112,28,53,-25,1,136,137,0,29,5.7767691355,10.934598721,-5.157829585,0.2063131834,28.058592944,28.264906128
2024,Idaho,Bannock County,90400,775,1059,871,188,223,361,584,3,2343,11.765032634,9.6764338286,2.0885988057,2.4774336898,4.0105540897,6.4879877795
2024,Idaho,Bear Lake County,6766,36,77,68,9,17,10,27,0,59,11.410788382,10.07705987,1.3337285122,2.5192649674,1.4819205691,4.0011855365
2024,Idaho,Benewah County,10369,78,104,150,-46,1,124,125,-1,66,10.067763795,14.520813166,-4.453049371,0.0968054211,12.003872217,12.100677638
2024,Idaho,Bingham County,50395,422,667,471,196,7,219,226,0,503,13.291088793,9.3854615017,3.9056272916,0.139486689,4.3639406982,4.5034273872
2024,Idaho,Blaine County,25041,140,199,153,46,269,-174,95,-1,383,7.9692443234,6.1271074446,1.8421368788,10.772496095,-6.968082976,3.8044131192
2024,Idaho,Boise County,8517,157,68,84,-16,66,106,172,1,19,8.058304201,9.9543757777,-1.896071577,7.8212952539,12.561474196,20.38276945
2024,Idaho,Bonner County,52547,1140,448,549,-101,107,1139,1246,-5,519,8.6191969525,10.562364123,-1.94316717,2.0586028436,21.913538681,23.972141524
2024,Idaho,Bonneville County,131366,1823,1803,994,809,69,935,1004,10,1671,13.820910739,7.61951485,6.201395889,0.5289200449,7.1672498841,7.696169929
2024,Idaho,Boundary County,13557,285,151,153,-2,73,215,288,-1,119,11.256476201,11.405568601,-0.1490924,5.4418726005,16.027433002,21.469305602
2024,Idaho,Butte County,2758,60,33,37,-4,0,65,65,-1,4,12.096774194,13.563049853,-1.46627566,0.0,23.826979472,23.826979472
2024,Idaho,Camas County,1232,63,11,6,5,0,58,58,0,0,9.162848813,4.9979175344,4.1649312786,0.0,48.313202832,48.313202832
2024,Idaho,Canyon County,257674,6782,3341,1970,1371,584,4816,5400,11,3234,13.138904292,7.7472737069,5.3916305848,2.2966537283,18.939528006,21.236181735
2024,Idaho,Caribou County,7219,19,85,76,9,4,8,12,-2,77,11.789999306,10.541646439,1.2483528677,0.5548234968,1.1096469936,1.6644704903
2024,Idaho,Cassia County,25696,52,366,228,138,60,-148,-88,2,367,14.257888586,8.8819633814,5.3759252045,2.3373587846,-5.765485002,-3.428126217
2024,Idaho,Clark County,801,-9,19,5,14,-1,-20,-21,-2,2,23.587833644,6.2073246431,17.380509001,-1.241464929,-24.82929857,-26.0707635
2024,Idaho,Clearwater County,9214,179,67,136,-69,7,240,247,1,724,7.3428681024,14.904926297,-7.562058195,0.7671653241,26.302811113,27.069976437
2024,Idaho,Custer County,4523,5,33,66,-33,0,38,38,0,120,7.3000774251,14.60015485,-7.300077425,0.0,8.4061497622,8.4061497622
2024,Idaho,Elmore County,29724,333,459,245,214,171,-53,118,1,1117,15.52905354,8.28892836,7.2401251797,5.7853336717,-1.793115115,3.992218557
2024,Idaho,Franklin County,15494,324,216,124,92,2,230,232,0,94,14.088181581,8.0876597965,6.0005217845,0.1304461258,15.001304461,15.131750587
2024,Idaho,Fremont County,14196,179,186,143,43,25,112,137,-1,581,13.185410981,10.137170808,3.048240173,1.7722326587,7.939602311,9.7118349697
2024,Idaho,Gem County,21071,617,204,256,-52,267,403,670,-1,257,9.8254063817,12.329921734,-2.504515352,12.859723058,19.40999398,32.269717038
2024,Idaho,Gooding County,16061,182,226,166,60,13,108,121,1,107,14.151534126,10.394489668,3.7570444584,0.8140262993,6.762680025,7.5767063244
2024,Idaho,Idaho County,17890,253,170,228,-58,16,299,315,-4,503,9.5701860557,12.835308357,-3.265122301,0.9007233935,16.832268416,17.732991809
2024,Idaho,Jefferson County,34198,862,448,238,210,34,618,652,0,174,13.26739124,7.0483015962,6.2190896437,1.006900228,18.30189238,19.308792608
2024,Idaho,Jerome County,25479,235,364,223,141,92,0,92,2,207,14.35246338,8.7928553122,5.5596080673,3.6275456893,0.0,3.6275456893
2024,Idaho,Kootenai County,185010,1720,1879,1782,97,12,1613,1625,-2,1748,10.203638338,9.6768938365,0.5267445018,0.0651642683,8.7591637252,8.8243279935
2024,Idaho,Latah County,41301,377,431,295,136,368,-128,240,1,2676,10.483429614,7.1754332624,3.3079963515,8.951048951,-3.113408331,5.8376406202
2024,Idaho,Lemhi County,8441,157,64,129,-65,0,221,221,1,75,7.6532137519,15.426008969,-7.772795217,0.0,26.427503737,26.427503737
2024,Idaho,Lewis County,3739,14,33,61,-28,4,38,42,0,105,8.8424437299,16.345123258,-7.502679528,1.0718113612,10.182207931,11.254019293
2024,Idaho,Lincoln County,5450,65,66,38,28,3,32,35,2,39,12.182741117,7.0143054915,5.1684356253,0.5537609599,5.9067835718,6.4605445316
2024,Idaho,Madison County,54547,-411,1110,210,900,388,-1703,-1315,4,14790,20.273046893,3.8354413041,16.437605589,7.0864344094,-31.10360258,-24.01716817
2024,Idaho,Minidoka County,22480,272,304,212,92,10,168,178,2,77,13.605442177,9.4880057286,4.1174364483,0.44754744,7.5187969925,7.9663444325
2024,Idaho,Nez Perce County,42987,78,395,591,-196,62,212,274,0,1113,9.1971686691,13.760827047,-4.563658378,1.4436062215,4.9362019186,6.3798081401
2024,Idaho,Oneida County,4953,213,57,55,2,0,212,212,-1,41,11.761064686,11.34839575,0.4126689363,0.0,43.742907253,43.742907253
2024,Idaho,Owyhee County,12722,77,148,137,11,6,60,66,0,156,11.668703434,10.801434935,0.8672684984,0.4730555446,4.7305554461,5.2036109907
2024,Idaho,Payette County,27279,350,326,302,24,-8,335,327,-1,180,12.027744982,11.142266824,0.8854781582,-0.295159386,12.359799292,12.064639906
2024,Idaho,Power County,8253,117,111,62,49,14,54,68,0,58,13.545670877,7.5660503997,5.9796204771,1.7084629935,6.589785832,8.2982488254
2024,Idaho,Shoshone County,14026,91,154,227,-73,1,160,161,3,187,11.015342799,16.236901398,-5.221558599,0.0715282,11.444511999,11.516040199
2024,Idaho,Teton County,12549,30,129,63,66,16,-51,-35,-1,23,10.292005744,5.0263283868,5.2656773576,1.2765278443,-4.068932504,-2.792404659
2024,Idaho,Twin Falls County,95156,1335,1137,923,214,194,926,1120,1,1711,12.033210391,9.7683845124,2.2648258783,2.0531599083,9.8001344079,11.853294316
2024,Idaho,Valley County,12644,194,84,96,-12,-1,208,207,-1,143,6.6948274488,7.65123137,-0.956403921,-0.079700327,16.577667968,16.497967642
2024,Idaho,Washington County,11425,278,116,160,-44,53,271,324,-2,144,10.278220805,14.176856282,-3.898635478,4.6960836435,24.012050328,28.708133971
2024,Illinois,Illinois,12549689,-32826,127235,116782,10453,40492,-83839,-43347,68,278186,10.125256026,9.2934149349,0.8318410912,3.222319857,-6.671838252,-3.449518395
2024,Illinois,Adams County,64441,-115,700,834,-134,9,9,18,1,1625,10.852965573,12.930533268,-2.077567695,0.1395381288,0.1395381288,0.2790762576
2024,Illinois,Alexander County,4695,-146,30,104,-74,0,-73,-73,1,82,6.2919463087,21.812080537,-15.52013423,0.0,-15.31040268,-15.31040268
2024,Illinois,Bond County,16450,-86,130,203,-73,8,-21,-13,0,2371,7.8821318135,12.308251986,-4.426120172,0.4850542654,-1.273267447,-0.788213181
2024,Illinois,Boone County,53202,134,512,485,27,-1,114,113,-6,265,9.6358332549,9.1276936106,0.5081396443,-0.018819987,2.1454784982,2.1266585113
2024,Illinois,Brown County,6294,-22,56,61,-5,0,-17,-17,0,1720,8.8818398097,9.6748612213,-0.793021412,0.0,-2.696272799,-2.696272799
2024,Illinois,Bureau County,32729,-98,319,425,-106,15,-6,9,-1,416,9.7321374092,12.96601379,-3.23387638,0.4576240161,-0.183049606,0.2745744097
2024,Illinois,Calhoun County,4317,-36,27,82,-55,0,19,19,0,85,6.2283737024,18.915801615,-12.68742791,0.0,4.3829296424,4.3829296424
2024,Illinois,Carroll County,15526,-53,124,226,-102,3,46,49,0,1234,7.9729946954,14.531425816,-6.55843112,0.192895033,2.9577238386,3.1506188716
2024,Illinois,Cass County,12596,-42,158,139,19,67,-128,-61,0,127,12.522786716,11.016881985,1.5059047317,5.3102956329,-10.1450424,-4.83474677
2024,Illinois,Champaign County,205644,-525,2090,1504,586,2144,-3275,-1131,20,15033,10.150238094,7.3042861687,2.8459519248,10.412493049,-15.9052774,-5.492784346
2024,Illinois,Christian County,33228,-162,284,449,-165,0,3,3,0,2912,8.5262241436,13.479840283,-4.95361614,0.0,0.090065748,0.090065748
2024,Illinois,Clark County,15088,-72,87,225,-138,-4,71,67,-1,230,5.7524464427,14.877016662,-9.12457022,-0.264480296,4.6945252579,4.4300449617
2024,Illinois,Clay County,12999,-78,163,184,-21,0,-58,-58,1,278,12.501917472,14.112593956,-1.610676484,0.0,-4.448535051,-4.448535051
2024,Illinois,Clinton County,36785,-152,375,368,7,38,-201,-163,4,1757,10.173353951,9.9834513442,0.1899026071,1.0308998671,-5.452917718,-4.422017851
2024,Illinois,Coles County,46060,-286,449,566,-117,52,-225,-173,4,2705,9.7179836807,12.250286778,-2.532303097,1.1254680432,-4.869813648,-3.744345605
2024,Illinois,Cook County,5087072,-24494,53124,43149,9975,23790,-58105,-34315,-154,82190,10.417861679,8.4617181235,1.9561435556,4.665328841,-11.39465878,-6.729329936
2024,Illinois,Crawford County,18300,-195,147,250,-103,1,-94,-93,1,1342,7.990216062,13.588802826,-5.598586765,0.0543552113,-5.109389863,-5.055034651
2024,Illinois,Cumberland County,10261,-47,100,134,-34,2,-14,-12,-1,98,9.7233701201,13.029315961,-3.305945841,0.1944674024,-1.361271817,-1.166804414
2024,Illinois,DeKalb County,100288,65,1040,818,222,350,-513,-163,6,4827,10.373495718,8.1591533632,2.2143423553,3.4910802899,-5.116926253,-1.625845964
2024,Illinois,De Witt County,15365,0,165,201,-36,4,36,40,-4,164,10.738691832,13.081679141,-2.342987309,0.2603319232,2.3429873088,2.603319232
2024,Illinois,Douglas County,19629,-38,243,239,4,16,-57,-41,-1,226,12.36767101,12.164087948,0.2035830619,0.8143322476,-2.901058632,-2.086726384
2024,Illinois,DuPage County,921213,-451,9715,6667,3048,4517,-8099,-3582,83,13864,10.543297247,7.2354259129,3.3078713338,4.9021177214,-8.789517694,-3.887399973
2024,Illinois,Edgar County,16334,-51,112,259,-147,2,96,98,-2,367,6.8461750053,15.8317797,-8.985604695,0.1222531251,5.8681500046,5.9904031297
2024,Illinois,Edwards County,5968,-90,28,88,-60,3,-32,-29,-1,20,4.6565774156,14.634957592,-9.978380176,0.4989190088,-5.321802761,-4.822883752
2024,Illinois,Effingham County,34331,31,374,391,-17,37,10,47,1,405,10.898864944,11.394267896,-0.495402952,1.0782299544,0.2914135012,1.3696434556
2024,Illinois,Fayette County,21164,-106,188,252,-64,1,-44,-43,1,2423,8.8608191545,11.877268228,-3.016449074,0.0471320168,-2.073808738,-2.026676721
2024,Illinois,Ford County,13250,-6,144,210,-66,33,25,58,2,307,10.865464423,15.84546895,-4.980004527,2.4900022636,1.8863653512,4.3763676149
2024,Illinois,Franklin County,37138,-77,399,587,-188,4,109,113,-2,303,10.732586446,15.78954447,-5.056958025,0.1075948516,2.9319597057,3.0395545573
2024,Illinois,Fulton County,32541,-394,263,503,-240,0,-156,-156,2,1969,8.0334779156,15.364408333,-7.330930417,0.0,-4.765104771,-4.765104771
2024,Illinois,Gallatin County,4670,-153,24,91,-67,1,-86,-85,-1,86,5.0563573159,19.17202149,-14.11566417,0.2106815548,-18.11861372,-17.90793216
2024,Illinois,Greene County,11543,-97,91,185,-94,0,-2,-2,-1,111,7.8505801665,15.959970668,-8.109390502,0.0,-0.172540223,-0.172540223
2024,Illinois,Grundy County,53578,429,580,508,72,33,328,361,-4,220,10.868852305,9.5196154675,1.3492368379,0.6184002174,6.1465233727,6.7649235901
2024,Illinois,Hamilton County,7911,-70,73,105,-32,0,-39,-39,1,86,9.1870123332,13.214195822,-4.027183489,0.0,-4.908129877,-4.908129877
2024,Illinois,Hancock County,17186,-68,178,228,-50,5,-22,-17,-1,178,10.336817654,13.240418118,-2.903600465,0.2903600465,-1.277584204,-0.987224158
2024,Illinois,Hardin County,3569,-3,27,83,-56,-1,56,55,-2,41,7.5619661112,23.246043971,-15.68407786,-0.280072819,15.68407786,15.404005041
2024,Illinois,Henderson County,6088,-80,55,95,-40,1,-40,-39,-1,40,8.9751958225,15.502610966,-6.527415144,0.1631853786,-6.527415144,-6.364229765
2024,Illinois,Henry County,48448,-148,505,569,-64,-2,-82,-84,0,736,10.407650138,11.726639463,-1.318989324,-0.041218416,-1.689955072,-1.731173488
2024,Illinois,Iroquois County,26136,-357,273,424,-151,2,-209,-207,1,387,10.374508351,16.112789527,-5.738281176,0.0760037242,-7.942389177,-7.866385453
2024,Illinois,Jackson County,52141,-336,542,569,-27,237,-549,-312,3,3061,10.361505668,10.877669235,-0.516163566,4.5307690837,-10.49532585,-5.964556768
2024,Illinois,Jasper County,9144,-28,83,121,-38,8,2,10,0,120,9.0631142171,13.21249181,-4.149377593,0.8735531775,0.2183882944,1.0919414719
2024,Illinois,Jefferson County,36320,-99,402,504,-102,9,-5,4,-1,1683,11.053217669,13.857765435,-2.804547767,0.2474600971,-0.137477832,0.1099822654
2024,Illinois,Jersey County,21091,-100,151,292,-141,14,28,42,-1,706,7.1425192753,13.812024029,-6.669504754,0.6622203302,1.3244406603,1.9866609905
2024,Illinois,Jo Daviess County,21756,-89,143,280,-137,5,45,50,-2,207,6.5594825807,12.843742116,-6.284259535,0.2293525378,2.0641728401,2.2935253779
2024,Illinois,Johnson County,13326,-65,101,168,-67,6,-5,1,1,2455,7.5607291238,12.576262305,-5.015533181,0.4491522252,-0.374293521,0.0748587042
2024,Illinois,Kane County,514982,843,5581,3707,1874,731,-1805,-1074,43,5496,10.846149287,7.2042063081,3.6419429785,1.4206298385,-3.50784796,-2.087218121
2024,Illinois,Kankakee County,105940,-58,1136,1243,-107,147,-101,46,3,3876,10.72011626,11.729845521,-1.00972926,1.3871981429,-0.953108928,0.4340892148
2024,Illinois,Kendall County,139976,2482,1566,751,815,235,1440,1675,-8,370,11.287706779,5.4131978232,5.8745089559,1.6938768155,10.379500487,12.073377302
2024,Illinois,Knox County,48411,-209,459,717,-258,169,-120,49,0,3626,9.4608939411,14.778782039,-5.317888098,3.4834228236,-2.473436324,1.0099864992
2024,Illinois,Lake County,708760,-1139,6534,4977,1557,2626,-5388,-2762,66,19964,9.2115159457,7.0164852865,2.1950306592,3.7020876758,-7.595905711,-3.893818035
2024,Illinois,LaSalle County,108309,128,1119,1328,-209,81,261,342,-5,2887,10.337659938,12.268465056,-1.930805118,0.748302462,2.411196822,3.159499284
2024,Illinois,Lawrence County,14813,-78,90,194,-104,3,24,27,-1,2276,6.0597899273,13.062213843,-7.002423916,0.2019929976,1.6159439806,1.8179369782
2024,Illinois,Lee County,33654,-284,343,405,-62,23,-243,-220,-2,2730,10.149130075,11.983666706,-1.834536632,0.6805539117,-7.190200024,-6.509646112
2024,Illinois,Livingston County,35320,-197,383,480,-97,23,-124,-101,1,1808,10.813557886,13.552239649,-2.738681762,0.6493781498,-3.500995243,-2.851617093
2024,Illinois,Logan County,27590,-76,254,342,-88,12,0,12,0,3219,9.1935717388,12.3787462,-3.185174461,0.4343419719,0.0,0.4343419719
2024,Illinois,McDonough County,26839,-75,233,319,-86,42,-29,13,-2,2491,8.6692835749,11.86910498,-3.199821405,1.562703477,-1.079009544,0.4836939334
2024,Illinois,McHenry County,312800,1242,3060,2421,639,114,499,613,-10,1852,9.802068685,7.7551661066,2.0469025783,0.3651751079,1.5984419195,1.9636170274
2024,Illinois,McLean County,170441,-477,1692,1356,336,605,-1426,-821,8,8625,9.913317065,7.9447150947,1.9686019704,3.5446553335,-8.354840505,-4.810185172
2024,Illinois,Macon County,100591,-742,1149,1346,-197,170,-715,-545,0,3013,11.380519403,13.331748579,-1.951229175,1.6838018264,-7.081872388,-5.398070561
2024,Illinois,Macoupin County,44018,-105,369,635,-266,23,138,161,0,874,8.3729478903,14.408731464,-6.035783574,0.5218910609,3.1313463655,3.6532374264
2024,Illinois,Madison County,262752,-820,2189,3108,-919,122,-28,94,5,6718,8.3180702381,11.810215761,-3.492145523,0.463592768,-0.10639834,0.3571944278
2024,Illinois,Marion County,36673,-232,421,560,-139,5,-99,-94,1,846,11.443638044,15.221941341,-3.778303297,0.1359101905,-2.691021773,-2.555111582
2024,Illinois,Marshall County,11683,12,121,181,-60,4,67,71,1,227,10.362250578,15.50055665,-5.138306072,0.3425537381,5.7377751135,6.0803288516
2024,Illinois,Mason County,12523,-176,87,211,-124,4,-55,-51,-1,180,6.8987391959,16.731424946,-9.832685751,0.3171834113,-4.361271905,-4.044088494
2024,Illinois,Massac County,13661,-166,81,238,-157,-6,-2,-8,-1,255,5.8934807916,17.316647264,-11.42316647,-0.436554133,-0.145518044,-0.582072177
2024,Illinois,Menard County,11954,-118,109,153,-44,2,-78,-76,2,95,9.0735037043,12.736202447,-3.662698743,0.1664863065,-6.492965954,-6.326479647
2024,Illinois,Mercer County,15487,-46,137,207,-70,1,25,26,-2,134,8.8330109607,13.34622824,-4.513217279,0.0644745326,1.611863314,1.6763378466
2024,Illinois,Monroe County,34957,-44,134,347,-213,0,172,172,-3,281,3.8308699505,9.920237857,-6.089367906,0.0,4.9172360559,4.9172360559
2024,Illinois,Montgomery County,27663,-238,235,392,-157,4,-86,-82,1,2354,8.4587142754,14.109855302,-5.651141027,0.1439781153,-3.09552948,-2.951551364
2024,Illinois,Morgan County,32140,-158,327,448,-121,7,-44,-37,0,2467,10.149290791,13.90483876,-3.755547969,0.2172631056,-1.365653807,-1.148390701
2024,Illinois,Moultrie County,14342,-33,162,204,-42,6,3,9,0,402,11.282515583,14.207612216,-2.925096633,0.4178709475,0.2089354738,0.6268064213
2024,Illinois,Ogle County,51265,-80,519,562,-43,17,-52,-35,-2,495,10.115973102,10.954098041,-0.838124939,0.3313517201,-1.013546438,-0.682194718
2024,Illinois,Peoria County,177513,-487,2008,1989,19,608,-1121,-513,7,4726,11.296352032,11.189464239,0.1068877931,3.4204093802,-6.306379795,-2.885970415
2024,Illinois,Perry County,20503,-9,177,277,-100,5,87,92,-1,2266,8.6309886627,13.507253444,-4.876264781,0.2438132391,4.2423503596,4.4861635987
2024,Illinois,Piatt County,16714,39,155,187,-32,1,72,73,-2,199,9.2844948935,11.201293839,-1.916798946,0.0598999671,4.312797628,4.372697595
2024,Illinois,Pike County,14342,-157,158,233,-75,9,-93,-84,2,321,10.95662425,16.157553483,-5.200929233,0.6241115079,-6.449152249,-5.825040741
2024,Illinois,Pope County,3707,-39,26,70,-44,-1,6,5,0,73,6.977056219,18.784382128,-11.80732591,-0.268348316,1.6100898967,1.3417415806
2024,Illinois,Pulaski County,4911,-39,37,107,-70,-1,32,31,0,160,7.5043099077,21.701652976,-14.19734307,-0.202819187,6.4902139742,6.2873947875
2024,Illinois,Putnam County,5561,8,42,62,-20,0,28,28,0,1,7.5580349109,11.157099154,-3.599064243,0.0,5.0386899406,5.0386899406
2024,Illinois,Randolph County,29815,-211,251,400,-149,49,-113,-64,2,2890,8.3888972444,13.368760549,-4.979863304,1.6376731672,-3.776674855,-2.139001688
2024,Illinois,Richland County,15488,-67,141,249,-108,8,32,40,1,317,9.0841735657,16.042263956,-6.958090391,0.515414103,2.0616564121,2.5770705151
2024,Illinois,Rock Island County,141236,-323,1622,1663,-41,436,-717,-281,-1,4397,11.471207058,11.761169752,-0.289962694,3.0835057197,-5.070811012,-1.987305292
2024,Illinois,St. Clair County,251018,-1247,2168,2775,-607,223,-877,-654,14,4598,8.6154310795,11.027592826,-2.412161746,0.8861813334,-3.485116724,-2.59893539
2024,Illinois,Saline County,22873,-179,230,380,-150,4,-32,-28,-1,628,10.016330974,16.54872074,-6.532389766,0.1741970604,-1.393576483,-1.219379423
2024,Illinois,Sangamon County,193491,-660,1850,2074,-224,319,-764,-445,9,3689,9.5448893567,10.700594879,-1.155705522,1.6458484891,-3.941781334,-2.295932845
2024,Illinois,Schuyler County,6733,-20,66,100,-34,11,4,15,-1,595,9.7879282219,14.830194276,-5.042266054,1.6313213703,0.593207771,2.2245291413
2024,Illinois,Scott County,4710,-61,34,68,-34,0,-27,-27,0,37,7.1722392153,14.344478431,-7.172239215,0.0,-5.69560173,-5.69560173
2024,Illinois,Shelby County,20568,-142,180,294,-114,5,-34,-29,1,175,8.7213527787,14.244876205,-5.523523427,0.2422597994,-1.647366636,-1.405106837
2024,Illinois,Stark County,5218,-95,44,86,-42,4,-56,-52,-1,93,8.3562814548,16.332731934,-7.97645048,0.7596619504,-10.63526731,-9.875605356
2024,Illinois,Stephenson County,43105,-451,314,623,-309,33,-175,-142,0,719,7.2466276641,14.377863168,-7.131235504,0.7615882577,-4.038725609,-3.277137351
2024,Illinois,Tazewell County,129541,-69,1201,1597,-396,36,294,330,-3,2475,9.2687274986,12.324860795,-3.056133297,0.2778302997,2.2689474476,2.5467777473
2024,Illinois,Union County,16667,-105,136,253,-117,21,-9,12,0,944,8.1342145399,15.13203146,-6.99781692,1.2560184216,-0.538293609,0.7177248123
2024,Illinois,Vermilion County,71652,-451,849,1115,-266,16,-203,-187,2,2690,11.811763069,15.512503913,-3.700740844,0.222600953,-2.824249591,-2.601648638
2024,Illinois,Wabash County,10942,-98,39,161,-122,10,15,25,-1,336,3.5483577472,14.648348649,-11.0999909,0.9098353198,1.3647529797,2.2745882995
2024,Illinois,Warren County,16185,-175,196,210,-14,25,-187,-162,1,874,12.044860962,12.905208173,-0.860347212,1.5363343063,-11.49178061,-9.955446305
2024,Illinois,Washington County,13536,-87,111,170,-59,1,-29,-28,0,217,8.1740859384,12.518870356,-4.344784418,0.0736404139,-2.135572002,-2.061931588
2024,Illinois,Wayne County,15761,-82,137,252,-115,57,-23,34,-1,131,8.6697886344,15.947348437,-7.277559803,3.6071383369,-1.455511961,2.1516263764
2024,Illinois,White County,13401,-194,86,243,-157,6,-43,-37,0,588,6.3713142688,18.002667062,-11.63135279,0.4445102978,-3.185657134,-2.741146837
2024,Illinois,Whiteside County,54498,-57,537,743,-206,43,112,155,-6,962,9.8484223268,13.626401841,-3.777979515,0.7886073744,2.0540471147,2.8426544891
2024,Illinois,Will County,700728,2682,6953,5180,1773,1289,-374,915,-6,9525,9.9415631117,7.4064859656,2.5350771461,1.8430425501,-0.534754006,1.3082885441
2024,Illinois,Williamson County,66706,162,633,854,-221,61,322,383,0,2039,9.5009380863,12.818011257,-3.317073171,0.9155722326,4.8330206379,5.7485928705
2024,Illinois,Winnebago County,280922,-620,3193,3290,-97,608,-1144,-536,13,3595,11.35361552,11.698526483,-0.344910963,2.1619161404,-4.067815896,-1.905899755
2024,Illinois,Woodford County,38285,108,397,420,-23,27,104,131,0,903,10.384243153,10.98584918,-0.601606027,0.7062331616,2.7203055112,3.4265386728
2024,Indiana,Indiana,6862199,29925,79587,72079,7508,17869,4599,22468,-51,178474,11.623229313,10.526728557,1.0965007562,2.6096659579,0.6716578287,3.2813237866
2024,Indiana,Adams County,36288,137,629,369,260,-1,-124,-125,2,482,17.366335814,10.187882218,7.1784535954,-0.027609437,-3.423570176,-3.451179613
2024,Indiana,Allen County,394545,2901,5282,3520,1762,1020,103,1123,16,6295,13.436972535,8.9545897997,4.4823827349,2.5947959079,0.2620235083,2.8568194162
2024,Indiana,Bartholomew County,84003,609,1031,820,211,673,-281,392,6,1247,12.318022426,9.7970692426,2.5209531832,8.0407653662,-3.357288362,4.6834770038
2024,Indiana,Benton County,8729,57,90,108,-18,9,68,77,-2,102,10.34423309,12.413079708,-2.068846618,1.034423309,7.8156427792,8.8500660882
2024,Indiana,Blackford County,11893,-26,130,202,-72,5,43,48,-2,136,10.918864438,16.966235512,-6.047371073,0.4199563245,3.6116243911,4.0315807156
2024,Indiana,Boone County,76120,1811,879,609,270,91,1456,1547,-6,831,11.686576392,8.0968430289,3.5897333626,1.2098730963,19.35796954,20.567842637
2024,Indiana,Brown County,15653,66,94,199,-105,5,168,173,-2,135,6.0179257362,12.740076825,-6.722151088,0.3201024328,10.755441741,11.075544174
2024,Indiana,Carroll County,20525,11,193,233,-40,12,40,52,-1,103,9.4056872731,11.355052511,-1.949365238,0.5848095714,1.9493652379,2.5341748093
2024,Indiana,Cass County,37666,129,474,464,10,128,-6,122,-3,715,12.605880085,12.339933247,0.2659468372,3.4041195165,-0.159568102,3.2445514142
2024,Indiana,Clark County,125467,1245,1309,1413,-104,112,1230,1342,7,1670,10.485043394,11.318079691,-0.833036297,0.8971160123,9.8522562067,10.749372219
2024,Indiana,Clay County,26460,50,302,343,-41,4,88,92,-1,344,11.424248156,12.975222243,-1.550974087,0.1513145451,3.3289199924,3.4802345375
2024,Indiana,Clinton County,32730,-39,395,416,-21,14,-33,-19,1,625,12.061252844,12.702484007,-0.641231164,0.4274874426,-1.007648972,-0.580161529
2024,Indiana,Crawford County,10438,-79,97,161,-64,-1,-13,-14,-1,69,9.2579336674,15.366261036,-6.108327368,-0.095442615,-1.240753997,-1.336196612
2024,Indiana,Daviess County,33656,160,532,338,194,112,-151,-39,5,647,15.844650941,10.06671432,5.7779366214,3.3357159876,-4.497259948,-1.16154396
2024,Indiana,Dearborn County,51215,315,380,571,-191,12,498,510,-4,536,7.4425892376,11.183469618,-3.74088038,0.2350291338,9.7537090535,9.9887381873
2024,Indiana,Decatur County,26399,-55,309,334,-25,17,-45,-28,-2,499,11.692808355,12.638828449,-0.946020093,0.6432936636,-1.702836168,-1.059542505
2024,Indiana,DeKalb County,44198,385,544,474,70,11,305,316,-1,418,12.362091102,10.77138085,1.5907102521,0.2499687539,6.9309518128,7.1809205667
2024,Indiana,Delaware County,112321,158,1124,1425,-301,121,339,460,-1,7886,10.014076727,12.695782327,-2.6817056,1.0780278327,3.0202597958,4.0982876285
2024,Indiana,Dubois County,43546,54,498,497,1,51,2,53,0,711,11.443277649,11.42029918,0.0229784692,1.1719019279,0.0459569383,1.2178588662
2024,Indiana,Elkhart County,206409,-464,2878,1901,977,475,-1925,-1450,9,2427,13.927536162,9.199529619,4.7280065427,2.2986725771,-9.315673076,-7.017000498
2024,Indiana,Fayette County,23362,-27,241,362,-121,12,82,94,0,348,10.309939894,15.486299758,-5.176359864,0.513358003,3.5079463541,4.0213043571
2024,Indiana,Floyd County,80809,188,703,879,-176,86,277,363,1,1723,8.7096574367,10.890169114,-2.180511677,1.0654772967,3.4318280369,4.4973053336
2024,Indiana,Fountain County,16731,111,224,254,-30,7,136,143,-2,111,13.432880573,15.231927079,-1.799046505,0.4197775179,8.1556774909,8.5754550088
2024,Indiana,Franklin County,23096,13,198,256,-58,19,55,74,-3,155,8.5753264471,11.08729076,-2.511964313,0.8228848611,2.3820351242,3.2049199853
2024,Indiana,Fulton County,20358,-10,234,283,-49,14,25,39,0,138,11.491430536,13.897755733,-2.406325198,0.687521485,1.2277169376,1.9152384226
2024,Indiana,Gibson County,32904,-98,373,385,-12,19,-106,-87,1,604,11.319151519,11.683306527,-0.364155009,0.5765787637,-3.216702576,-2.640123813
2024,Indiana,Grant County,66200,207,745,1038,-293,114,386,500,0,4732,11.271398637,15.704311121,-4.432912484,1.7247509323,5.8399461394,7.5646970717
2024,Indiana,Greene County,31196,125,343,431,-88,33,180,213,0,301,11.017071643,13.843608974,-2.826537331,1.0599514992,5.7815536319,6.8415051311
2024,Indiana,Hamilton County,371645,6182,4009,2099,1910,1568,2719,4287,-15,2612,10.877646152,5.6952305497,5.1824156026,4.254464746,7.3774806406,11.631945387
2024,Indiana,Hancock County,86166,3049,872,851,21,62,2977,3039,-11,834,10.302274889,10.054169645,0.2481052439,0.7325011962,35.171871954,35.90437315
2024,Indiana,Harrison County,40006,216,382,497,-115,20,313,333,-2,474,9.5744147576,12.45676475,-2.882349992,0.5012782596,7.8450047621,8.3462830217
2024,Indiana,Hendricks County,186387,3268,1841,1337,504,419,2382,2801,-37,3723,9.964655513,7.2366889848,2.7279665283,2.2678928082,12.892889425,15.160782234
2024,Indiana,Henry County,48929,114,420,679,-259,1,374,375,-2,3719,8.5938778851,13.893435914,-5.299558029,0.020461614,7.6526436405,7.6731052545
2024,Indiana,Howard County,83831,285,947,1217,-270,58,501,559,-4,1164,11.315772179,14.542021903,-3.226249724,0.6930462369,5.9864855984,6.6795318353
2024,Indiana,Huntington County,36781,-19,412,492,-80,37,25,62,-1,1245,11.198543102,13.373017491,-2.174474389,1.0056944048,0.6795232465,1.6852176513
2024,Indiana,Jackson County,46460,230,598,529,69,295,-135,160,1,754,12.903225806,11.41439206,1.4888337469,6.3653037005,-2.912935592,3.4523681087
2024,Indiana,Jasper County,33535,190,384,412,-28,4,215,219,-1,190,11.483253589,12.320574163,-0.837320574,0.1196172249,6.4294258373,6.5490430622
2024,Indiana,Jay County,20032,-86,279,295,-16,9,-80,-71,1,253,13.897882939,14.694894147,-0.797011208,0.4483188045,-3.98505604,-3.536737235
2024,Indiana,Jefferson County,33056,120,347,417,-70,33,157,190,0,2350,10.516426233,12.637895502,-2.121469269,1.0001212268,4.7581525033,5.7582737301
2024,Indiana,Jennings County,27622,138,291,344,-53,1,189,190,1,293,10.561463362,12.485028853,-1.923565492,0.0362936885,6.8595071317,6.8958008202
2024,Indiana,Johnson County,167819,2133,1886,1560,326,206,1606,1812,-5,2977,11.31017526,9.3551820812,1.9549931785,1.2353637876,9.6310400144,10.866403802
2024,Indiana,Knox County,36070,194,411,471,-60,84,171,255,-1,1668,11.425235593,13.093153198,-1.667917605,2.3350846468,4.7535651739,7.0886498207
2024,Indiana,Kosciusko County,80364,-200,903,850,53,133,-390,-257,4,1531,11.222410022,10.563730364,0.658679658,1.652913104,-4.846888049,-3.193974945
2024,Indiana,LaGrange County,40907,53,668,305,363,23,-337,-314,4,168,16.340308949,7.4607698047,8.8795391446,0.5626154279,-8.243539096,-7.680923668
2024,Indiana,Lake County,500598,941,5653,5407,246,708,-19,689,6,4316,11.303117705,10.811243133,0.491874572,1.4156390121,-0.037990312,1.3776486996
2024,Indiana,LaPorte County,111706,-116,1180,1274,-94,35,-61,-26,4,6366,10.557961419,11.399019362,-0.841057944,0.3131598726,-0.545792921,-0.232633048
2024,Indiana,Lawrence County,45084,-147,502,674,-172,14,13,27,-2,598,11.11664729,14.925538393,-3.808891103,0.31002602,0.2878813043,0.5979073244
2024,Indiana,Madison County,132504,1121,1402,1757,-355,37,1437,1474,2,5766,10.625760269,13.316305843,-2.690545574,0.2804230599,10.891025325,11.171448385
2024,Indiana,Marion County,968460,-763,13736,9122,4614,6055,-11403,-5348,-29,16590,14.177757662,9.4153687677,4.7623888944,6.2497322834,-11.76972704,-5.519994757
2024,Indiana,Marshall County,46352,-26,567,519,48,34,-108,-74,0,672,12.229052087,11.193788418,1.0352636687,0.7333117653,-2.329343255,-1.596031489
2024,Indiana,Martin County,9897,70,144,127,17,-1,56,55,-2,156,14.60150071,12.877712432,1.7237882782,-0.10139931,5.6783613871,5.5769620767
2024,Indiana,Miami County,35402,-144,340,496,-156,9,3,12,0,3360,9.5844844111,13.982071376,-4.397586965,0.2537069403,0.0845689801,0.3382759204
2024,Indiana,Monroe County,139342,-279,1146,1082,64,913,-1273,-360,17,12239,8.2161433595,7.7573011475,0.458842212,6.5456709313,-9.126658374,-2.580987443
2024,Indiana,Montgomery County,38573,254,445,461,-16,20,249,269,1,1065,11.574676169,11.990844301,-0.416168132,0.5202101649,6.4766165531,6.996826718
2024,Indiana,Morgan County,73227,967,797,824,-27,21,977,998,-4,665,10.956305374,11.327472558,-0.371167183,0.288685587,13.430753263,13.71943885
2024,Indiana,Newton County,13960,121,152,219,-67,25,164,189,-1,141,10.935645167,15.755962445,-4.820317278,1.7986258499,11.798985575,13.597611425
2024,Indiana,Noble County,47430,196,603,528,75,60,60,120,1,686,12.739795487,11.15524381,1.5845516775,1.267641342,1.267641342,2.535282684
2024,Indiana,Ohio County,6004,-93,47,89,-42,2,-54,-52,1,38,7.7679530617,14.709528138,-6.941575076,0.3305511941,-8.924882241,-8.594331047
2024,Indiana,Orange County,19638,37,213,304,-91,2,129,131,-3,262,10.856545784,15.494788348,-4.638242565,0.101939397,6.5750911083,6.6770305054
2024,Indiana,Owen County,21532,45,55,305,-250,5,293,298,-3,224,2.5570096934,14.179781027,-11.62277133,0.2324554267,13.621888003,13.85434343
2024,Indiana,Parke County,16484,117,209,192,17,1,101,102,-2,1000,12.724117987,11.689141883,1.0349761042,0.0608809473,6.1489756781,6.2098566254
2024,Indiana,Perry County,19209,2,164,239,-75,25,53,78,-1,1580,8.5381091212,12.442732195,-3.904623074,1.3015410246,2.7592669721,4.0608079967
2024,Indiana,Pike County,12106,-37,130,185,-55,-3,22,19,-1,174,10.722091633,15.25836117,-4.536269537,-0.247432884,1.8145078148,1.5670749309
2024,Indiana,Porter County,175335,487,1693,1729,-36,182,347,529,-6,3323,9.6692300883,9.874836871,-0.205606783,1.0394565127,1.9818209336,3.0212774464
2024,Indiana,Posey County,25040,-58,205,245,-40,2,-21,-19,1,205,8.1774302924,9.773026447,-1.595596155,0.0797798077,-0.837687981,-0.757908173
2024,Indiana,Pulaski County,12385,-64,123,207,-84,14,5,19,1,158,9.9057743416,16.670693404,-6.764919063,1.1274865104,0.4026737537,1.5301602642
2024,Indiana,Putnam County,37567,273,350,414,-64,46,291,337,0,4140,9.3506632292,11.060498791,-1.709835562,1.2289443101,7.7744085706,9.0033528807
2024,Indiana,Randolph County,24216,-134,286,401,-115,21,-40,-19,0,252,11.777786929,16.513610345,-4.735823416,0.8648025368,-1.647242927,-0.78244039
2024,Indiana,Ripley County,29227,197,334,404,-70,9,262,271,-4,531,11.466433218,13.869577905,-2.403144686,0.3089757454,8.9946272551,9.3036030005
2024,Indiana,Rush County,16847,175,200,220,-20,11,186,197,-2,124,11.933530237,13.12688326,-1.193353024,0.656344163,11.09818312,11.754527283
2024,Indiana,St. Joseph County,272848,566,3286,2826,460,763,-671,92,14,12627,12.055839891,10.368169061,1.6876708308,2.7993322694,-2.461798103,0.3375341662
2024,Indiana,Scott County,24657,157,279,425,-146,4,298,302,1,379,11.35138434,17.291535285,-5.940150945,0.1627438615,12.124417682,12.287161544
2024,Indiana,Shelby County,45231,42,479,510,-31,86,-14,72,1,734,10.595001106,11.280690113,-0.685689007,1.902234019,-0.309666003,1.5925680159
2024,Indiana,Spencer County,19910,61,187,270,-83,9,137,146,-2,305,9.4066752182,13.581830529,-4.175155311,0.4527276843,6.8915214165,7.3442491008
2024,Indiana,Starke County,23206,3,236,363,-127,15,115,130,0,100,10.170441078,15.643517421,-5.473076343,0.6464263397,4.9559352712,5.6023616109
2024,Indiana,Steuben County,34917,145,356,375,-19,20,145,165,-1,1730,10.216820445,10.762100188,-0.545279743,0.5739786767,4.161345406,4.7353240827
2024,Indiana,Sullivan County,20757,86,212,270,-58,7,140,147,-3,2211,10.234623926,13.034662547,-2.800038621,0.3379356957,6.7587139133,7.096649609
2024,Indiana,Switzerland County,10019,10,111,118,-7,0,17,17,0,100,11.084481726,11.783503096,-0.69902137,0.0,1.6976233273,1.6976233273
2024,Indiana,Tippecanoe County,188792,555,2028,1367,661,1925,-2049,-124,18,15916,10.757793167,7.2514315875,3.5063615796,10.211416098,-10.86919043,-0.657774336
2024,Indiana,Tipton County,15256,-69,148,223,-75,6,0,6,0,198,9.679212583,14.584218959,-4.905006377,0.3924005101,0.0,0.3924005101
2024,Indiana,Union County,6973,6,62,90,-28,1,33,34,0,35,8.8952654232,12.912482066,-4.017216643,0.143472023,4.7345767575,4.8780487805
2024,Indiana,Vanderburgh County,179810,247,2159,2108,51,196,-3,193,3,6742,12.015371216,11.731543549,0.2838276665,1.0907886792,-0.016695745,1.0740929341
2024,Indiana,Vermillion County,15417,-16,171,227,-56,4,35,39,1,188,11.085899514,14.71636953,-3.630470016,0.2593192869,2.2690437601,2.528363047
2024,Indiana,Vigo County,106153,71,1167,1226,-59,161,-34,127,3,8907,10.997243621,11.553231088,-0.555987467,1.517186138,-0.320399557,1.1967865809
2024,Indiana,Wabash County,30670,-172,313,504,-191,11,8,19,0,1198,10.176876057,16.38704643,-6.210170373,0.3576537911,0.2601118481,0.6177656392
2024,Indiana,Warren County,8518,30,87,95,-8,4,35,39,-1,79,10.231682935,11.172527343,-0.940844408,0.4704222039,4.1161942844,4.5866164883
2024,Indiana,Warrick County,65867,636,584,673,-89,73,659,732,-7,937,8.9093655128,10.267128408,-1.357762895,1.1136706891,10.053547728,11.167218417
2024,Indiana,Washington County,28205,34,303,381,-78,12,100,112,0,337,10.749255002,13.516389953,-2.767134951,0.4257130694,3.5476089116,3.973321981
2024,Indiana,Wayne County,66127,-89,748,943,-195,83,23,106,0,2152,11.303960164,14.250848175,-2.946888011,1.2543164353,0.3475816628,1.6018980981
2024,Indiana,Wells County,28555,257,314,347,-33,24,266,290,0,464,11.046030992,12.2069196,-1.160888607,0.8442826236,9.357465745,10.201748369
2024,Indiana,White County,24917,257,423,311,112,85,60,145,0,224,17.064364524,12.546140347,4.5182241765,3.4290094197,2.4204772374,5.8494866571
2024,Indiana,Whitley County,34742,165,377,363,14,6,146,152,-1,335,10.877248662,10.473319003,0.4039296585,0.1731127108,4.2124092962,4.385522007
2024,Iowa,Iowa,3207004,7311,36898,33119,3779,7112,-3603,3509,23,97595,11.518571894,10.338868843,1.1797030514,2.2201767931,-1.124760544,1.0954162496
2024,Iowa,Adair County,7389,-68,85,120,-35,4,-37,-33,0,162,11.450895864,16.165970632,-4.715074768,0.5388656877,-4.984507611,-4.445641924
2024,Iowa,Adams County,3544,-57,39,56,-17,1,-40,-39,-1,71,10.916724983,15.675297411,-4.758572428,0.2799160252,-11.19664101,-10.91672498
2024,Iowa,Allamakee County,14074,56,177,155,22,61,-27,34,0,200,12.601452371,11.035170155,1.5662822156,4.3428734159,-1.922255446,2.4206179695
2024,Iowa,Appanoose County,12119,-22,126,190,-64,3,41,44,-2,239,10.387469085,15.663643858,-5.276174773,0.2473206925,3.3800494641,3.6273701566
2024,Iowa,Audubon County,5534,-41,61,83,-22,7,-25,-18,-1,98,10.982086596,14.942839139,-3.960752543,1.2602394455,-4.500855162,-3.240615717
2024,Iowa,Benton County,25796,54,263,247,16,13,26,39,-1,331,10.206061547,9.5851604641,0.6209010827,0.5044821297,1.0089642594,1.5134463891
2024,Iowa,Black Hawk County,130471,419,1629,1352,277,370,-226,144,-2,4366,12.505613708,10.379121997,2.1264917109,2.8404401915,-1.734971576,1.1054686151
2024,Iowa,Boone County,26590,11,281,350,-69,-1,83,82,-2,755,10.570069025,13.165566401,-2.595497376,-0.037615904,3.1221200323,3.0845041283
2024,Iowa,Bremer County,25307,53,250,256,-6,24,37,61,-2,1573,9.889044916,10.126381994,-0.237337078,0.9493483119,1.4635786476,2.4129269595
2024,Iowa,Buchanan County,20691,2,254,223,31,29,-59,-30,1,110,12.276462059,10.778153697,1.4983083615,1.4016433059,-2.85161914,-1.449975834
2024,Iowa,Buena Vista County,20567,-77,304,181,123,122,-323,-201,1,792,14.753342554,8.7840625076,5.9692800466,5.9207493145,-15.67542646,-9.754677149
2024,Iowa,Butler County,14172,-74,152,192,-40,9,-42,-33,-1,222,10.697445281,13.51256246,-2.815117179,0.6334013653,-2.955873038,-2.322471673
2024,Iowa,Calhoun County,9763,38,94,141,-47,2,86,88,-3,694,9.6469622332,14.47044335,-4.823481117,0.2052545156,8.8259441708,9.0311986864
2024,Iowa,Carroll County,20522,-19,250,286,-36,26,-9,17,0,472,12.176411855,13.929815162,-1.753403307,1.2663468329,-0.438350827,0.8279960061
2024,Iowa,Cass County,13130,-7,129,200,-71,0,66,66,-2,191,9.822210378,15.228233144,-5.406022766,0.0,5.0253169376,5.0253169376
2024,Iowa,Cedar County,18302,-51,160,227,-67,10,5,15,1,264,8.7300504706,12.385759105,-3.655708635,0.5456281544,0.2728140772,0.8184422316
2024,Iowa,Cerro Gordo County,42406,-20,449,546,-97,30,47,77,0,1010,10.585628065,12.872500943,-2.286872878,0.7072802716,1.1080724255,1.8153526971
2024,Iowa,Cherokee County,11605,115,125,174,-49,-1,167,166,-2,407,10.824853864,15.068196579,-4.243342715,-0.086598831,14.462004763,14.375405932
2024,Iowa,Chickasaw County,11658,-70,132,147,-15,36,-92,-56,1,208,11.288805268,12.571624049,-1.28281878,3.0787650731,-7.867955187,-4.789190114
2024,Iowa,Clarke County,9588,-55,127,154,-27,12,-41,-29,1,153,13.207841506,16.01580781,-2.807966304,1.2479850242,-4.263948833,-3.015963808
2024,Iowa,Clay County,16511,4,165,190,-25,2,27,29,0,267,9.9945484281,11.508873948,-1.514325519,0.1211460416,1.635471561,1.7566176025
2024,Iowa,Clayton County,16969,-88,168,222,-54,15,-49,-34,0,298,9.8748016223,13.048845001,-3.174043379,0.8816787163,-2.880150473,-1.998471757
2024,Iowa,Clinton County,46158,-97,549,618,-69,5,-32,-27,-1,636,11.881445251,13.374741649,-1.493296398,0.1082098839,-0.692543257,-0.584333373
2024,Iowa,Crawford County,16013,-116,228,161,67,40,-223,-183,0,485,14.187044988,10.018044926,4.1690000622,2.488955261,-13.87592558,-11.38697032
2024,Iowa,Dallas County,111092,2946,1413,599,814,218,1908,2126,6,715,12.890101169,5.4643811748,7.4257199938,1.9887063374,17.405741705,19.394448043
2024,Iowa,Davis County,9169,22,154,88,66,32,-76,-44,0,81,16.815898668,9.609084953,7.2068137148,3.4942127102,-8.298755187,-4.804542477
2024,Iowa,Decatur County,7665,-30,86,98,-12,9,-26,-17,-1,480,11.197916667,12.760416667,-1.5625,1.171875,-3.385416667,-2.213541667
2024,Iowa,Delaware County,17600,-7,201,186,15,3,-24,-21,-1,241,11.418183884,10.566080609,0.8521032749,0.170420655,-1.36336524,-1.192944585
2024,Iowa,Des Moines County,38253,11,415,509,-94,41,64,105,0,531,10.850382378,13.30805935,-2.457676972,1.0719654879,1.6733119812,2.7452774691
2024,Iowa,Dickinson County,18056,8,154,208,-54,7,56,63,-1,319,8.5309107024,11.522269001,-2.991358298,0.3877686683,3.1021493463,3.4899180146
2024,Iowa,Dubuque County,98887,172,1115,1018,97,105,-31,74,1,4226,11.285310877,10.303539438,0.9817714396,1.0627422799,-0.313762006,0.7489802735
2024,Iowa,Emmet County,9229,15,95,124,-29,-4,49,45,-1,376,10.302011603,13.446836198,-3.144824595,-0.43376891,5.3136691428,4.8799002332
2024,Iowa,Fayette County,19210,-56,205,262,-57,13,-11,2,-1,872,10.655993347,13.618879301,-2.962885955,0.6757459195,-0.571785009,0.1039609107
2024,Iowa,Floyd County,15326,-22,164,204,-40,4,15,19,-1,215,10.693095129,13.301167112,-2.608071983,0.2608071983,0.9780269935,1.2388341918
2024,Iowa,Franklin County,9875,-71,130,122,8,13,-92,-79,0,166,13.117400737,12.310176076,0.8072246607,1.3117400737,-9.283083598,-7.971343525
2024,Iowa,Fremont County,6458,-17,67,95,-28,1,9,10,1,98,10.361091781,14.691100286,-4.330008505,0.1546431609,1.3917884482,1.5464316091
2024,Iowa,Greene County,8584,-126,89,129,-40,1,-86,-85,-1,109,10.292587024,14.918468833,-4.625881809,0.1156470452,-9.945645889,-9.829998844
2024,Iowa,Grundy County,12384,29,141,149,-8,6,32,38,-1,154,11.399005619,12.04575771,-0.646752092,0.4850640689,2.5870083674,3.0720724362
2024,Iowa,Guthrie County,10722,41,95,133,-38,11,70,81,-2,96,8.8772601972,12.428164276,-3.550904079,1.027893286,6.5411390927,7.5690323786
2024,Iowa,Hamilton County,14729,-74,181,194,-13,15,-77,-62,1,245,12.257889747,13.138290668,-0.880400921,1.0158472166,-5.214682378,-4.198835162
2024,Iowa,Hancock County,10615,-36,120,149,-29,15,-22,-7,0,192,11.285620239,14.012978463,-2.727358224,1.4107025299,-2.069030377,-0.658327847
2024,Iowa,Hardin County,16463,-151,154,252,-98,76,-130,-54,1,715,9.3116062521,15.237173867,-5.925567615,4.5953381504,-7.860446836,-3.265108686
2024,Iowa,Harrison County,14670,-10,157,185,-28,1,17,18,0,260,10.69846678,12.606473595,-1.908006814,0.0681431005,1.1584327087,1.2265758092
2024,Iowa,Henry County,19547,-706,194,243,-49,4,-667,-663,6,1516,9.7487437186,12.211055276,-2.462311558,0.2010050251,-33.51758794,-33.31658291
2024,Iowa,Howard County,9376,-133,127,131,-4,6,-133,-127,-2,113,13.449827906,13.873444533,-0.423616627,0.6354249404,-14.08525285,-13.44982791
2024,Iowa,Humboldt County,9500,-21,124,120,4,22,-47,-25,0,82,13.038220914,12.617633142,0.4205877714,2.3132327428,-4.941906314,-2.628673571
2024,Iowa,Ida County,6833,-72,79,97,-18,3,-56,-53,-1,168,11.50094628,14.121415053,-2.620468773,0.4367447955,-8.152569515,-7.71582472
2024,Iowa,Iowa County,16381,-116,185,210,-25,-2,-90,-92,1,349,11.253725896,12.774499665,-1.52077377,-0.121661902,-5.474785571,-5.596447472
2024,Iowa,Jackson County,19342,-4,208,237,-29,13,13,26,-1,187,10.752688172,12.251861042,-1.49917287,0.6720430108,0.6720430108,1.3440860215
2024,Iowa,Jasper County,37919,-30,383,424,-41,47,-36,11,0,1922,10.096483366,11.177307956,-1.08082459,1.2389940423,-0.949016713,0.289977329
2024,Iowa,Jefferson County,15440,-228,144,189,-45,128,-311,-183,0,797,9.258068664,12.151215122,-2.893146458,8.229394368,-19.99485663,-11.76546226
2024,Iowa,Johnson County,157528,613,1690,877,813,729,-934,-205,5,10189,10.749165986,5.5781174967,5.1710484889,4.6367704163,-5.940663332,-1.303892915
2024,Iowa,Jones County,20900,-49,192,227,-35,0,-14,-14,0,1622,9.1758464957,10.848526847,-1.672680351,0.0,-0.66907214,-0.66907214
2024,Iowa,Keokuk County,9914,31,109,138,-29,7,53,60,0,117,11.01176946,13.941506289,-2.929736829,0.7071778552,5.3543466182,6.0615244734
2024,Iowa,Kossuth County,14396,-69,164,194,-30,8,-48,-40,1,309,11.364817574,13.443747618,-2.078930044,0.5543813451,-3.32628807,-2.771906725
2024,Iowa,Lee County,32565,-264,338,485,-147,-5,-114,-119,2,1151,10.337339817,14.833165122,-4.495825305,-0.152919228,-3.4865584,-3.639477628
2024,Iowa,Linn County,228972,32,2621,2063,558,484,-1020,-536,10,5476,11.447614389,9.0104648928,2.437149496,2.1139432904,-4.455004455,-2.341061165
2024,Iowa,Louisa County,10513,-104,113,120,-7,52,-149,-97,0,96,10.695693327,11.3582584,-0.662565073,4.9219119735,-14.10317085,-9.181258874
2024,Iowa,Lucas County,8747,45,115,124,-9,4,50,54,0,63,13.181271133,14.212848874,-1.031577741,0.4584789959,5.7309874491,6.1894664451
2024,Iowa,Lyon County,12324,147,158,96,62,23,63,86,-1,179,12.897432758,7.8364148402,5.0610179176,1.8774743888,5.1426472389,7.0201216277
2024,Iowa,Madison County,16971,-69,194,169,25,1,-96,-95,1,63,11.408073858,9.9379612478,1.4701126106,0.0588045044,-5.645232425,-5.58642792
2024,Iowa,Mahaska County,21874,-97,232,266,-34,18,-82,-64,1,788,10.582734633,12.13365264,-1.550918007,0.8210742388,-3.74044931,-2.919375071
2024,Iowa,Marion County,33770,140,357,374,-17,3,157,160,-3,1440,10.59347181,11.097922849,-0.504451039,0.0890207715,4.6587537092,4.7477744807
2024,Iowa,Marshall County,40014,193,479,537,-58,283,-33,250,1,1058,11.999749483,13.452746289,-1.452996806,7.0896223461,-0.826705079,6.2629172669
2024,Iowa,Mills County,14633,98,123,160,-37,13,124,137,-2,287,8.4339001646,10.970927043,-2.537026879,0.8913878223,8.5024684586,9.3938562809
2024,Iowa,Mitchell County,10518,-26,127,146,-19,29,-36,-7,0,252,12.059633463,13.863830595,-1.804197132,2.7537745703,-3.418478777,-0.664704207
2024,Iowa,Monona County,8493,-13,92,150,-58,6,40,46,-1,152,10.824166127,17.648096947,-6.823930819,0.7059238779,4.7061591858,5.4120830637
2024,Iowa,Monroe County,7504,-26,83,111,-28,0,2,2,0,92,11.041638952,14.7665292,-3.724890249,0.0,0.2660635892,0.2660635892
2024,Iowa,Montgomery County,10139,-71,98,157,-59,2,-13,-11,-1,201,9.6319229446,15.430733697,-5.798810752,0.196569856,-1.277704064,-1.081134208
2024,Iowa,Muscatine County,42218,-177,467,468,-1,106,-281,-175,-1,719,11.038492903,11.062129933,-0.02363703,2.5055251557,-6.642005366,-4.13648021
2024,Iowa,O'Brien County,14012,-73,185,183,2,42,-116,-74,-1,456,13.168665694,13.02630174,0.1423639534,2.9896430224,-8.2571093,-5.267466278
2024,Iowa,Osceola County,5978,-94,60,84,-24,12,-80,-68,-2,107,9.9585062241,13.941908714,-3.98340249,1.9917012448,-13.2780083,-11.28630705
2024,Iowa,Page County,15014,-162,136,215,-79,5,-88,-83,0,1287,9.0096058297,14.243126863,-5.233521033,0.3312355084,-5.829744949,-5.49850944
2024,Iowa,Palo Alto County,8810,20,113,134,-21,0,41,41,0,343,12.840909091,15.227272727,-2.386363636,0.0,4.6590909091,4.6590909091
2024,Iowa,Plymouth County,25722,0,306,264,42,47,-89,-42,0,319,11.896431071,10.26358759,1.6328434803,1.8272296089,-3.460073089,-1.63284348
2024,Iowa,Pocahontas County,6976,-97,77,103,-26,27,-98,-71,0,113,10.96163428,14.662965336,-3.701331056,3.8436899423,-13.9511709,-10.10748096
2024,Iowa,Polk County,505255,4071,6560,4143,2417,1579,63,1642,12,8956,13.036060804,8.2329877916,4.8030730129,3.1377957333,0.1251938766,3.2629896099
2024,Iowa,Pottawattamie County,93179,114,946,1079,-133,203,42,245,2,2203,10.158716522,11.586950452,-1.42823393,2.1799359979,0.451021241,2.6309572389
2024,Iowa,Poweshiek County,18453,-65,190,234,-44,18,-38,-20,-1,1610,10.278326256,12.658570231,-2.380243975,0.9737361716,-2.055665251,-1.08192908
2024,Iowa,Ringgold County,4642,-46,43,81,-38,1,-9,-8,0,117,9.2175777063,17.363344051,-8.145766345,0.2143622722,-1.92926045,-1.714898178
2024,Iowa,Sac County,9686,-3,112,149,-37,2,32,34,0,156,11.561290323,15.380645161,-3.819354839,0.2064516129,3.3032258065,3.5096774194
2024,Iowa,Scott County,174270,519,1904,1722,182,302,35,337,0,3122,10.94186845,9.8959545545,1.045913896,1.7355274538,0.2011372877,1.9366647415
2024,Iowa,Shelby County,11806,95,113,152,-39,59,77,136,-2,193,9.6100693116,12.926818897,-3.316749585,5.0176468087,6.5484543096,11.566101118
2024,Iowa,Sioux County,36246,119,508,267,241,119,-245,-126,4,2434,14.03838448,7.3784422367,6.6599422437,3.2885191991,-6.770480704,-3.481961505
2024,Iowa,Story County,98566,309,840,625,215,468,-380,88,6,10563,8.5355878124,6.350883789,2.1847040234,4.7555417812,-3.861337344,0.8942044375
2024,Iowa,Tama County,16833,-110,203,213,-10,31,-133,-102,2,267,12.020369493,12.612505921,-0.592136428,1.8356229275,-7.875414495,-6.039791568
2024,Iowa,Taylor County,5924,49,75,86,-11,19,42,61,-1,69,12.712941775,14.577506568,-1.864564794,3.2206119163,7.1192473938,10.33985931
2024,Iowa,Union County,11906,3,104,170,-66,59,13,72,-3,340,8.7361921962,14.280314167,-5.544121971,4.9561090344,1.0920240245,6.0481330589
2024,Iowa,Van Buren County,7266,14,100,93,7,1,7,8,-1,83,13.776002204,12.81168205,0.9643201543,0.137760022,0.9643201543,1.1020801763
2024,Iowa,Wapello County,35166,85,453,471,-18,140,-35,105,-2,974,12.897347929,13.409825331,-0.512477401,3.9859353424,-0.996483836,2.9894515068
2024,Iowa,Warren County,55205,902,617,514,103,22,780,802,-3,1641,11.268583117,9.3874420134,1.8811411038,0.401797129,14.245534573,14.647331702
2024,Iowa,Washington County,22560,18,278,263,15,30,-27,3,0,342,12.327612966,11.662453993,0.665158973,1.330317946,-1.197286151,0.1330317946
2024,Iowa,Wayne County,6557,67,88,84,4,0,63,63,0,86,13.489691117,12.876523339,0.613167778,0.0,9.657392504,9.657392504
2024,Iowa,Webster County,36485,-167,409,476,-67,107,-210,-103,3,3090,11.184489383,13.01666735,-1.832177967,2.9260155598,-5.74264736,-2.816631801
2024,Iowa,Winnebago County,10571,-68,96,125,-29,5,-42,-37,-2,561,9.0523338048,11.786892975,-2.73455917,0.471475719,-3.96039604,-3.488920321
2024,Iowa,Winneshiek County,19815,-87,179,210,-31,7,-66,-59,3,1592,9.01377244,10.574816829,-1.561044389,0.3524938943,-3.323513861,-2.971019966
2024,Iowa,Woodbury County,105951,393,1426,1017,409,352,-375,-23,7,2859,13.48405978,9.6166120591,3.8674477209,3.3284635642,-3.545948399,-0.217484835
2024,Iowa,Worth County,7297,-14,79,93,-14,3,-4,-1,1,67,10.815991238,12.732749179,-1.916757941,0.4107338445,-0.547645126,-0.136911281
2024,Iowa,Wright County,12656,-39,169,181,-12,82,-110,-28,1,162,13.332807384,14.279515601,-0.946708217,6.4691728137,-8.678158653,-2.208985839
2024,Kansas,Kansas,2940546,3830,34768,30329,4439,3932,-4574,-642,33,87026,11.831359568,10.320792233,1.5105673356,1.3380380184,-1.556507095,-0.218469076
2024,Kansas,Allen County,12412,-77,124,196,-72,2,-6,-4,-1,385,9.9594393799,15.742339665,-5.782900285,0.160636119,-0.481908357,-0.321272238
2024,Kansas,Anderson County,7838,40,102,104,-2,0,43,43,-1,88,13.046815042,13.302634945,-0.255819903,0.0,5.50012791,5.50012791
2024,Kansas,Atchison County,16016,-37,172,218,-46,1,7,8,1,1694,10.726870186,13.595684306,-2.86881412,0.0623655243,0.4365586704,0.4989241947
2024,Kansas,Barber County,4071,-53,40,67,-27,0,-26,-26,0,41,9.7620500305,16.351433801,-6.589383771,0.0,-6.34533252,-6.34533252
2024,Kansas,Barton County,24899,-159,314,351,-37,12,-135,-123,1,537,12.570810897,14.052084793,-1.481273896,0.4804131553,-5.404647997,-4.924234842
2024,Kansas,Bourbon County,14408,-35,193,210,-17,-1,-17,-18,0,386,13.379085647,14.557554331,-1.178468684,-0.069321687,-1.178468684,-1.247790371
2024,Kansas,Brown County,9250,-123,113,156,-43,0,-80,-80,0,120,12.135531332,16.753476883,-4.617945551,0.0,-8.591526607,-8.591526607
2024,Kansas,Butler County,68632,343,747,734,13,85,249,334,-4,2625,10.911401465,10.721510944,0.1898905208,1.2415918668,3.6371338217,4.8787256885
2024,Kansas,Chase County,2579,11,36,32,4,0,6,6,1,176,13.9887313,12.434427822,1.5543034778,0.0,2.3314552166,2.3314552166
2024,Kansas,Chautauqua County,3347,-40,23,65,-42,0,1,1,1,83,6.831006831,19.305019305,-12.47401247,0.0,0.297000297,0.297000297
2024,Kansas,Cherokee County,19054,29,166,301,-135,-2,169,167,-3,166,8.7187163528,15.809238688,-7.090522335,-0.105044775,8.8762835158,8.7712387405
2024,Kansas,Cheyenne County,2636,18,40,39,1,-1,19,18,-1,29,15.2264941,14.845831747,0.3806623525,-0.380662352,7.2325846974,6.8519223449
2024,Kansas,Clark County,1847,-92,21,32,-11,0,-79,-79,-2,32,11.093502377,16.904384575,-5.810882198,0.0,-41.73269942,-41.73269942
2024,Kansas,Clay County,8007,-34,81,112,-31,0,-3,-3,0,199,10.094715852,13.958125623,-3.863409771,0.0,-0.373878365,-0.373878365
2024,Kansas,Cloud County,8854,-80,110,156,-46,8,-42,-34,0,551,12.367888464,17.539914549,-5.172026085,0.8994827974,-4.722284686,-3.822801889
2024,Kansas,Coffey County,8251,-1,71,108,-37,8,28,36,0,110,8.6044961522,13.088529358,-4.484033206,0.9695206932,3.3933224262,4.3628431194
2024,Kansas,Comanche County,1655,-35,17,31,-14,0,-20,-20,-1,42,10.164424514,18.535127055,-8.370702541,0.0,-11.95814649,-11.95814649
2024,Kansas,Cowley County,34157,-266,414,493,-79,11,-201,-190,3,1950,12.073490814,14.377369495,-2.303878682,0.3207932342,-5.861767279,-5.540974045
2024,Kansas,Crawford County,38764,-381,449,495,-46,20,-358,-338,3,1480,11.526267825,12.70713268,-1.180864855,0.5134195022,-9.19020909,-8.676789588
2024,Kansas,Decatur County,2712,23,27,58,-31,1,55,56,-2,44,9.998148491,21.477504166,-11.47935567,0.370301796,20.366598778,20.736900574
2024,Kansas,Dickinson County,18445,90,190,278,-88,0,180,180,-2,252,10.326086957,15.108695652,-4.782608696,0.0,9.7826086957,9.7826086957
2024,Kansas,Doniphan County,7493,18,74,109,-35,6,46,52,1,385,9.8877605559,14.564404062,-4.676643506,0.8017103153,6.1464457509,6.9481560663
2024,Kansas,Douglas County,120553,546,1069,796,273,322,-55,267,6,8534,8.8875956102,6.6178915863,2.2697040239,2.6770867975,-0.457266378,2.219820419
2024,Kansas,Edwards County,2733,-27,29,59,-30,6,-5,1,2,35,10.558893137,21.481886037,-10.9229929,2.18459858,-1.820498817,0.3640997633
2024,Kansas,Elk County,2467,19,19,50,-31,0,50,50,0,4,7.7314343845,20.345879959,-12.61444557,0.0,20.345879959,20.345879959
2024,Kansas,Ellis County,28810,-30,269,228,41,11,-84,-73,2,1836,9.3321769297,7.9098005204,1.4223764094,0.381613183,-2.914137034,-2.532523851
2024,Kansas,Ellsworth County,6357,-26,56,84,-28,0,2,2,0,1166,8.7912087912,13.186813187,-4.395604396,0.0,0.3139717425,0.3139717425
2024,Kansas,Finney County,37466,-173,560,320,240,113,-528,-415,2,559,14.912455895,8.5214033686,6.3910525265,3.0091205645,-14.06031556,-11.05119499
2024,Kansas,Ford County,33980,56,602,276,326,70,-346,-276,6,668,17.730914232,8.1291234684,9.6017907634,2.061734213,-10.19085768,-8.129123468
2024,Kansas,Franklin County,26125,166,283,330,-47,4,209,213,0,525,10.867060902,12.6718378,-1.804776899,0.1535980339,8.0254972736,8.1790953076
2024,Kansas,Geary County,35047,-482,946,271,675,104,-1252,-1148,-9,906,26.80798005,7.6796644752,19.128315575,2.9471775108,-35.47948311,-32.5323056
2024,Kansas,Gove County,2735,-7,34,42,-8,1,0,1,0,44,12.415555961,15.336863246,-2.921307285,0.3651634106,0.0,0.3651634106
2024,Kansas,Graham County,2376,-21,28,41,-13,0,-8,-8,0,34,11.732662895,17.179970668,-5.447307773,0.0,-3.352189399,-3.352189399
2024,Kansas,Grant County,7147,-103,116,61,55,15,-174,-159,1,55,16.114468292,8.4739876363,7.6404806557,2.0837674516,-24.17170244,-22.08793499
2024,Kansas,Gray County,5743,32,84,64,20,6,7,13,-1,82,14.667365113,11.175135324,3.4922297887,1.0476689366,1.2222804261,2.2699493627
2024,Kansas,Greeley County,1181,-51,17,26,-9,0,-41,-41,-1,24,14.09034397,21.549937837,-7.459593867,0.0,-33.98259428,-33.98259428
2024,Kansas,Greenwood County,5870,-38,52,122,-70,3,30,33,-1,90,8.8300220751,20.716590253,-11.88656818,0.5094243505,5.0942435048,5.6036678553
2024,Kansas,Hamilton County,2437,-15,45,26,19,16,-48,-32,-2,0,18.40867253,10.636121906,7.7725506238,6.5453057885,-19.63591737,-13.09061158
2024,Kansas,Harper County,5435,35,80,79,1,-1,35,34,0,101,14.766958929,14.582371943,0.1845869866,-0.184586987,6.4605445316,6.275957545
2024,Kansas,Harvey County,33504,-167,348,500,-152,2,-17,-15,0,1128,10.360997395,14.88649051,-4.525493115,0.059545962,-0.506140677,-0.446594715
2024,Kansas,Haskell County,3630,35,59,35,24,2,11,13,-2,44,16.332179931,9.6885813149,6.6435986159,0.553633218,3.044982699,3.598615917
2024,Kansas,Hodgeman County,1655,-42,11,42,-31,1,-12,-11,0,18,6.5632458234,25.059665871,-18.49642005,0.5966587112,-7.159904535,-6.563245823
2024,Kansas,Jackson County,13368,76,184,156,28,17,31,48,0,193,13.803450863,11.702925731,2.1005251313,1.2753188297,2.3255813953,3.6009002251
2024,Kansas,Jefferson County,18327,-27,167,203,-36,1,7,8,1,179,9.1055314741,11.068400534,-1.96286906,0.0545241406,0.3816689839,0.4361931245
2024,Kansas,Jewell County,2847,-38,29,59,-30,1,-9,-8,0,15,10.11863224,20.586182833,-10.46755059,0.3489183531,-3.140265178,-2.791346825
2024,Kansas,Johnson County,622237,3146,6982,4443,2539,1030,-450,580,27,5717,11.249242746,7.1584625498,4.0907801967,1.6595130377,-0.725029968,0.9344830697
2024,Kansas,Kearny County,3823,-42,74,48,26,-1,-68,-69,1,69,19.250780437,12.486992716,6.7637877211,-0.260145682,-17.68990635,-17.95005203
2024,Kansas,Kingman County,7066,-108,77,260,-183,0,75,75,0,111,10.814606742,36.516853933,-25.70224719,0.0,10.533707865,10.533707865
2024,Kansas,Kiowa County,2374,-31,29,38,-9,7,-30,-23,1,166,12.136430216,15.902908558,-3.766478343,2.9294831555,-12.55492781,-9.625444654
2024,Kansas,Labette County,19728,26,207,290,-83,4,106,110,-1,415,10.499619579,14.709611971,-4.209992392,0.2028911996,5.3766167892,5.5795079888
2024,Kansas,Lane County,1529,-15,18,32,-14,0,-1,-1,0,16,11.714936544,20.826553856,-9.111617312,0.0,-0.650829808,-0.650829808
2024,Kansas,Leavenworth County,83518,596,896,747,149,41,411,452,-5,6060,10.766642634,8.9762076424,1.7904349916,0.4926700312,4.9387166547,5.4313866859
2024,Kansas,Lincoln County,2920,9,29,42,-13,0,24,24,-2,38,9.9468358772,14.405762305,-4.458926428,0.0,8.2318641742,8.2318641742
2024,Kansas,Linn County,9860,83,89,165,-76,1,159,160,-1,14,9.0645210572,16.805010949,-7.740489892,0.1018485512,16.193919641,16.295768193
2024,Kansas,Logan County,2665,-38,35,49,-14,1,-26,-25,1,22,13.04023845,18.25633383,-5.21609538,0.3725782414,-9.687034277,-9.314456036
2024,Kansas,Lyon County,32172,141,370,314,56,105,-20,85,0,1237,11.525941155,9.7814743859,1.7444667695,3.2708751927,-0.623023846,2.6478513465
2024,Kansas,McPherson County,30091,28,329,395,-66,5,91,96,-2,1925,10.93859095,13.132958739,-2.194367789,0.166239984,3.0255677095,3.1918076936
2024,Kansas,Marion County,11690,-93,115,213,-98,2,4,6,-1,622,9.7984918843,18.148511055,-8.350019171,0.1704085545,0.340817109,0.5112256635
2024,Kansas,Marshall County,9933,-59,97,133,-36,0,-23,-23,0,167,9.7365119197,13.350062735,-3.613550816,0.0,-2.308657465,-2.308657465
2024,Kansas,Meade County,3911,-2,49,59,-10,5,3,8,0,70,12.525562372,15.081799591,-2.556237219,1.2781186094,0.7668711656,2.0449897751
2024,Kansas,Miami County,35320,529,365,405,-40,11,559,570,-1,472,10.412060875,11.553108642,-1.141047767,0.313788136,15.946142545,16.259930681
2024,Kansas,Mitchell County,5719,-11,69,96,-27,0,17,17,-1,123,12.05345445,16.770023583,-4.716569133,0.0,2.9696916761,2.9696916761
2024,Kansas,Montgomery County,30568,-285,304,518,-214,9,-81,-72,1,762,9.8988945149,16.867195259,-6.968300744,0.2930593771,-2.637534394,-2.344475017
2024,Kansas,Morris County,5334,-66,53,71,-18,4,-52,-48,0,76,9.8751630334,13.228991988,-3.353828955,0.7452953233,-9.688839203,-8.943543879
2024,Kansas,Morton County,2580,-21,31,44,-13,5,-12,-7,-1,54,11.966801776,16.985138004,-5.018336229,1.9301293187,-4.632310365,-2.702181046
2024,Kansas,Nemaha County,10114,-50,130,120,10,1,-63,-62,2,259,12.821777296,11.835486734,0.9862905612,0.0986290561,-6.213630536,-6.115001479
2024,Kansas,Neosho County,15420,-163,188,239,-51,10,-122,-112,0,441,12.127858594,15.417862787,-3.290004193,0.6450988614,-7.870206109,-7.225107248
2024,Kansas,Ness County,2618,-39,33,53,-20,5,-25,-20,1,82,12.511848341,20.09478673,-7.582938389,1.8957345972,-9.478672986,-7.582938389
2024,Kansas,Norton County,5330,5,48,53,-5,4,5,9,1,954,9.0098545284,9.9483810418,-0.938526513,0.7508212107,0.9385265134,1.6893477241
2024,Kansas,Osage County,15824,119,163,232,-69,0,192,192,-4,150,10.339687272,14.716610105,-4.376922833,0.0,12.179263535,12.179263535
2024,Kansas,Osborne County,3427,-54,36,57,-21,0,-34,-34,1,95,10.422698321,16.502605675,-6.079907354,0.0,-9.843659525,-9.843659525
2024,Kansas,Ottawa County,5818,12,66,74,-8,0,21,21,-1,106,11.355815554,12.732278045,-1.376462491,0.0,3.6132140399,3.6132140399
2024,Kansas,Pawnee County,6126,-62,63,86,-23,0,-39,-39,0,748,10.232255969,13.967841481,-3.735585512,0.0,-6.334253695,-6.334253695
2024,Kansas,Phillips County,4761,-22,54,76,-22,1,-1,0,0,50,11.316010059,15.926236379,-4.61022632,0.2095557418,-0.209555742,0.0
2024,Kansas,Pottawatomie County,26382,90,375,217,158,13,-82,-69,1,330,14.23852375,8.2393590766,5.9991646733,0.4936021567,-3.113490527,-2.61988837
2024,Kansas,Pratt County,9082,9,115,128,-13,1,22,23,-1,497,12.668686312,14.100798678,-1.432112366,0.1101624897,2.4235747728,2.5337372625
2024,Kansas,Rawlins County,2463,-60,20,39,-19,0,-40,-40,-1,37,8.0224628961,15.643802647,-7.621339751,0.0,-16.04492579,-16.04492579
2024,Kansas,Reno County,61497,-55,662,777,-115,19,41,60,0,2816,10.759941162,12.629115231,-1.869174069,0.3088200636,0.6664011898,0.9752212533
2024,Kansas,Republic County,4627,-26,56,88,-32,1,5,6,0,57,12.068965517,18.965517241,-6.896551724,0.2155172414,1.0775862069,1.2931034483
2024,Kansas,Rice County,9260,-110,105,142,-37,7,-80,-73,0,489,11.272141707,15.244229737,-3.97208803,0.7514761138,-8.588298443,-7.83682233
2024,Kansas,Riley County,71402,-161,744,421,323,308,-800,-492,8,11287,10.408141853,5.8895533872,4.5185884657,4.3087468961,-11.19155038,-6.882803483
2024,Kansas,Rooks County,4778,-32,56,73,-17,1,-16,-15,0,190,11.681268252,15.227367543,-3.546099291,0.2085940759,-3.337505215,-3.128911139
2024,Kansas,Rush County,2830,-111,28,56,-28,1,-84,-83,0,73,9.7036908681,19.407381736,-9.703690868,0.3465603881,-29.1110726,-28.76451222
2024,Kansas,Russell County,6723,-10,67,83,-16,4,3,7,-1,92,9.9583828775,12.336504162,-2.378121284,0.594530321,0.4458977408,1.0404280618
2024,Kansas,Saline County,53098,-291,606,689,-83,63,-272,-209,1,1562,11.381671002,12.940546733,-1.558875731,1.183243025,-5.108604806,-3.925361781
2024,Kansas,Scott County,4922,-85,72,72,0,-4,-82,-86,1,75,14.502971095,14.502971095,0.0,-0.805720616,-16.51727264,-17.32299325
2024,Kansas,Sedgwick County,528469,3101,6615,5110,1505,682,889,1571,25,11138,12.554123645,9.6978944562,2.8562291891,1.294317812,1.6871679396,2.9814857516
2024,Kansas,Seward County,21067,-278,393,164,229,-3,-504,-507,0,342,18.532490804,7.7336602848,10.79883052,-0.141469395,-23.76685844,-23.90832783
2024,Kansas,Shawnee County,177746,209,1990,1994,-4,54,156,210,3,4603,11.202337292,11.224854553,-0.022517261,0.303983022,0.8781731746,1.1821561966
2024,Kansas,Sheridan County,2423,-16,28,41,-13,0,-2,-2,-1,37,11.517893871,16.865487454,-5.347593583,0.0,-0.822706705,-0.822706705
2024,Kansas,Sherman County,5844,-32,81,62,19,-4,-49,-53,2,252,13.822525597,10.580204778,3.2423208191,-0.682593857,-8.361774744,-9.044368601
2024,Kansas,Smith County,3590,18,42,52,-10,0,27,27,1,53,11.728567439,14.521083496,-2.792516057,0.0,7.5397933538,7.5397933538
2024,Kansas,Stafford County,3909,-62,44,81,-37,-2,-22,-24,-1,88,11.16751269,20.558375635,-9.390862944,-0.507614213,-5.583756345,-6.091370558
2024,Kansas,Stanton County,1901,-66,15,19,-4,-3,-58,-61,-1,26,7.7559462254,9.8241985522,-2.068252327,-1.551189245,-29.98965874,-31.54084798
2024,Kansas,Stevens County,5077,-89,65,55,10,-4,-96,-100,1,75,12.691594259,10.739041296,1.952552963,-0.781021185,-18.74450844,-19.52552963
2024,Kansas,Sumner County,22334,-25,220,309,-89,-3,69,66,-2,300,9.844942161,13.827668762,-3.982726601,-0.134249211,3.0877318596,2.9534826483
2024,Kansas,Thomas County,7865,-43,120,72,48,7,-98,-91,0,380,15.21587523,9.1295251379,6.0863500919,0.8875927217,-12.4262981,-11.53870538
2024,Kansas,Trego County,2731,-15,28,43,-15,2,-1,1,-1,35,10.224575498,15.702026657,-5.477451159,0.7303268213,-0.365163411,0.3651634106
2024,Kansas,Wabaunsee County,7057,48,88,89,-1,3,47,50,-1,188,12.512441348,12.654628181,-0.142186833,0.4265605005,6.6827811745,7.109341675
2024,Kansas,Wallace County,1509,16,28,19,9,0,7,7,0,24,18.654230513,12.658227848,5.9960026649,0.0,4.6635576282,4.6635576282
2024,Kansas,Washington County,5504,11,67,79,-12,2,21,23,0,103,12.185141402,14.367554788,-2.182413385,0.3637355642,3.8192234246,4.1829589888
2024,Kansas,Wichita County,2082,4,40,30,10,4,-11,-7,1,24,19.230769231,14.423076923,4.8076923077,1.9230769231,-5.288461538,-3.365384615
2024,Kansas,Wilson County,8382,-172,76,152,-76,0,-96,-96,0,154,8.9749645725,17.949929145,-8.974964573,0.0,-11.33679735,-11.33679735
2024,Kansas,Woodson County,3115,-2,25,54,-29,0,27,27,0,43,8.0231065469,17.329910141,-9.306803594,0.0,8.6649550706,8.6649550706
2024,Kansas,Wyandotte County,165281,-345,2287,1552,735,689,-1754,-1065,-15,3020,13.822614813,9.3802790512,4.442335762,4.1643120272,-10.60116589,-6.436853859
2024,Kentucky,Kentucky,4526154,14591,52380,54385,-2005,7627,8965,16592,4,121207,11.591422922,12.035119046,-0.443696124,1.6878156287,1.9839081042,3.6717237329
2024,Kentucky,Adair County,19264,167,197,265,-68,18,217,235,0,1158,10.270847997,13.816115325,-3.545267329,0.9384531164,11.313573682,12.252026798
2024,Kentucky,Allen County,21788,505,268,277,-9,-5,519,514,0,168,12.444568271,12.862482877,-0.417914606,-0.232174781,24.099742286,23.867567505
2024,Kentucky,Anderson County,24613,340,249,270,-21,7,353,360,1,91,10.186965593,11.04610727,-0.859141677,0.2863805589,14.441762468,14.728143027
2024,Kentucky,Ballard County,7582,-60,59,128,-69,-1,11,10,-1,114,7.7509196006,16.815554388,-9.064634787,-0.131371519,1.4450867052,1.3137151865
2024,Kentucky,Barren County,45008,136,548,594,-46,23,159,182,0,634,12.194036493,13.217623498,-1.023587005,0.5117935024,3.5380507343,4.0498442368
2024,Kentucky,Bath County,12975,147,175,213,-38,0,185,185,0,88,13.564314227,16.509708173,-2.945393946,0.0,14.339417897,14.339417897
2024,Kentucky,Bell County,23317,-294,289,459,-170,-2,-123,-125,1,734,12.316740539,19.561882032,-7.245141493,-0.085236959,-5.242072963,-5.327309922
2024,Kentucky,Boone County,140496,1451,1723,1075,648,375,428,803,0,1329,12.327350907,7.6911794692,4.6361714382,2.6829695823,3.0621626166,5.7451321989
2024,Kentucky,Bourbon County,20134,25,208,286,-78,20,83,103,0,97,10.337201501,14.213652064,-3.876450563,0.9939616828,4.1249409835,5.1189026663
2024,Kentucky,Boyd County,47826,-233,477,739,-262,4,24,28,1,2449,9.9494185743,15.414298378,-5.464879804,0.0834332794,0.5005996767,0.5840329561
2024,Kentucky,Boyle County,30988,137,311,385,-74,20,188,208,3,2978,10.058377399,12.451689064,-2.393311664,0.6468409903,6.0803053089,6.7271462993
2024,Kentucky,Bracken County,8426,-9,94,115,-21,5,8,13,-1,27,11.149991104,13.640946563,-2.490955459,0.5930846332,0.9489354131,1.5420200463
2024,Kentucky,Breathitt County,12953,-405,143,235,-92,1,-311,-310,-3,272,10.869978336,17.863251112,-6.993272776,0.0760138345,-23.64030254,-23.5642887
2024,Kentucky,Breckinridge County,21124,163,254,318,-64,2,224,226,1,294,12.070809077,15.112272781,-3.041463704,0.0950457408,10.645122965,10.740168706
2024,Kentucky,Bullitt County,84863,1089,771,810,-39,103,1029,1132,-4,136,9.1439008047,9.606432752,-0.462531947,1.2215587327,12.203727533,13.425286266
2024,Kentucky,Butler County,12375,10,151,166,-15,24,1,25,0,158,12.206952304,13.41956346,-1.212611156,1.9401778496,0.0808407437,2.0210185934
2024,Kentucky,Caldwell County,12551,-57,167,182,-15,-7,-36,-43,1,216,13.275567391,14.467983624,-1.192416233,-0.556460909,-2.861798959,-3.418259867
2024,Kentucky,Calloway County,38280,187,356,477,-121,47,261,308,0,3486,9.3226663873,12.491325468,-3.168659081,1.2308014612,6.8348761997,8.065677661
2024,Kentucky,Campbell County,93702,430,967,857,110,43,271,314,6,2627,10.343684149,9.1670499642,1.1766341844,0.4599569994,2.8987987635,3.3587557628
2024,Kentucky,Carlisle County,4704,-15,59,96,-37,1,21,22,0,50,12.522551204,20.375676536,-7.853125332,0.2122466306,4.4571792423,4.6694258729
2024,Kentucky,Carroll County,10987,48,162,150,12,0,37,37,-1,286,14.776977105,13.682386208,1.0945908967,0.0,3.374988598,3.374988598
2024,Kentucky,Carter County,26366,23,272,441,-169,0,194,194,-2,663,10.320818077,16.73338519,-6.412567114,0.0,7.3611717164,7.3611717164
2024,Kentucky,Casey County,15918,7,180,236,-56,0,62,62,1,442,11.310440165,14.829243771,-3.518803607,0.0,3.8958182789,3.8958182789
2024,Kentucky,Christian County,72032,-254,1295,771,524,83,-863,-780,2,4918,17.946479303,10.684737871,7.2617414321,1.1502376696,-11.95970011,-10.80946244
2024,Kentucky,Clark County,37304,312,410,492,-82,6,389,395,-1,440,11.036933348,13.244320017,-2.20738667,0.1615160978,10.471627005,10.633143103
2024,Kentucky,Clay County,19648,-226,232,344,-112,5,-121,-116,2,1723,11.740296544,17.40802591,-5.667729366,0.2530236324,-6.123171904,-5.870148272
2024,Kentucky,Clinton County,9148,9,107,155,-48,10,46,56,1,128,11.702302182,16.951933067,-5.249630885,1.0936731011,5.0308962651,6.1245693662
2024,Kentucky,Crittenden County,8974,-17,102,146,-44,4,23,27,0,254,11.355413304,16.253826886,-4.898413582,0.4453103256,2.5605343724,3.005844698
2024,Kentucky,Cumberland County,6000,31,74,110,-36,1,69,70,-3,80,12.365276965,18.380817111,-6.015540145,0.1670983374,11.529785279,11.696883616
2024,Kentucky,Daviess County,103458,269,1308,1161,147,143,-26,117,5,2406,12.659269189,11.236553156,1.4227160327,1.3840026712,-0.251636849,1.1323658219
2024,Kentucky,Edmonson County,12448,146,108,180,-72,0,218,218,0,143,8.7272727273,14.545454545,-5.818181818,0.0,17.616161616,17.616161616
2024,Kentucky,Elliott County,7245,-47,52,97,-45,0,-4,-4,2,1114,7.1541583545,13.345256931,-6.191098576,0.0,-0.550319873,-0.550319873
2024,Kentucky,Estill County,13936,-88,126,237,-111,8,15,23,0,90,9.0128755365,16.9527897,-7.939914163,0.5722460658,1.0729613734,1.6452074392
2024,Kentucky,Fayette County,320154,-127,3696,2594,1102,1414,-2644,-1230,1,11923,11.542154942,8.1007440255,3.441410916,4.4157486708,-8.256887897,-3.841139226
2024,Kentucky,Fleming County,15442,164,205,208,-3,-2,168,166,1,169,13.346354167,13.541666667,-0.1953125,-0.130208333,10.9375,10.807291667
2024,Kentucky,Floyd County,34423,-495,367,655,-288,5,-213,-208,1,268,10.585367964,18.892141734,-8.30677377,0.1442148224,-6.143551434,-5.999336612
2024,Kentucky,Franklin County,51644,96,512,697,-185,91,191,282,-1,1667,9.9232498643,13.508799132,-3.585549267,1.7637026126,3.7018373517,5.4655399643
2024,Kentucky,Fulton County,6338,-33,73,121,-48,-1,16,15,0,539,11.487921945,19.041624046,-7.553702101,-0.157368794,2.5179007003,2.3605319065
2024,Kentucky,Gallatin County,8792,19,112,113,-1,4,16,20,0,108,12.752633077,12.866495872,-0.113862795,0.4554511813,1.8218047253,2.2772559066
2024,Kentucky,Garrard County,17829,263,175,234,-59,24,300,324,-2,140,9.8884023167,13.222206526,-3.33380421,1.3561237463,16.951546829,18.307670575
2024,Kentucky,Grant County,25619,145,361,305,56,1,87,88,1,325,14.131094279,11.939013172,2.192081107,0.0391443055,3.4055545769,3.4446988824
2024,Kentucky,Graves County,36461,-32,465,507,-42,37,-28,9,1,366,12.747758862,13.89916934,-1.151410478,1.0143378019,-0.767606985,0.2467308167
2024,Kentucky,Grayson County,26825,182,376,409,-33,0,213,213,2,752,14.06448717,15.298870352,-1.234383182,0.0,7.9673823595,7.9673823595
2024,Kentucky,Green County,11468,76,117,164,-47,0,122,122,1,100,10.236220472,14.348206474,-4.111986002,0.0,10.673665792,10.673665792
2024,Kentucky,Greenup County,35221,-154,301,529,-228,-2,77,75,-1,545,8.5273953198,14.986684798,-6.459289478,-0.056660434,2.1814267097,2.1247662757
2024,Kentucky,Hancock County,8920,-107,95,111,-16,0,-90,-90,-1,90,10.586727587,12.369755391,-1.783027804,0.0,-10.0295314,-10.0295314
2024,Kentucky,Hardin County,112273,530,1369,1208,161,143,229,372,-3,2509,12.222341261,10.784943933,1.4373973288,1.2766945218,2.0444968217,3.3211913435
2024,Kentucky,Harlan County,25324,-328,282,510,-228,0,-100,-100,0,561,11.064030132,20.009416196,-8.945386064,0.0,-3.92341494,-3.92341494
2024,Kentucky,Harrison County,19415,310,255,286,-31,0,342,342,-1,311,13.239875389,14.849428868,-1.609553479,0.0,17.757009346,17.757009346
2024,Kentucky,Hart County,19724,130,257,257,0,0,130,130,0,239,13.072892823,13.072892823,0.0,0.0,6.6127473422,6.6127473422
2024,Kentucky,Henderson County,44119,87,514,584,-70,16,142,158,-1,994,11.66180758,13.249991492,-1.588183912,0.3630134655,3.2217445066,3.5847579721
2024,Kentucky,Henry County,15973,213,198,219,-21,4,231,235,-1,93,12.47912268,13.802665994,-1.323543315,0.2521034885,14.55897646,14.811079948
2024,Kentucky,Hickman County,4447,13,41,78,-37,1,51,52,-2,120,9.2331944601,17.565589461,-8.332395001,0.2251998649,11.485193109,11.710392974
2024,Kentucky,Hopkins County,44929,3,524,651,-127,55,75,130,0,979,11.663235212,14.490011685,-2.826776473,1.2241945356,1.669356185,2.8935507206
2024,Kentucky,Jackson County,13104,115,161,193,-32,-1,148,147,0,94,12.340474457,14.793239566,-2.452765109,-0.07664891,11.344038631,11.267389721
2024,Kentucky,Jefferson County,772144,-951,9534,8371,1163,3247,-5371,-2124,10,13880,12.339838692,10.834569927,1.5052687642,4.2025861372,-6.951675437,-2.749089299
2024,Kentucky,Jessamine County,55017,781,618,542,76,95,608,703,2,1447,11.313190484,9.9219243408,1.3912661437,1.7390826797,11.13012915,12.869211829
2024,Kentucky,Johnson County,22116,-119,231,378,-147,5,22,27,1,386,10.416901535,17.045838876,-6.628937341,0.2254740592,0.9920858605,1.2175599197
2024,Kentucky,Kenton County,171321,1041,2158,1486,672,234,129,363,6,1800,12.634623435,8.700208723,3.9344147119,1.3700194086,0.7552671099,2.1252865185
2024,Kentucky,Knott County,13659,-188,108,254,-146,5,-45,-40,-2,625,7.8528321094,18.468697739,-10.61586563,0.3635570421,-3.272013379,-2.908456337
2024,Kentucky,Knox County,29794,21,377,497,-120,11,129,140,1,939,12.658015344,16.687091846,-4.029076502,0.3693320127,4.3312572397,4.7005892524
2024,Kentucky,Larue County,15303,153,158,203,-45,-1,200,199,-1,157,10.376645979,13.332019834,-2.955373855,-0.065674975,13.13499491,13.069319936
2024,Kentucky,Laurel County,63296,417,705,803,-98,16,499,515,0,1082,11.174955419,12.728353477,-1.553398058,0.2536160095,7.9096492966,8.1632653061
2024,Kentucky,Lawrence County,16000,-97,142,266,-124,6,23,29,-2,131,8.8481789575,16.574757766,-7.726578808,0.3738667165,1.4331557466,1.8070224632
2024,Kentucky,Lee County,7293,20,65,133,-68,0,88,88,0,1146,8.9248935878,18.261705341,-9.336811753,0.0,12.082932857,12.082932857
2024,Kentucky,Leslie County,9864,-185,95,199,-104,0,-80,-80,-1,324,9.5415055491,19.986943203,-10.44543765,0.0,-8.034952041,-8.034952041
2024,Kentucky,Letcher County,20423,-404,179,409,-230,0,-174,-174,0,309,8.6787878788,19.83030303,-11.15151515,0.0,-8.436363636,-8.436363636
2024,Kentucky,Lewis County,12973,36,161,211,-50,0,88,88,-2,145,12.427634118,16.287147819,-3.859513701,0.0,6.7927441142,6.7927441142
2024,Kentucky,Lincoln County,24776,357,312,382,-70,-1,428,427,0,175,12.684215876,15.53003354,-2.845817664,-0.040654538,17.400142291,17.359487753
2024,Kentucky,Livingston County,8892,-76,94,163,-69,0,-7,-7,0,63,10.526315789,18.253079507,-7.726763718,0.0,-0.78387458,-0.78387458
2024,Kentucky,Logan County,28283,427,368,370,-2,8,421,429,0,341,13.110315467,13.181567181,-0.071251714,0.285006858,14.998485901,15.283492759
2024,Kentucky,Lyon County,9187,88,53,137,-84,14,159,173,-1,1811,5.7967844252,14.984140873,-9.187356448,1.5312260746,17.390353276,18.92157935
2024,Kentucky,McCracken County,67428,62,696,933,-237,15,283,298,1,2158,10.326869148,13.843346143,-3.516476995,0.2225618351,4.1989999555,4.4215617906
2024,Kentucky,McCreary County,17050,267,180,279,-99,5,359,364,2,1916,10.640498921,16.492773328,-5.852274407,0.2955694145,21.221883959,21.517453374
2024,Kentucky,McLean County,9054,-53,94,137,-43,-1,-10,-11,1,87,10.351852872,15.08727493,-4.735422058,-0.110126094,-1.101260944,-1.211387038
2024,Kentucky,Madison County,96735,1584,1058,942,116,63,1407,1470,-2,4836,11.027380841,9.8183296332,1.2090512075,0.6566398799,14.664957318,15.321597198
2024,Kentucky,Magoffin County,11228,-120,130,211,-81,-1,-39,-40,1,121,11.516654855,18.692416726,-7.175761871,-0.088589653,-3.454996456,-3.543586109
2024,Kentucky,Marion County,19834,86,212,244,-32,7,111,118,0,546,10.711939771,12.32883634,-1.616896569,0.3536961245,5.6086099742,5.9623060987
2024,Kentucky,Marshall County,31744,-46,304,450,-146,-2,102,100,0,442,9.5696792269,14.165643592,-4.595964366,-0.062958416,3.2108792143,3.1479207983
2024,Kentucky,Martin County,10928,-168,100,167,-67,-1,-100,-101,0,1569,9.0810025427,15.165274246,-6.084271704,-0.090810025,-9.081002543,-9.171812568
2024,Kentucky,Mason County,16841,-62,186,251,-65,9,-6,3,0,251,11.024182077,14.876718824,-3.852536747,0.533428165,-0.355618777,0.1778093883
2024,Kentucky,Meade County,30131,121,267,307,-40,19,141,160,1,219,8.879134035,10.209341381,-1.330207346,0.6318484894,4.6889808949,5.3208293843
2024,Kentucky,Menifee County,6286,50,72,107,-35,-1,87,86,-1,56,11.499760422,17.089921738,-5.590161316,-0.159718895,13.895543843,13.735824948
2024,Kentucky,Mercer County,23097,197,254,333,-79,-1,277,276,0,258,11.044198535,14.479205166,-3.435006631,-0.043481097,12.044263756,12.00078266
2024,Kentucky,Metcalfe County,10482,74,119,156,-37,13,99,112,-1,85,11.39301101,14.935375778,-3.542364768,1.2446146482,9.4782192437,10.722833892
2024,Kentucky,Monroe County,11306,-47,147,182,-35,-1,-12,-13,1,102,12.97497683,16.064257028,-3.089280198,-0.088265149,-1.059181782,-1.147446931
2024,Kentucky,Montgomery County,28527,170,326,373,-47,6,212,218,-1,304,11.461922509,13.114408269,-1.65248576,0.210955629,7.453765558,7.664721187
2024,Kentucky,Morgan County,14283,137,130,176,-46,26,160,186,-3,2028,9.14559077,12.381722889,-3.236132119,1.829118154,11.256111717,13.085229871
2024,Kentucky,Muhlenberg County,30568,-128,339,448,-109,3,-22,-19,0,1753,11.066858188,14.625228519,-3.558370332,0.0979367981,-0.718203186,-0.620266388
2024,Kentucky,Nelson County,47730,371,553,542,11,40,318,358,2,640,11.631208657,11.39984646,0.2313621975,0.8413170819,6.688470801,7.5297878829
2024,Kentucky,Nicholas County,7686,-100,99,117,-18,0,-82,-82,0,104,12.797311272,15.12409514,-2.326783868,0.0,-10.59979317,-10.59979317
2024,Kentucky,Ohio County,23626,130,256,346,-90,70,151,221,-1,250,10.865413183,14.685285005,-3.819871822,2.9710114172,6.408896057,9.3799074742
2024,Kentucky,Oldham County,70183,739,546,473,73,79,600,679,-13,4178,7.8208369441,6.7751939095,1.0456430347,1.1315862978,8.5943263122,9.72591261
2024,Kentucky,Owen County,11313,19,109,151,-42,2,59,61,0,98,9.6430309196,13.35869421,-3.71566329,0.1769363471,5.2196222409,5.396558588
2024,Kentucky,Owsley County,4001,43,55,85,-30,0,73,73,0,92,13.820831763,21.35946727,-7.538635507,0.0,18.344013067,18.344013067
2024,Kentucky,Pendleton County,14810,107,166,183,-17,2,122,124,0,208,11.249279978,12.401314675,-1.152034697,0.1355334937,8.2675431166,8.4030766103
2024,Kentucky,Perry County,27133,-234,312,511,-199,6,-40,-34,-1,656,11.449541284,18.752293578,-7.302752294,0.2201834862,-1.467889908,-1.247706422
2024,Kentucky,Pike County,55973,-344,536,937,-401,13,43,56,1,1878,9.5467094131,16.688930448,-7.142221035,0.2315433253,0.7658740761,0.9974174014
2024,Kentucky,Powell County,12972,-69,166,214,-48,-1,-19,-20,-1,295,12.762849345,16.453311806,-3.690462461,-0.076884635,-1.460808058,-1.537692692
2024,Kentucky,Pulaski County,66191,424,691,917,-226,23,629,652,-2,1162,10.473029297,13.8983616,-3.425332303,0.3485957653,9.5333363646,9.8819321299
2024,Kentucky,Robertson County,2313,66,20,38,-18,2,83,85,-1,54,8.7719298246,16.666666667,-7.894736842,0.8771929825,36.403508772,37.280701754
2024,Kentucky,Rockcastle County,16190,-35,162,282,-120,0,85,85,0,310,9.9953725127,17.399352152,-7.403979639,0.0,5.2444855777,5.2444855777
2024,Kentucky,Rowan County,24409,37,272,291,-19,31,25,56,0,2750,11.151882905,11.930874726,-0.778991821,1.2709866546,1.0249892376,2.2959758923
2024,Kentucky,Russell County,18279,94,211,274,-63,15,143,158,-1,208,11.573058359,15.028521281,-3.455462922,0.8227292672,7.8433523475,8.6660816147
2024,Kentucky,Scott County,60168,1091,699,491,208,36,848,884,-1,1112,11.723762003,8.2351461277,3.4886158749,0.6037989014,14.222818567,14.826617468
2024,Kentucky,Shelby County,49515,673,568,492,76,87,509,596,1,1189,11.5497626,10.004371829,1.5453907704,1.7690657503,10.350051344,12.119117094
2024,Kentucky,Simpson County,20195,247,211,256,-45,-8,303,295,-3,529,10.512418105,12.754403009,-2.241984904,-0.398575094,15.096031687,14.697456593
2024,Kentucky,Spencer County,20531,319,201,186,15,11,295,306,-2,87,9.8667255725,9.1304027686,0.7363228039,0.5399700562,14.481015144,15.0209852
2024,Kentucky,Taylor County,26443,47,324,402,-78,15,110,125,0,1430,12.263668881,15.216033612,-2.952364731,0.5677624482,4.1635912867,4.7313537349
2024,Kentucky,Todd County,12494,100,175,167,8,19,72,91,1,145,14.06300225,13.420122147,0.6428801029,1.5268402443,5.7859209257,7.31276117
2024,Kentucky,Trigg County,14369,21,158,221,-63,0,85,85,-1,58,11.003934951,15.3915799,-4.387644949,0.0,5.9198384232,5.9198384232
2024,Kentucky,Trimble County,8607,80,87,132,-45,4,121,125,0,38,10.155246878,15.40796078,-5.252713902,0.4669079024,14.123964048,14.590871951
2024,Kentucky,Union County,13106,2,164,203,-39,1,39,40,1,438,12.514307516,15.490270889,-2.975963373,0.0763067531,2.9759633728,3.0522701259
2024,Kentucky,Warren County,142229,2183,1898,1207,691,572,909,1481,11,5700,13.447878842,8.5519440262,4.8959348153,4.0527854043,6.440527854,10.493313258
2024,Kentucky,Washington County,12267,207,133,162,-29,11,226,237,-1,314,10.934352777,13.318534961,-2.384182184,0.9043449665,18.580178403,19.484523369
2024,Kentucky,Wayne County,19580,-54,209,287,-78,7,17,24,0,312,10.659458357,14.637629418,-3.978171061,0.3570153517,0.8670372826,1.2240526343
2024,Kentucky,Webster County,12726,-13,172,190,-18,20,-14,6,-1,401,13.508737483,14.922442568,-1.413705085,1.5707834282,-1.0995484,0.4712350285
2024,Kentucky,Whitley County,36825,-83,544,583,-39,9,-55,-46,2,1717,14.755943743,15.81381471,-1.057870967,0.2441240693,-1.491869312,-1.247745243
2024,Kentucky,Wolfe County,6282,-134,88,148,-60,1,-74,-73,-1,130,13.860450465,23.3107576,-9.450307135,0.1575051189,-11.6553788,-11.49787368
2024,Kentucky,Woodford County,27268,215,273,297,-24,36,204,240,-1,547,10.051361352,10.934997515,-0.883636163,1.3254542442,7.5109073839,8.8363616281
2024,Louisiana,Louisiana,4573749,-14274,56209,50094,6115,9274,-29692,-20418,29,123627,12.27033373,10.935439127,1.3348946034,2.0244991908,-6.481715546,-4.457216355
2024,Louisiana,Acadia Parish,56489,-236,834,806,28,-7,-262,-269,5,697,14.73316021,14.238521738,0.4946384723,-0.123659618,-4.628402848,-4.752062466
2024,Louisiana,Allen Parish,22112,-175,237,330,-93,38,-120,-82,0,2806,10.675916124,14.865199667,-4.189283542,1.7117502646,-5.405527152,-3.693776887
2024,Louisiana,Ascension Parish,131632,1147,1631,906,725,75,346,421,1,618,12.444824258,6.9129434565,5.5318808013,0.5722635312,2.6400424238,3.212305955
2024,Louisiana,Assumption Parish,20160,-303,210,310,-100,1,-205,-204,1,161,10.338970534,15.262289836,-4.923319302,0.049233193,-10.09280457,-10.04357138
2024,Louisiana,Avoyelles Parish,38408,-307,442,578,-136,29,-205,-176,5,2803,11.462209717,14.989043476,-3.526833759,0.7520454339,-5.31618324,-4.564137806
2024,Louisiana,Beauregard Parish,36827,203,508,433,75,8,120,128,0,1058,13.832350819,11.790173041,2.0421777784,0.2178322964,3.2674844454,3.4853167418
2024,Louisiana,Bienville Parish,12366,-246,165,253,-88,4,-162,-158,0,311,13.211626231,20.257826888,-7.046200657,0.320281848,-12.97141485,-12.651133
2024,Louisiana,Bossier Parish,129795,642,1573,1223,350,300,-14,286,6,2123,12.14915736,9.4459119205,2.7032454392,2.3170675193,-0.108129818,2.2089377018
2024,Louisiana,Caddo Parish,226386,-2548,2748,2818,-70,141,-2616,-2475,-3,4052,12.070631644,12.378107704,-0.307476061,0.6193446367,-11.49081964,-10.87147501
2024,Louisiana,Calcasieu Parish,203761,1473,2499,2060,439,393,650,1043,-9,2597,12.308859276,10.146558667,2.162300609,1.9357269689,3.2015840453,5.1373110142
2024,Louisiana,Caldwell Parish,9389,-104,85,148,-63,2,-44,-42,1,708,9.0032835505,15.676305476,-6.673021926,0.2118419659,-4.66052325,-4.448681284
2024,Louisiana,Cameron Parish,4768,-128,60,52,8,-2,-137,-139,3,22,12.417218543,10.761589404,1.6556291391,-0.413907285,-28.35264901,-28.76655629
2024,Louisiana,Catahoula Parish,8414,-190,77,142,-65,1,-126,-125,0,500,9.0492419791,16.688212481,-7.638970502,0.1175226231,-14.80785051,-14.69032789
2024,Louisiana,Claiborne Parish,13670,-179,142,196,-54,0,-123,-123,-2,1793,10.320142447,14.244703659,-3.924561212,0.0,-8.939278317,-8.939278317
2024,Louisiana,Concordia Parish,17688,-338,105,287,-182,65,-223,-158,2,874,5.8800470404,16.072128577,-10.19208154,3.6400291202,-12.4880999,-8.848070785
2024,Louisiana,De Soto Parish,27114,258,335,356,-21,0,281,281,-2,277,12.414304243,13.19251436,-0.778210117,0.0,10.413192514,10.413192514
2024,Louisiana,East Baton Rouge Parish,448467,-1624,5455,4160,1295,1739,-4674,-2935,16,17292,12.141675885,9.2592798684,2.8823960167,3.8706460796,-10.40333512,-6.532689042
2024,Louisiana,East Carroll Parish,6829,-110,63,112,-49,-1,-61,-62,1,1662,9.1516560139,16.269610691,-7.117954678,-0.145264381,-8.861127252,-9.006391633
2024,Louisiana,East Feliciana Parish,19229,21,175,283,-108,0,132,132,-3,2838,9.1058095065,14.725394802,-5.619585295,0.0,6.8683820277,6.8683820277
2024,Louisiana,Evangeline Parish,31754,-279,453,445,8,113,-400,-287,0,1442,14.203521094,13.952686284,0.2508348096,3.5430416856,-12.54174048,-8.998698794
2024,Louisiana,Franklin Parish,19285,-73,235,294,-59,1,-15,-14,0,338,12.162616774,15.216209922,-3.053593148,0.0517558161,-0.776337241,-0.724581425
2024,Louisiana,Grant Parish,21911,-129,261,262,-1,13,-138,-125,-3,2959,11.87686287,11.922368092,-0.045505222,0.5915678824,-6.279720598,-5.688152716
2024,Louisiana,Iberia Parish,67659,-661,873,845,28,72,-762,-690,1,660,12.840217975,12.428389678,0.411828297,1.0589870495,-11.20761294,-10.14862589
2024,Louisiana,Iberville Parish,29617,4,345,418,-73,66,10,76,1,2788,11.649501942,14.114469019,-2.464967077,2.2286003714,0.3376667229,2.5662670944
2024,Louisiana,Jackson Parish,14746,-70,120,219,-99,29,2,31,-2,705,8.118530546,14.816318246,-6.6977877,1.9619782153,0.1353088424,2.0972870577
2024,Louisiana,Jefferson Parish,421777,-4253,5202,4223,979,2753,-7945,-5192,-40,2937,12.271660885,9.9621729946,2.3094878905,6.4944026176,-18.74247323,-12.24807061
2024,Louisiana,Jefferson Davis Parish,31553,-376,435,480,-45,-3,-327,-330,-1,662,13.704672191,15.1223969,-1.417724709,-0.094514981,-10.30213289,-10.39664787
2024,Louisiana,Lafayette Parish,249750,2036,3388,2063,1325,688,12,700,11,2782,13.621086149,8.2940675104,5.3270186385,2.7660293006,0.0482446971,2.8142739977
2024,Louisiana,Lafourche Parish,95056,-695,1115,1063,52,22,-772,-750,3,2430,11.687202251,11.142148873,0.5450533785,0.2305995063,-8.091946312,-7.861346806
2024,Louisiana,LaSalle Parish,14800,-21,169,191,-22,8,-8,0,1,2003,11.410823402,12.896256035,-1.485432632,0.5401573208,-0.540157321,0.0
2024,Louisiana,Lincoln Parish,47962,-18,465,462,3,21,-43,-22,1,5294,9.6933564028,9.6308186196,0.0625377832,0.4377644827,-0.896374893,-0.45861041
2024,Louisiana,Livingston Parish,150145,2089,1842,1345,497,171,1422,1593,-1,1046,12.35408332,9.0207611644,3.3333221552,1.1468774417,9.5371913575,10.684068799
2024,Louisiana,Madison Parish,9246,-234,131,141,-10,4,-226,-222,-2,825,13.991242123,15.059275873,-1.06803375,0.4272134999,-24.13756275,-23.71034925
2024,Louisiana,Morehouse Parish,23955,-459,269,480,-211,7,-255,-248,0,1159,11.122826604,19.847422936,-8.724596332,0.2894415845,-10.54394343,-10.25450185
2024,Louisiana,Natchitoches Parish,36291,-357,425,509,-84,5,-276,-271,-2,2113,11.653573534,13.956868068,-2.303294534,0.1371008651,-7.567967754,-7.430866889
2024,Louisiana,Orleans Parish,364136,-5781,4111,3387,724,964,-7468,-6504,-1,15504,11.200826098,9.2282164912,1.9726096072,2.6265133444,-20.34730462,-17.72079128
2024,Louisiana,Ouachita Parish,157568,-136,2016,1748,268,168,-583,-415,11,5281,12.788956837,11.088837575,1.7001192621,1.0657464031,-3.698393768,-2.632647365
2024,Louisiana,Plaquemines Parish,22386,-232,291,212,79,27,-338,-311,0,788,12.932183806,9.4213847658,3.5107990401,1.1998933428,-15.02088703,-13.82099369
2024,Louisiana,Pointe Coupee Parish,20000,-212,249,315,-66,21,-165,-144,-2,153,12.384362877,15.666965085,-3.282602208,1.044464339,-8.206505521,-7.162041182
2024,Louisiana,Rapides Parish,126260,-768,1631,1671,-40,78,-817,-739,11,3336,12.878620385,13.194466378,-0.315845993,0.6158996873,-6.451154417,-5.83525473
2024,Louisiana,Red River Parish,7356,-109,95,130,-35,0,-73,-73,-1,168,12.819647797,17.542675933,-4.723028136,0.0,-9.850887255,-9.850887255
2024,Louisiana,Richland Parish,19712,-72,260,281,-21,24,-76,-52,1,1019,13.165890217,14.229289042,-1.063398825,1.2153129431,-3.848490986,-2.633178043
2024,Louisiana,Sabine Parish,21906,-68,264,361,-97,0,29,29,0,343,12.032816773,16.45396536,-4.421148587,0.0,1.321786691,1.321786691
2024,Louisiana,St. Bernard Parish,44463,44,575,460,115,64,-137,-73,2,224,12.938502734,10.350802187,2.5877005468,1.4401116086,-3.082738912,-1.642627304
2024,Louisiana,St. Charles Parish,50620,-438,576,468,108,5,-553,-548,2,585,11.329884537,9.2055311867,2.1243533508,0.0983496922,-10.87747595,-10.77912626
2024,Louisiana,St. Helena Parish,10774,-15,96,168,-72,37,21,58,-1,108,8.9041413532,15.582247368,-6.678106015,3.4318044799,1.947780921,5.3795854009
2024,Louisiana,St. James Parish,19191,-197,213,249,-36,8,-170,-162,1,141,11.042276886,12.908577205,-1.866300319,0.4147334042,-8.813084839,-8.398351435
2024,Louisiana,St. John the Baptist Parish,39592,-363,471,456,15,30,-413,-383,5,366,11.84205564,11.46492011,0.3771355299,0.7542710599,-10.38379826,-9.629527198
2024,Louisiana,St. Landry Parish,81464,-215,1188,1111,77,70,-366,-296,4,1216,14.563910189,13.619953047,0.9439571419,0.8581428563,-4.48686122,-3.628718364
2024,Louisiana,St. Martin Parish,51057,-192,630,576,54,32,-275,-243,-3,272,12.315993197,11.260336637,1.0556565597,0.6255742576,-5.376028776,-4.750454519
2024,Louisiana,St. Mary Parish,47055,-764,616,661,-45,105,-821,-716,-3,668,12.985644117,13.934270717,-0.948626599,2.2134620655,-17.30716529,-15.09370323
2024,Louisiana,St. Tammany Parish,275583,2346,3081,2490,591,493,1264,1757,-2,2496,11.227724937,9.0740133377,2.1537115994,1.7965817572,4.6062461281,6.4028278853
2024,Louisiana,Tangipahoa Parish,138064,1265,1970,1520,450,68,735,803,12,4503,14.334413872,11.060055373,3.2743584986,0.4947919509,5.348118881,5.8429108319
2024,Louisiana,Tensas Parish,3764,-50,18,86,-68,0,18,18,0,0,4.7505938242,22.697281605,-17.94668778,0.0,4.7505938242,4.7505938242
2024,Louisiana,Terrebonne Parish,103616,-1016,1367,1242,125,130,-1272,-1142,1,1023,13.128577465,11.928085744,1.2004917214,1.2485113903,-12.21620376,-10.96769237
2024,Louisiana,Union Parish,20650,-79,195,338,-143,12,53,65,-1,416,9.425070688,16.336789193,-6.911718505,0.58000435,2.5616858793,3.1416902293
2024,Louisiana,Vermilion Parish,56992,39,749,702,47,1,-11,-10,2,571,13.14669358,12.32173417,0.8249594102,0.0175523279,-0.193075607,-0.175523279
2024,Louisiana,Vernon Parish,46250,-620,814,443,371,80,-1065,-985,-6,1411,17.482817869,9.514604811,7.9682130584,1.7182130584,-22.87371134,-21.15549828
2024,Louisiana,Washington Parish,44865,-126,566,687,-121,-1,-5,-6,1,1767,12.597934473,15.291132479,-2.693198006,-0.022257835,-0.111289174,-0.133547009
2024,Louisiana,Webster Parish,35238,-289,393,640,-247,25,-69,-44,2,391,11.107185756,18.088037872,-6.980852116,0.7065639794,-1.950116583,-1.243552604
2024,Louisiana,West Baton Rouge Parish,28266,232,337,278,59,14,156,170,3,608,11.971580817,9.8756660746,2.0959147425,0.4973357016,5.541740675,6.0390763766
2024,Louisiana,West Carroll Parish,9323,-158,110,150,-40,1,-120,-119,1,56,11.699638375,15.954052329,-4.254413954,0.1063603489,-12.76324186,-12.65688151
2024,Louisiana,West Feliciana Parish,15371,-25,120,165,-45,1,19,20,0,5381,7.800565541,10.725777619,-2.925212078,0.0650047128,1.235089544,1.3000942568
2024,Louisiana,Winn Parish,13216,-35,135,206,-71,61,-26,35,1,1497,10.201382854,15.566554577,-5.365171723,4.6095137341,-1.964710772,2.6448029622
2024,Maine,Maine,1395722,6384,11945,16998,-5053,2209,9216,11425,12,41513,8.5779121455,12.206559284,-3.628647139,1.5863213001,6.618169806,8.2044911061
2024,Maine,Androscoggin County,113765,540,1136,1429,-293,346,478,824,9,5898,10.009251509,12.590863034,-2.581611525,3.048592449,4.2116392793,7.2602317283
2024,Maine,Aroostook County,67351,29,640,1084,-444,40,435,475,-2,1592,9.5045035011,16.098252805,-6.593749304,0.5940314688,6.4600922234,7.0541236922
2024,Maine,Cumberland County,310230,1393,2922,3059,-137,1133,401,1534,-4,10409,9.4400121473,9.8826136751,-0.442601528,3.6603469414,1.2954979025,4.9558448439
2024,Maine,Franklin County,30828,233,226,411,-185,16,403,419,-1,1832,7.3588069616,13.38260912,-6.023802159,0.520977484,13.122120378,13.643097862
2024,Maine,Hancock County,56526,-23,372,752,-380,40,315,355,2,1354,6.5797037365,13.300906478,-6.721202742,0.7074950254,5.5715233252,6.2790183507
2024,Maine,Kennebec County,127259,724,1110,1605,-495,127,1092,1219,0,4314,8.7472517081,12.648053145,-3.900801437,1.0008116819,8.6054043831,9.606216065
2024,Maine,Knox County,40977,-202,280,542,-262,20,42,62,-2,1431,6.8163006962,13.194410633,-6.378109937,0.4868786212,1.0224451044,1.5093237256
2024,Maine,Lincoln County,36507,222,258,450,-192,2,412,414,0,570,7.088691065,12.363996044,-5.275304979,0.0549510935,11.319925267,11.37487636
2024,Maine,Oxford County,59905,447,441,831,-390,9,829,838,-1,845,7.3892244665,13.92391277,-6.534688304,0.1508004993,13.890401548,14.041202048
2024,Maine,Penobscot County,155312,584,1298,1950,-652,205,1032,1237,-1,6783,8.3731131467,12.579022062,-4.205908915,1.3224100116,6.6572055219,7.9796155335
2024,Maine,Piscataquis County,17486,83,130,306,-176,8,251,259,0,242,7.4522055662,17.54134541,-10.08913984,0.4585972656,14.388489209,14.847086474
2024,Maine,Sagadahoc County,37513,141,315,441,-126,14,255,269,-2,340,8.4128997797,11.778059692,-3.365159912,0.3739066569,6.8104426788,7.1843493356
2024,Maine,Somerset County,51302,184,472,759,-287,10,458,468,3,665,9.2169498145,14.82132396,-5.604374146,0.1952743605,8.9435657098,9.1388400703
2024,Maine,Waldo County,40620,365,359,531,-172,7,526,533,4,832,8.8778979907,13.13137558,-4.253477589,0.1731066461,13.007727975,13.180834621
2024,Maine,Washington County,31555,28,287,529,-242,17,252,269,1,827,9.0992676199,16.771820805,-7.672553185,0.5389810088,7.989600837,8.5285818459
2024,Maine,York County,218586,1636,1699,2319,-620,215,2035,2250,6,3579,7.8018809008,10.648947504,-2.847066603,0.9872892252,9.3448073179,10.332096543
2024,Maryland,Maryland,6180253,16272,67969,53770,14199,32977,-30905,2072,1,125196,11.012266942,8.7117596766,2.3005072652,5.342899365,-5.007196072,0.3357032927
2024,Maryland,Allegany County,67273,7,553,1001,-448,33,427,460,-5,6178,8.22066464,14.880443589,-6.659778949,0.4905640744,6.3476018106,6.838165885
2024,Maryland,Anne Arundel County,594582,1235,6971,4570,2401,1525,-2732,-1207,41,9584,11.736391653,7.6940625239,4.0423291291,2.5674935118,-4.599601491,-2.03210798
2024,Maryland,Baltimore County,844703,-1283,9375,8577,798,3663,-5765,-2102,21,22361,11.090153186,10.146159347,0.9439938392,4.3331446529,-6.819704866,-2.486560213
2024,Maryland,Calvert County,94728,169,957,834,123,78,-28,50,-4,582,10.11162943,8.8120156165,1.2996138139,0.8241453454,-0.295847047,0.5282982984
2024,Maryland,Caroline County,33593,166,423,430,-7,103,68,171,2,563,12.623097583,12.831990451,-0.208892868,3.0737093405,2.0292450015,5.102954342
2024,Maryland,Carroll County,176639,1167,1795,1758,37,215,944,1159,-29,3745,10.195648531,9.9854875309,0.2101610004,1.2212058129,5.3619455229,6.5831513358
2024,Maryland,Cecil County,105672,802,1124,1194,-70,142,733,875,-3,1384,10.677204548,11.342155009,-0.664950461,1.348899507,6.9629812579,8.3118807649
2024,Maryland,Charles County,171973,1862,1724,1421,303,395,1174,1569,-10,1440,10.079395704,8.3079009834,1.7714947206,2.3093743057,6.8638112277,9.1731855334
2024,Maryland,Dorchester County,32879,296,336,489,-153,32,413,445,4,380,10.265497541,14.939965171,-4.67446763,0.9776664324,12.618007394,13.595673826
2024,Maryland,Frederick County,293391,5851,3172,2066,1106,1215,3551,4766,-21,5186,10.920401907,7.1127207878,3.8076811188,4.1829408312,12.225204026,16.408144857
2024,Maryland,Garrett County,28423,-165,215,389,-174,6,4,10,-1,606,7.5424040975,13.646489274,-6.104085177,0.2104856957,0.1403237972,0.3508094929
2024,Maryland,Harford County,264644,829,2624,2413,211,148,481,629,-11,1825,9.9307609483,9.1322127166,0.7985482317,0.5601191389,1.8203872013,2.3805063401
2024,Maryland,Howard County,336001,635,3236,1901,1335,1500,-2222,-722,22,3090,9.6400329477,5.6630725073,3.9769604404,4.4684948769,-6.619330411,-2.150835534
2024,Maryland,Kent County,19303,8,145,312,-167,37,139,176,-1,1355,7.5133426602,16.166640759,-8.653298098,1.9171977823,7.2024457226,9.1196435048
2024,Maryland,Montgomery County,1058474,5407,11709,6412,5297,11191,-11153,38,72,8704,11.09047847,6.0732896022,5.0171888682,10.599841538,-10.56384887,0.0359926708
2024,Maryland,Prince George's County,947430,450,10619,6954,3665,9345,-12516,-3171,-44,19787,11.210878321,7.3415997593,3.8692785617,9.865868529,-13.21361268,-3.347744153
2024,Maryland,Queen Anne's County,52508,788,533,522,11,107,675,782,-5,359,10.227578002,10.016502283,0.2110757186,2.0531910811,12.952373642,15.005564723
2024,Maryland,St. Mary's County,115281,498,1405,1025,380,210,-96,114,4,2358,12.213992628,8.910564017,3.3034286112,1.8255789693,-0.834550386,0.9910285834
2024,Maryland,Somerset County,24910,302,218,315,-97,59,340,399,0,4877,8.8048790339,12.72264631,-3.917767277,2.3829718486,13.732380145,16.115351993
2024,Maryland,Talbot County,37823,9,304,543,-239,88,163,251,-3,472,8.0383939077,14.358052276,-6.319658368,2.3269034996,4.3100598913,6.6369633909
2024,Maryland,Washington County,155813,556,1554,1900,-346,212,693,905,-3,7979,9.9913202816,12.215899958,-2.224579677,1.3630372585,4.4555887742,5.8186260327
2024,Maryland,Wicomico County,104800,314,1276,1201,75,467,-234,233,6,3675,12.193840008,11.477117437,0.716722571,4.4627925423,-2.236174422,2.2266181207
2024,Maryland,Worcester County,54171,237,459,716,-257,70,425,495,-1,737,8.4917441376,13.246380833,-4.754636696,1.2950372323,7.8627260534,9.1577632857
2024,Maryland,Baltimore city,565239,-3868,7242,6827,415,2136,-6389,-4253,-30,17969,12.768590888,12.036891742,0.7316991465,3.7660466912,-11.26464059,-7.498593903
2024,Massachusetts,Massachusetts,7001399,18659,68387,61404,6983,50647,-39149,11498,178,240786,9.7806522089,8.7819493213,0.9987028876,7.2434920734,-5.599057618,1.6444344553
2024,Massachusetts,Barnstable County,231735,-343,1504,3208,-1704,836,539,1375,-14,4049,6.4853723376,13.833161209,-7.347788872,3.6049011132,2.3242125598,5.929113673
2024,Massachusetts,Berkshire County,126818,-729,888,1685,-797,263,-195,68,0,5321,6.9820926621,13.248678081,-6.266585419,2.067894561,-1.533229808,0.5346647534
2024,Massachusetts,Bristol County,581841,2097,5475,6004,-529,2092,531,2623,3,12942,9.4267746226,10.337599056,-0.910824434,3.6019748878,0.9142680045,4.5162428923
2024,Massachusetts,Dukes County,20819,-143,177,173,4,176,-324,-148,1,81,8.4727507719,8.2812761782,0.1914745937,8.4248821235,-15.50944209,-7.084559967
2024,Massachusetts,Essex County,810089,3590,8482,7227,1255,5988,-3691,2297,38,18410,10.493706498,8.9410536265,1.5526528714,7.4081955328,-4.566407767,2.8417877653
2024,Massachusetts,Franklin County,70836,-159,495,754,-259,152,-51,101,-1,1498,6.9801383337,10.63237233,-3.652233997,2.1433960136,-0.719165768,1.4242302459
2024,Massachusetts,Hampden County,460291,-467,4808,4951,-143,1581,-1931,-350,26,14189,10.440269736,10.750785246,-0.31051551,3.4330421074,-4.193045104,-0.760002997
2024,Massachusetts,Hampshire County,162502,-16,937,1419,-482,755,-292,463,3,23924,5.7657990278,8.7317703526,-2.965971325,4.6458679466,-1.796812504,2.8490554427
2024,Massachusetts,Middlesex County,1623952,7158,16102,11957,4145,16339,-13402,2937,76,56066,9.937218159,7.3791651675,2.5580529915,10.083480779,-8.270935149,1.8125456299
2024,Massachusetts,Nantucket County,14444,1,159,88,71,51,-122,-71,1,64,11.008412088,6.0927060616,4.9157060269,3.5310001039,-8.446706131,-4.915706027
2024,Massachusetts,Norfolk County,727473,2004,7196,6056,1140,5181,-4372,809,55,16144,9.9054194868,8.336189607,1.5692298798,7.1317368484,-6.018134241,1.1136026077
2024,Massachusetts,Plymouth County,535308,2060,5395,5289,106,1722,228,1950,4,10977,10.097739379,9.8993407926,0.1983985865,3.2230411883,0.4267441295,3.6497853178
2024,Massachusetts,Suffolk County,768425,-387,8210,4932,3278,10606,-14207,-3601,-64,49889,10.681501941,6.4167073782,4.2647945632,13.798783141,-18.48381219,-4.685029049
2024,Massachusetts,Worcester County,866866,3993,8559,7661,898,4905,-1860,3045,50,27232,9.8962907121,8.8579837767,1.0383069353,5.671375855,-2.150613474,3.5207623809
2024,Michigan,Michigan,10037261,3980,101911,105941,-4030,22817,-15051,7766,244,215992,10.155281307,10.556864882,-0.401583575,2.2736805015,-1.49981002,0.7738704814
2024,Michigan,Alcona County,10489,92,63,216,-153,9,235,244,1,80,6.03274921,20.683711577,-14.65096237,0.8618213157,22.503112133,23.364933448
2024,Michigan,Alger County,8757,-16,67,114,-47,0,30,30,1,916,7.6440387906,13.006274957,-5.362236167,0.0,3.4227039361,3.4227039361
2024,Michigan,Allegan County,121939,649,1227,1163,64,97,486,583,2,935,10.089257449,9.5630044115,0.5262530373,0.7976022596,3.9962340017,4.7938362613
2024,Michigan,Alpena County,28904,71,269,447,-178,4,246,250,-1,577,9.3181149003,15.484005057,-6.165890157,0.1385593294,8.5213987564,8.6599580858
2024,Michigan,Antrim County,24409,144,187,319,-132,17,262,279,-3,203,7.6837736779,13.107613921,-5.423840243,0.6985248798,10.765501089,11.464025969
2024,Michigan,Arenac County,15145,22,132,247,-115,0,137,137,0,172,8.7220827276,16.320866922,-7.598784195,0.0,9.0524646491,9.0524646491
2024,Michigan,Baraga County,8310,27,69,116,-47,0,73,73,1,883,8.3167600796,13.981799554,-5.665039474,0.0,8.7988910987,8.7988910987
2024,Michigan,Barry County,63808,406,604,711,-107,10,508,518,-5,460,9.4961087965,11.178366481,-1.682257684,0.1572203443,7.9867934911,8.1440138354
2024,Michigan,Bay County,102500,-138,865,1409,-544,14,396,410,-4,1168,8.4333473077,13.737094054,-5.303746746,0.1364934824,3.8608156461,3.9973091285
2024,Michigan,Benzie County,18441,114,138,231,-93,13,196,209,-2,193,7.5065274151,12.565274151,-5.058746736,0.7071366406,10.661444735,11.368581375
2024,Michigan,Berrien County,152261,-574,1584,1824,-240,225,-563,-338,4,2517,10.38361696,11.956892257,-1.573275297,1.4749455909,-3.690641634,-2.215696043
2024,Michigan,Branch County,45215,713,530,533,-3,135,575,710,6,1870,11.814929166,11.881806124,-0.066876958,3.0094630895,12.818083529,15.827546619
2024,Michigan,Calhoun County,133366,-58,1517,1670,-153,94,-1,93,2,2780,11.372240339,12.519209865,-1.146969527,0.7046740882,-0.007496533,0.6971775554
2024,Michigan,Cass County,51642,165,446,601,-155,13,308,321,-1,752,8.6502002541,11.656435768,-3.006235514,0.2521358818,5.9736808929,6.2258167748
2024,Michigan,Charlevoix County,26159,-14,201,357,-156,20,125,145,-3,295,7.6817243751,13.643659711,-5.961935336,0.7643506841,4.7771917756,5.5415424597
2024,Michigan,Cheboygan County,26048,84,192,417,-225,15,292,307,2,292,7.3829116358,16.034761209,-8.651849573,0.5767899715,11.228178113,11.804968084
2024,Michigan,Chippewa County,36264,57,291,445,-154,43,167,210,1,4155,8.0307985263,12.280774379,-4.249975852,1.1866815692,4.6087400477,5.7954216169
2024,Michigan,Clare County,31316,9,305,518,-213,4,216,220,2,342,9.7408300465,16.543442505,-6.802612459,0.1277485908,6.8984239018,7.0261724925
2024,Michigan,Clinton County,79720,68,675,712,-37,59,46,105,0,667,8.4707476847,8.9350701503,-0.464322466,0.7404060939,0.5772657681,1.3176718621
2024,Michigan,Crawford County,13538,104,107,220,-113,3,213,216,1,191,7.9341539374,16.313213703,-8.379059766,0.2224529141,15.794156903,16.016609818
2024,Michigan,Delta County,36790,9,314,528,-214,-4,228,224,-1,552,8.5359720542,14.353481671,-5.817509617,-0.108738498,6.1980943578,6.0893558603
2024,Michigan,Dickinson County,25982,39,212,341,-129,7,164,171,-3,388,8.1656234954,13.134328358,-4.968704863,0.2696196437,6.3168030814,6.5864227251
2024,Michigan,Eaton County,108820,-34,1075,1212,-137,149,-44,105,-2,1770,9.8771557467,11.135918851,-1.258763104,1.3690197267,-0.404274282,0.964745445
2024,Michigan,Emmet County,34123,-92,260,371,-111,5,15,20,-1,422,7.6092364424,10.857795077,-3.248558635,0.14633147,0.4389944101,0.5853258802
2024,Michigan,Genesee County,401522,-401,4337,4972,-635,331,-110,221,13,5135,10.796009683,12.376702823,-1.58069314,0.8239518573,-0.273820859,0.5501309984
2024,Michigan,Gladwin County,25853,232,226,450,-224,0,456,456,0,195,8.7811322221,17.484555309,-8.703423087,0.0,17.717682714,17.717682714
2024,Michigan,Gogebic County,14224,-153,77,202,-125,3,-29,-26,-2,282,5.3844271179,14.125380231,-8.740953114,0.2097828747,-2.027901122,-1.818118248
2024,Michigan,Grand Traverse County,96421,123,893,1017,-124,54,192,246,1,2045,9.2673789299,10.55422662,-1.28684769,0.5604014135,1.992538359,2.5529397724
2024,Michigan,Gratiot County,41368,264,355,496,-141,14,390,404,1,5851,8.6089824425,12.028324765,-3.419342322,0.3395091667,9.4577553594,9.7972645261
2024,Michigan,Hillsdale County,45587,-148,446,604,-158,13,-3,10,0,1367,9.7676354,13.227918793,-3.460283393,0.2847068614,-0.065701583,0.219005278
2024,Michigan,Houghton County,37599,439,347,353,-6,146,295,441,4,4092,9.2831632312,9.4436790219,-0.160515791,3.9058842414,7.8920263781,11.797910619
2024,Michigan,Huron County,30927,-218,277,492,-215,17,-19,-2,-1,413,8.9251192164,15.852558319,-6.927439103,0.5477509988,-0.612192293,-0.064441294
2024,Michigan,Ingham County,284637,1160,2908,2556,352,1240,-434,806,2,18924,10.237381934,8.9981940244,1.2391879095,4.3653210447,-1.527862366,2.8374586791
2024,Michigan,Ionia County,66262,-574,670,591,79,11,-673,-662,9,6004,10.067769613,8.8806743903,1.1870952231,0.1652917399,-10.11284918,-9.947557439
2024,Michigan,Iosco County,25373,-100,200,468,-268,11,158,169,-1,289,7.8668921842,18.408527711,-10.54163553,0.4326790701,6.2148448256,6.6475238957
2024,Michigan,Iron County,11740,35,64,192,-128,2,161,163,0,284,5.4595862657,16.378758797,-10.91917253,0.1706120708,13.7342717,13.904883771
2024,Michigan,Isabella County,64118,-248,593,657,-64,61,-247,-186,2,4176,9.230721335,10.226954329,-0.996232994,0.9495345724,-3.844836711,-2.895302139
2024,Michigan,Jackson County,159424,-334,1611,1942,-331,78,-84,-6,3,9043,10.094554204,12.168605999,-2.074051795,0.4887493656,-0.526345471,-0.037596105
2024,Michigan,Kalamazoo County,262215,1323,2732,2412,320,842,152,994,9,7838,10.445281749,9.2218226864,1.2234590629,3.2192266592,0.5811430549,3.800369714
2024,Michigan,Kalkaska County,18490,246,184,239,-55,4,294,298,3,215,10.017967006,13.012468013,-2.994501007,0.2177818914,16.006969021,16.224750912
2024,Michigan,Kent County,661354,2434,8192,5154,3038,1838,-2453,-615,11,11826,12.409545291,7.8074702675,4.6020750238,2.7842705378,-3.715895337,-0.931624799
2024,Michigan,Keweenaw County,2172,17,10,34,-24,0,41,41,0,4,4.6221400508,15.715276173,-11.09313612,0.0,18.950774208,18.950774208
2024,Michigan,Lake County,12734,83,90,195,-105,2,186,188,0,1233,7.0908016545,15.363403585,-8.27260193,0.1575733701,14.654323419,14.811896789
2024,Michigan,Lapeer County,88977,345,769,1095,-326,82,591,673,-2,1663,8.6594710854,12.330456227,-3.670985142,0.9233766307,6.6550681553,7.578444786
2024,Michigan,Leelanau County,23019,136,187,291,-104,10,232,242,-2,181,8.1477931245,12.679186092,-4.531392968,0.4357108623,10.108492005,10.544202867
2024,Michigan,Lenawee County,97520,-760,739,1191,-452,105,-413,-308,0,4070,7.5485188968,12.165474974,-4.616956078,1.0725229826,-4.218590398,-3.146067416
2024,Michigan,Livingston County,196757,623,1629,1703,-74,34,677,711,-14,1382,8.292376257,8.6690710655,-0.376694808,0.1730759931,3.4462484506,3.6193244437
2024,Michigan,Luce County,6435,161,56,83,-27,-1,186,185,3,1249,8.812652451,13.061609883,-4.248957432,-0.157368794,29.270595641,29.113226847
2024,Michigan,Mackinac County,10851,-111,81,187,-106,48,-53,-5,0,122,7.4267638564,17.14573878,-9.718974923,4.4010452482,-4.859487462,-0.458442213
2024,Michigan,Macomb County,875101,866,8630,9376,-746,1820,-212,1608,4,7683,9.8666008131,10.719495854,-0.852895041,2.080789511,-0.242377679,1.8384118317
2024,Michigan,Manistee County,25562,197,194,357,-163,15,347,362,-2,1261,7.6187484046,14.02006794,-6.401319536,0.5890784849,13.62734895,14.216427435
2024,Michigan,Marquette County,66999,451,561,737,-176,37,582,619,8,4472,8.4015365377,11.037312706,-2.635776169,0.5541120355,8.7160325578,9.2701445933
2024,Michigan,Mason County,29159,-159,232,410,-178,14,7,21,-2,348,7.9347435744,14.022607179,-6.087863604,0.4788207329,0.2394103665,0.7182310994
2024,Michigan,Mecosta County,41099,317,414,444,-30,10,335,345,2,1005,10.11223605,10.845006778,-0.732770728,0.2442569094,8.1826064655,8.4268633749
2024,Michigan,Menominee County,22945,-280,73,313,-240,6,-44,-38,-2,359,3.162226554,13.558587828,-10.39636127,0.2599090318,-1.905999567,-1.646090535
2024,Michigan,Midland County,84039,277,862,858,4,88,188,276,-3,1099,10.274074648,10.226399128,0.0476755204,1.048861449,2.2407494592,3.2896109082
2024,Michigan,Missaukee County,15311,79,158,199,-41,9,109,118,2,167,10.346069476,13.030809023,-2.684739548,0.5893330714,7.1374783093,7.7268113807
2024,Michigan,Monroe County,155045,-190,1144,1740,-596,116,292,408,-2,1501,7.3739847879,11.215676163,-3.841691376,0.7477117442,1.8821709424,2.6298826866
2024,Michigan,Montcalm County,68154,945,678,750,-72,87,922,1009,8,5641,10.017508477,11.081314687,-1.06380621,1.2854325037,13.622629522,14.908062026
2024,Michigan,Montmorency County,9678,121,73,200,-127,1,248,249,-1,48,7.5903301274,20.795425006,-13.20509488,0.103977125,25.786327008,25.890304133
2024,Michigan,Muskegon County,176564,1025,1875,1949,-74,91,1007,1098,1,4800,10.65029267,11.070624221,-0.420331551,0.5168942043,5.7199171833,6.2368113876
2024,Michigan,Newaygo County,51108,380,493,588,-95,34,440,474,1,713,9.6822341804,11.547979104,-1.865744923,0.6677402883,8.6413449075,9.3090851958
2024,Michigan,Oakland County,1270426,-599,12666,10964,1702,6558,-8944,-2386,85,14417,9.9675342944,8.6281419551,1.3393923393,5.1608313519,-7.038498873,-1.877667521
2024,Michigan,Oceana County,26981,61,268,312,-44,66,39,105,0,423,9.9441568802,11.576779652,-1.632622771,2.4489341571,1.4470974564,3.8960316135
2024,Michigan,Ogemaw County,20990,71,179,371,-192,17,244,261,2,215,8.5423178792,17.70502756,-9.16270968,0.8112815863,11.644276886,12.455558472
2024,Michigan,Ontonagon County,5906,-15,31,102,-71,1,55,56,0,67,5.2422423269,17.248668301,-12.00642597,0.1691045912,9.3007525154,9.4698571066
2024,Michigan,Osceola County,23330,51,232,273,-41,12,80,92,0,382,9.9551588749,11.714475745,-1.75931687,0.5149220108,3.4328134051,3.9477354159
2024,Michigan,Oscoda County,8545,154,77,164,-87,2,240,242,-1,36,9.0930562116,19.367028814,-10.2739726,0.2361832782,28.341993387,28.578176665
2024,Michigan,Otsego County,25747,186,237,344,-107,15,279,294,-1,313,9.2383254073,13.409214937,-4.17088953,0.5847041397,10.875496999,11.460201138
2024,Michigan,Ottawa County,303372,2454,3121,2281,840,234,1382,1616,-2,8807,10.329477569,7.5493554419,2.7801221268,0.7744625925,4.5739628324,5.3484254249
2024,Michigan,Presque Isle County,13285,-58,89,208,-119,5,56,61,0,159,6.6846928046,15.622652847,-8.937960042,0.3755445396,4.2060988433,4.5816433829
2024,Michigan,Roscommon County,23863,181,151,442,-291,1,470,471,1,201,6.351877169,18.592911978,-12.24103481,0.0420654117,19.770743506,19.812808918
2024,Michigan,Saginaw County,187782,-591,1998,2354,-356,89,-332,-243,8,6153,10.623280297,12.516117026,-1.89283673,0.4732091824,-1.765229759,-1.292020577
2024,Michigan,St. Clair County,159874,206,1423,2079,-656,60,809,869,-7,1455,8.9064974244,13.01237396,-4.105876536,0.375537488,5.0634971303,5.4390346183
2024,Michigan,St. Joseph County,60878,100,645,734,-89,49,137,186,3,401,10.603669363,12.066811337,-1.463141974,0.8055500756,2.2522522523,3.0578023279
2024,Michigan,Sanilac County,40368,-114,396,595,-199,29,56,85,0,512,9.7959183673,14.718614719,-4.922696351,0.7173778602,1.3852813853,2.1026592455
2024,Michigan,Schoolcraft County,8149,-25,59,129,-70,7,38,45,0,142,7.2290632849,15.80591803,-8.576854745,0.8576854745,4.6560068615,5.513692336
2024,Michigan,Shiawassee County,68025,58,665,805,-140,14,189,203,-5,465,9.7799870581,11.838931702,-2.058944644,0.2058944644,2.7795752691,2.9854697335
2024,Michigan,Tuscola County,52826,-82,495,715,-220,31,107,138,0,823,9.3631187697,13.52450489,-4.16138612,0.5863771351,2.0239468856,2.6103240207
2024,Michigan,Van Buren County,75798,129,815,904,-89,95,128,223,-5,447,10.761419979,11.936593449,-1.17517347,1.2543986479,1.6901371256,2.9445357735
2024,Michigan,Washtenaw County,365536,-968,2936,2375,561,2074,-3642,-1568,39,20845,8.0214195946,6.4887164636,1.532703131,5.6663570297,-9.950275941,-4.283918912
2024,Michigan,Wayne County,1751169,-7773,20698,19095,1603,5231,-14685,-9454,78,19739,11.793359241,10.879997812,0.9133614293,2.9805325245,-8.367256762,-5.386724237
2024,Michigan,Wexford County,34122,104,340,476,-136,22,219,241,-1,430,9.9794540652,13.971235691,-3.991781626,0.6457293807,6.4279424714,7.0736718521
2024,Minnesota,Minnesota,5737915,23615,63754,49911,13843,14575,-4686,9889,-117,140494,11.133916015,8.7163924184,2.417523597,2.5453591292,-0.818356973,1.7270021564
2024,Minnesota,Aitkin County,16102,-40,101,243,-142,9,94,103,-1,324,6.2647314229,15.072571641,-8.807840218,0.5582433941,5.8305421164,6.3887855105
2024,Minnesota,Anoka County,372441,3333,4246,2629,1617,900,835,1735,-19,3233,11.451704473,7.090563132,4.3611413406,2.4273513955,2.2520426836,4.6793940792
2024,Minnesota,Becker County,35283,-80,343,411,-68,11,-23,-12,0,471,9.710387,11.6354783,-1.9250913,0.311411828,-0.651133822,-0.339721994
2024,Minnesota,Beltrami County,46718,207,574,514,60,19,127,146,1,2419,12.31376503,11.026611891,1.287153139,0.407598494,2.7244741443,3.1320726383
2024,Minnesota,Benton County,41600,91,478,401,77,124,-115,9,5,718,11.502965984,9.6499777401,1.8529882444,2.9840330169,-2.767449975,0.2165830415
2024,Minnesota,Big Stone County,5105,-44,54,77,-23,2,-23,-21,0,242,10.532475132,15.018529354,-4.486054223,0.3900916715,-4.486054223,-4.095962551
2024,Minnesota,Blue Earth County,70006,403,700,584,116,243,42,285,2,4873,10.02800679,8.366222808,1.6617839824,3.4811509287,0.6016804074,4.0828313361
2024,Minnesota,Brown County,25628,-134,268,340,-72,32,-93,-61,-1,1002,10.430044756,13.232146332,-2.802101576,1.2453784783,-3.619381203,-2.374002724
2024,Minnesota,Carlton County,36825,281,390,462,-72,15,336,351,2,2490,10.631193011,12.593874797,-1.962681787,0.4088920389,9.1591816707,9.5680737096
2024,Minnesota,Carver County,111057,937,1217,646,571,155,211,366,0,899,11.004760893,5.8414753794,5.1632855134,1.4015923898,1.9079741564,3.3095665463
2024,Minnesota,Cass County,31446,138,285,432,-147,9,276,285,0,329,9.0830863371,13.768046658,-4.684960321,0.2868343054,8.7962520317,9.0830863371
2024,Minnesota,Chippewa County,12172,-97,164,168,-4,56,-150,-94,1,390,13.420072828,13.747391678,-0.327318849,4.5824638926,-12.27445686,-7.691992963
2024,Minnesota,Chisago County,58535,637,565,535,30,19,592,611,-4,1594,9.7051523194,9.1898344971,0.5153178223,0.3263679541,10.168938359,10.495306314
2024,Minnesota,Clay County,66258,398,539,543,-4,137,264,401,1,3335,8.159372682,8.2199246128,-0.060551931,2.0739036316,3.9964274361,6.0703310677
2024,Minnesota,Clearwater County,8644,6,83,122,-39,1,45,46,-1,93,9.6053697489,14.118736257,-4.513366509,0.1157273464,5.2077305867,5.3234579331
2024,Minnesota,Cook County,5639,-82,31,47,-16,20,-85,-65,-1,43,5.4577464789,8.2746478873,-2.816901408,3.5211267606,-14.96478873,-11.44366197
2024,Minnesota,Cottonwood County,11319,-63,130,165,-35,11,-39,-28,0,319,11.453239945,14.536804546,-3.083564601,0.9691203031,-3.435971984,-2.466851681
2024,Minnesota,Crow Wing County,68304,420,637,780,-143,16,546,562,1,1313,9.3547155403,11.454753723,-2.100038183,0.2349693071,8.018327606,8.2532969131
2024,Minnesota,Dakota County,447440,4168,5038,3088,1950,1042,1193,2235,-17,3992,11.312298476,6.9337788196,4.3785196562,2.3397012727,2.6787558717,5.0184571444
2024,Minnesota,Dodge County,21088,96,268,166,102,32,-38,-6,0,120,12.737642586,7.8897338403,4.8479087452,1.5209125475,-1.80608365,-0.285171103
2024,Minnesota,Douglas County,39953,269,396,443,-47,33,285,318,-2,793,9.9451260093,11.125481874,-1.180355865,0.8287605008,7.1574770521,7.9862375529
2024,Minnesota,Faribault County,13873,-57,127,188,-61,6,-3,3,1,148,9.1357047801,13.523720462,-4.388015682,0.4316080998,-0.21580405,0.2158040499
2024,Minnesota,Fillmore County,21522,68,227,246,-19,29,59,88,-1,415,10.564035741,11.448250186,-0.884214445,1.3495904691,2.7457185406,4.0953090097
2024,Minnesota,Freeborn County,30515,-168,311,394,-83,20,-105,-85,0,498,10.163730841,12.876237786,-2.712506945,0.6536161312,-3.431484689,-2.777868558
2024,Minnesota,Goodhue County,48035,-6,486,552,-66,37,20,57,3,763,10.116990716,11.490903035,-1.373912319,0.770223573,0.4163370665,1.1865606395
2024,Minnesota,Grant County,6139,18,69,79,-10,4,25,29,-1,84,11.256117455,12.887438825,-1.63132137,0.6525285481,4.0783034258,4.7308319739
2024,Minnesota,Hennepin County,1258713,1647,14847,9452,5395,4530,-8236,-3706,-42,30038,11.803103532,7.5141735423,4.2889299895,3.6012702229,-6.547474957,-2.946204734
2024,Minnesota,Houston County,18582,-145,66,200,-134,1,-11,-10,-1,253,3.5380203168,10.721273687,-7.183253371,0.0536063684,-0.589670053,-0.536063684
2024,Minnesota,Hubbard County,22132,169,220,244,-24,12,179,191,2,269,9.9784556072,11.067014401,-1.088558794,0.5442793968,8.118834335,8.6631137317
2024,Minnesota,Isanti County,43182,471,479,435,44,19,409,428,-1,357,11.153411803,10.128881283,1.0245305205,0.4424109066,9.523476884,9.9658877906
2024,Minnesota,Itasca County,45365,171,383,659,-276,1,449,450,-3,1055,8.4585739684,14.554047637,-6.095473669,0.0220850495,9.916187237,9.9382722866
2024,Minnesota,Jackson County,9919,21,99,106,-7,12,16,28,0,110,9.9914215068,10.697885654,-0.706464147,1.2110813948,1.614775193,2.8258565878
2024,Minnesota,Kanabec County,16602,153,164,209,-45,0,199,199,-1,287,9.9240567608,12.647121116,-2.723064355,0.0,12.041995704,12.041995704
2024,Minnesota,Kandiyohi County,43813,42,527,438,89,213,-261,-48,1,1029,12.034161491,10.001826818,2.032334673,4.8639020826,-5.959992693,-1.09609061
2024,Minnesota,Kittson County,4060,-26,30,61,-31,7,-1,6,-1,109,7.3655781979,14.976675669,-7.611097471,1.7186349128,-0.245519273,1.4731156396
2024,Minnesota,Koochiching County,11751,-97,100,185,-85,1,-12,-11,-1,227,8.4749353786,15.67863045,-7.203695072,0.0847493538,-1.016992245,-0.932242892
2024,Minnesota,Lac qui Parle County,6630,-26,58,102,-44,0,20,20,-2,130,8.7309950324,15.354508505,-6.623513473,0.0,3.0106879422,3.0106879422
2024,Minnesota,Lake County,10855,-57,83,171,-88,0,30,30,1,218,7.6262231819,15.711857399,-8.085634217,0.0,2.7564662103,2.7564662103
2024,Minnesota,Lake of the Woods County,3778,-108,38,50,-12,0,-95,-95,-1,27,9.9164926931,13.048016701,-3.131524008,0.0,-24.79123173,-24.79123173
2024,Minnesota,Le Sueur County,29255,131,320,284,36,63,32,95,0,306,10.962846229,9.7295260282,1.2333202008,2.1583103513,1.0962846229,3.2545949742
2024,Minnesota,Lincoln County,5521,-55,46,102,-56,5,-3,2,-1,106,8.2905289718,18.383346851,-10.09281788,0.9011444535,-0.540686672,0.3604577814
2024,Minnesota,Lyon County,25427,-6,294,243,51,135,-193,-58,1,902,11.56114825,9.5556429414,2.0055053087,5.308690523,-7.589461266,-2.280770743
2024,Minnesota,McLeod County,36785,51,380,409,-29,51,29,80,0,661,10.337463785,11.126375495,-0.78891171,1.3873964553,0.7889117099,2.1763081652
2024,Minnesota,Mahnomen County,5280,-59,63,90,-27,1,-33,-32,0,67,11.865524061,16.950748658,-5.085224597,0.1883416518,-6.215274508,-6.026932856
2024,Minnesota,Marshall County,8810,-79,82,96,-14,2,-68,-66,1,73,9.2660602294,10.848070512,-1.582010283,0.226001469,-7.684049946,-7.458048477
2024,Minnesota,Martin County,19657,1,222,301,-79,8,75,83,-3,298,11.293974004,15.313000789,-4.019026785,0.4069900542,3.8155317579,4.2225218121
2024,Minnesota,Meeker County,23490,-36,259,243,16,16,-68,-52,0,428,11.017525949,10.336906585,0.6806193636,0.6806193636,-2.892632295,-2.212012932
2024,Minnesota,Mille Lacs County,27427,132,290,373,-83,0,214,214,1,420,10.599027813,13.63254267,-3.033514857,0.0,7.8213515588,7.8213515588
2024,Minnesota,Morrison County,34250,13,344,409,-65,4,75,79,-1,522,10.045702104,11.94387256,-1.898170456,0.1168104896,2.1901966797,2.3070071692
2024,Minnesota,Mower County,40058,8,499,441,58,227,-278,-51,1,674,12.458181455,11.010136316,1.4480451391,5.6673490787,-6.940630149,-1.273281071
2024,Minnesota,Murray County,8049,9,60,109,-49,9,50,59,-1,76,7.4585120269,13.549630182,-6.091118155,1.118776804,6.215426689,7.3342034931
2024,Minnesota,Nicollet County,34242,-101,325,293,32,58,-191,-133,0,3405,9.4772909528,8.5441423052,0.9331486477,1.6913319239,-5.569730991,-3.878399067
2024,Minnesota,Nobles County,21727,-231,309,183,126,135,-492,-357,0,516,14.146732288,8.3781618404,5.7685704475,6.1806111938,-22.52489413,-16.34428293
2024,Minnesota,Norman County,6329,-42,55,86,-31,9,-19,-10,-1,104,8.6614173228,13.543307087,-4.881889764,1.4173228346,-2.992125984,-1.57480315
2024,Minnesota,Olmsted County,164784,748,2010,1237,773,565,-596,-31,6,3118,12.225533727,7.5238732437,4.7016604829,3.4365306247,-3.625083632,-0.188553008
2024,Minnesota,Otter Tail County,60626,82,623,755,-132,20,196,216,-2,1280,10.283073368,12.461830486,-2.178757118,0.3301147149,3.2351242057,3.5652389205
2024,Minnesota,Pennington County,13714,-102,139,152,-13,9,-97,-88,-1,283,10.098074827,11.042499092,-0.944424264,0.6538321831,-7.046857973,-6.39302579
2024,Minnesota,Pine County,30197,664,300,386,-86,14,732,746,4,1565,10.045203415,12.924828394,-2.879624979,0.4687761594,24.510296334,24.979072493
2024,Minnesota,Pipestone County,9245,-82,106,133,-27,19,-73,-54,-1,146,11.415033384,14.322636227,-2.907602843,2.0460908895,-7.861296575,-5.815205686
2024,Minnesota,Polk County,30412,-313,292,373,-81,55,-288,-233,1,1293,9.5523169276,12.202103473,-2.649786545,1.7992377775,-9.421463271,-7.622225494
2024,Minnesota,Pope County,11400,-20,126,147,-21,9,-7,2,-1,133,11.042944785,12.883435583,-1.840490798,0.7887817704,-0.613496933,0.1752848379
2024,Minnesota,Ramsey County,536075,-1228,6677,4716,1961,2641,-5799,-3158,-31,17205,12.441097172,8.7872119607,3.653885211,4.9209132291,-10.80514041,-5.884227178
2024,Minnesota,Red Lake County,3911,30,46,43,3,0,29,29,-2,30,11.80698152,11.036960986,0.7700205339,0.0,7.4435318275,7.4435318275
2024,Minnesota,Redwood County,15288,-70,190,183,7,8,-86,-78,1,290,12.399660641,11.942831038,0.4568296026,0.5220909744,-5.612477974,-5.090387
2024,Minnesota,Renville County,14348,-125,134,203,-69,6,-60,-54,-2,306,9.2987751986,14.086950487,-4.788175289,0.4163630686,-4.163630686,-3.747267617
2024,Minnesota,Rice County,67948,425,671,602,69,268,85,353,3,7666,9.9061791823,8.8875109802,1.0186682021,3.95656635,1.2548811185,5.2114474685
2024,Minnesota,Rock County,9551,-3,58,121,-63,5,55,60,0,237,6.0717089767,12.666841141,-6.595132164,0.5234231876,5.7576550641,6.2810782518
2024,Minnesota,Roseau County,15252,-82,176,170,6,9,-98,-89,1,156,11.508533316,11.116196953,0.392336363,0.5885045446,-6.408160596,-5.819656052
2024,Minnesota,St. Louis County,200514,956,1844,2249,-405,80,1264,1344,17,9885,9.2183406987,11.242976264,-2.024635566,0.399928013,6.3188626047,6.7187906177
2024,Minnesota,Scott County,155814,1391,1732,888,844,411,132,543,4,1319,11.165657223,5.7246556665,5.4410015569,2.649587251,0.8509623288,3.5005495798
2024,Minnesota,Sherburne County,102206,1666,1183,697,486,96,1095,1191,-11,2573,11.669774003,6.8755980389,4.794175964,0.9469977213,10.801692758,11.74869048
2024,Minnesota,Sibley County,15084,156,186,167,19,16,124,140,-3,260,12.395041983,11.128881781,1.2661602026,1.0662401706,8.2633613221,9.3296014927
2024,Minnesota,Stearns County,160977,735,1962,1229,733,696,-708,-12,14,6779,12.215964809,7.6521002805,4.5638645286,4.3334921035,-4.408207485,-0.074715381
2024,Minnesota,Steele County,37421,-8,435,382,53,45,-109,-64,3,497,11.623246493,10.207080828,1.4161656647,1.2024048096,-2.91249165,-1.71008684
2024,Minnesota,Stevens County,9728,113,110,74,36,58,19,77,0,724,11.373623533,7.6513467404,3.7222767926,5.9970014993,1.9645349739,7.9615364731
2024,Minnesota,Swift County,9719,-52,114,93,21,26,-101,-75,2,378,11.698306824,9.543355567,2.1549512571,2.6680348897,-10.36428938,-7.696254489
2024,Minnesota,Todd County,25667,134,306,252,54,69,14,83,-3,331,11.953125,9.84375,2.109375,2.6953125,0.546875,3.2421875
2024,Minnesota,Traverse County,3136,-106,24,62,-38,3,-71,-68,0,92,7.5258701787,19.441831295,-11.91596112,0.9407337723,-22.26403261,-21.32329884
2024,Minnesota,Wabasha County,21683,31,222,218,4,7,21,28,-1,294,10.245759778,10.061151494,0.1846082843,0.3230644975,0.9691934926,1.2922579901
2024,Minnesota,Wadena County,14241,5,189,220,-31,23,14,37,-1,356,13.273870141,15.451065772,-2.177195632,1.6153386944,0.9832496401,2.5985883344
2024,Minnesota,Waseca County,18981,67,198,188,10,17,41,58,-1,1003,10.449927431,9.9221533184,0.5277741127,0.8972159916,2.163873862,3.0610898535
2024,Minnesota,Washington County,278936,2767,2796,1930,866,527,1396,1923,-22,3424,10.073769827,6.9536394016,3.1201304258,1.898739878,5.0296790697,6.9284189478
2024,Minnesota,Watonwan County,11077,-29,174,129,45,108,-181,-73,-1,159,15.687688771,11.630527882,4.057160889,9.7371861335,-16.31880269,-6.581616553
2024,Minnesota,Wilkin County,6306,-52,46,89,-43,-1,-8,-9,0,87,7.2646873026,14.055590651,-6.790903348,-0.157927985,-1.263423879,-1.421351864
2024,Minnesota,Winona County,49721,252,336,431,-95,107,236,343,4,3819,6.7748764996,8.6903921766,-1.915515677,2.157475552,4.7585442081,6.9160197601
2024,Minnesota,Wright County,151150,3032,1890,1058,832,132,2079,2211,-11,1126,12.630819199,7.0705855621,5.5602336367,0.882152452,13.893901119,14.776053571
2024,Minnesota,Yellow Medicine County,9467,-17,90,105,-15,26,-28,-2,0,113,9.4981795156,11.081209435,-1.583029919,2.7439185267,-2.954989183,-0.211070656
2024,Mississippi,Mississippi,2939690,762,34628,36032,-1404,4800,-2614,2186,-20,93920,11.781000228,12.258663516,-0.477663288,1.6330368804,-0.889324668,0.7437122126
2024,Mississippi,Adams County,28746,229,311,416,-105,459,-126,333,1,1321,10.862162304,14.529451828,-3.667289524,16.031294204,-4.400747429,11.630546775
2024,Mississippi,Alcorn County,34135,-12,383,471,-88,22,55,77,-1,670,11.218183416,13.795729475,-2.577546059,0.6443865147,1.6109662869,2.2553528016
2024,Mississippi,Amite County,12442,-117,114,218,-104,2,-14,-12,-1,72,9.1196352146,17.439302428,-8.319667213,0.1599936003,-1.119955202,-0.959961602
2024,Mississippi,Attala County,17359,-171,216,281,-65,-1,-106,-107,1,251,12.382126172,16.108228955,-3.726102783,-0.057324658,-6.076413769,-6.133738428
2024,Mississippi,Benton County,7438,-118,72,125,-53,1,-66,-65,0,64,9.6038415366,16.673336001,-7.069494464,0.133386688,-8.803521409,-8.670134721
2024,Mississippi,Bolivar County,28968,-493,407,441,-34,53,-509,-456,-3,1498,13.931438156,15.0952438,-1.163805644,1.8141676222,-17.42285509,-15.60868747
2024,Mississippi,Calhoun County,12685,-161,166,220,-54,28,-134,-106,-1,318,13.003799303,17.233950883,-4.23015158,2.1934119306,-10.49704281,-8.30363088
2024,Mississippi,Carroll County,9535,-201,72,147,-75,0,-126,-126,0,600,7.4723678065,15.256084272,-7.783716465,0.0,-13.07664366,-13.07664366
2024,Mississippi,Chickasaw County,16866,3,233,236,-3,0,5,5,1,491,13.816004032,13.993892496,-0.177888464,0.0,0.2964807732,0.2964807732
2024,Mississippi,Choctaw County,8088,-7,88,109,-21,-2,17,15,-1,195,10.875610208,13.470926281,-2.595316072,-0.247172959,2.1009701539,1.8537971946
2024,Mississippi,Claiborne County,8617,-158,104,119,-15,20,-163,-143,0,1057,11.959521619,13.684452622,-1.724931003,2.2999080037,-18.74425023,-16.44434223
2024,Mississippi,Clarke County,15228,25,178,238,-60,-1,87,86,-1,156,11.698596826,15.64194407,-3.943347245,-0.065722454,5.7178535046,5.6521310506
2024,Mississippi,Clay County,18206,-105,212,269,-57,0,-48,-48,0,240,11.611030479,14.732864145,-3.121833667,0.0,-2.628912561,-2.628912561
2024,Mississippi,Coahoma County,20077,-158,303,335,-32,165,-289,-124,-2,555,15.032744592,16.620361183,-1.587616591,8.1861480452,-14.33816233,-6.152014289
2024,Mississippi,Copiah County,27664,-48,323,368,-45,96,-96,0,-3,932,11.665703554,13.290956371,-1.625252817,3.4672060098,-3.46720601,0.0
2024,Mississippi,Covington County,18059,-83,250,276,-26,-2,-55,-57,0,271,13.811773155,15.248197564,-1.436424408,-0.110494185,-3.038590094,-3.149084279
2024,Mississippi,DeSoto County,193247,2103,1655,1712,-57,230,1946,2176,-16,879,8.6110236712,8.9075966919,-0.296573021,1.1966981537,10.125106987,11.321805141
2024,Mississippi,Forrest County,78208,232,1006,883,123,200,-92,108,1,5799,12.882241459,11.307176151,1.5750653076,2.561081801,-1.178097628,1.3829841725
2024,Mississippi,Franklin County,7610,-1,89,134,-45,2,43,45,-1,63,11.694369621,17.607253137,-5.912883516,0.2627948229,5.6500886933,5.9128835162
2024,Mississippi,George County,25619,420,384,343,41,34,344,378,1,483,15.112755323,13.499153843,1.6136014798,1.3381085442,13.538509977,14.876618521
2024,Mississippi,Greene County,13601,35,134,137,-3,-1,41,40,-2,2713,9.864909633,10.085765819,-0.220856186,-0.073618729,3.0183678728,2.9447491442
2024,Mississippi,Grenada County,21065,-69,232,310,-78,13,-3,10,-1,312,10.995521221,14.692291287,-3.696770066,0.6161283443,-0.142183464,0.4739448802
2024,Mississippi,Hancock County,46159,152,425,564,-139,33,255,288,3,219,9.2224898553,12.238786537,-3.016296682,0.7160992123,5.5334939132,6.2495931254
2024,Mississippi,Harrison County,210612,169,2435,2308,127,497,-450,47,-5,4564,11.56618494,10.962938333,0.6032466067,2.3607367209,-2.137487977,0.2232487442
2024,Mississippi,Hinds County,214870,-2685,2765,2302,463,437,-3581,-3144,-4,8204,12.7883448,10.646932994,2.1414118055,2.0211597387,-16.56240967,-14.54124993
2024,Mississippi,Holmes County,15777,-334,205,279,-74,1,-262,-261,1,893,12.857501254,17.49874561,-4.641244355,0.0627195183,-16.4325138,-16.36979428
2024,Mississippi,Humphreys County,7216,-138,97,138,-41,5,-101,-96,-1,73,13.315030885,18.943033631,-5.628002745,0.6863417982,-13.86410432,-13.17776253
2024,Mississippi,Issaquena County,1256,-6,4,13,-9,0,3,3,0,501,3.1771247021,10.325655282,-7.14853058,0.0,2.3828435266,2.3828435266
2024,Mississippi,Itawamba County,24093,122,301,317,-16,4,134,138,0,1440,12.524966711,13.190745672,-0.665778961,0.1664447403,5.5758988016,5.7423435419
2024,Mississippi,Jackson County,146389,1426,1634,1506,128,325,978,1303,-5,1417,11.216672616,10.338010379,0.8786622367,2.2309783355,6.7135286526,8.9445069881
2024,Mississippi,Jasper County,16013,-64,202,295,-93,0,28,28,1,136,12.589591773,18.385789966,-5.796198193,0.0,1.7450919289,1.7450919289
2024,Mississippi,Jefferson County,6941,-126,67,101,-34,3,-95,-92,0,333,9.5659623073,14.420331239,-4.854368932,0.4283266705,-13.5636779,-13.13535123
2024,Mississippi,Jefferson Davis County,10969,-110,118,186,-68,-1,-40,-41,-1,103,10.703918723,16.872278665,-6.168359942,-0.090711176,-3.628447025,-3.7191582
2024,Mississippi,Jones County,66250,-190,920,895,25,49,-263,-214,-1,1806,13.86690783,13.490089683,0.3768181476,0.7385635692,-3.964126912,-3.225563343
2024,Mississippi,Kemper County,8584,-86,77,126,-49,-2,-34,-36,-1,846,8.9254665585,14.605308914,-5.679842355,-0.2318303,-3.941115104,-4.172945404
2024,Mississippi,Lafayette County,58467,737,589,479,110,215,414,629,-2,5652,10.137955369,8.2446190521,1.8933363168,3.7006118919,7.1258294104,10.826441302
2024,Mississippi,Lamar County,66217,471,773,523,250,49,171,220,1,373,11.715405076,7.9264642362,3.7889408395,0.7426324045,2.5916355342,3.3342679387
2024,Mississippi,Lauderdale County,70527,-615,825,919,-94,87,-610,-523,2,2871,11.646866993,12.973903959,-1.327036966,1.2282150647,-8.611622867,-7.383407803
2024,Mississippi,Lawrence County,11741,-20,159,188,-29,-1,10,9,0,58,13.530763339,15.998638414,-2.467875074,-0.08509914,0.850991405,0.7658922645
2024,Mississippi,Leake County,21258,55,324,301,23,114,-83,31,1,374,15.261063093,14.177716022,1.0833470714,5.3696333106,-3.909469866,1.4601634441
2024,Mississippi,Lee County,82799,-25,1090,1019,71,61,-164,-103,7,1066,13.162423093,12.30505425,0.8573688437,0.7366126685,-1.980401273,-1.243788604
2024,Mississippi,Leflore County,26378,-286,382,398,-16,50,-320,-270,0,899,14.403680103,15.006975604,-0.603295502,1.8852984427,-12.06591003,-10.18061159
2024,Mississippi,Lincoln County,34702,-62,408,489,-81,17,1,18,1,478,11.746753808,14.078829931,-2.332076124,0.4894480753,0.0287910633,0.5182391386
2024,Mississippi,Lowndes County,57283,-388,729,680,49,43,-481,-438,1,1869,12.683334203,11.830819284,0.852514919,0.7481253371,-8.368564817,-7.62043948
2024,Mississippi,Madison County,112511,1240,1276,1018,258,374,607,981,1,2385,11.403955635,9.0981401543,2.3058154811,3.3425387207,5.4249224692,8.7674611899
2024,Mississippi,Marion County,24224,58,287,363,-76,-1,136,135,-1,590,11.861954949,15.003099814,-3.141144865,-0.041330853,5.6209960736,5.5796652201
2024,Mississippi,Marshall County,34123,218,339,536,-197,13,400,413,2,1991,9.9664843888,15.758217205,-5.791732816,0.3821955665,11.759863586,12.142059152
2024,Mississippi,Monroe County,33609,41,386,501,-115,-1,158,157,-1,445,11.492028522,14.915819402,-3.423790881,-0.029772095,4.7039909493,4.6742188547
2024,Mississippi,Montgomery County,9600,37,123,155,-32,-1,69,68,1,117,12.837238428,16.177007775,-3.339769347,-0.104367792,7.2013776549,7.0970098628
2024,Mississippi,Neshoba County,28789,-15,431,417,14,11,-41,-30,1,488,14.967096696,14.480926501,0.4861701943,0.3819908669,-1.42378414,-1.041793273
2024,Mississippi,Newton County,21019,-4,289,294,-5,5,-6,-1,2,899,13.748156605,13.986013986,-0.237857381,0.2378573807,-0.285428857,-0.047571476
2024,Mississippi,Noxubee County,9914,-86,151,143,8,0,-94,-94,0,146,15.165210405,14.361755549,0.8034548559,0.0,-9.440594557,-9.440594557
2024,Mississippi,Oktibbeha County,51203,-181,490,393,97,272,-556,-284,6,5641,9.5528673224,7.6617895055,1.8910778169,5.3028161463,-10.83958006,-5.536763917
2024,Mississippi,Panola County,32669,77,379,453,-74,0,151,151,0,408,11.61490017,13.88271709,-2.26781692,0.0,4.6275723633,4.6275723633
2024,Mississippi,Pearl River County,57978,795,650,778,-128,45,879,924,-1,1132,11.288543865,13.511518656,-2.222974792,0.7815145752,15.265584703,16.047099278
2024,Mississippi,Perry County,11315,-83,128,196,-68,0,-14,-14,-1,114,11.271078237,17.258838551,-5.987760313,0.0,-1.232774182,-1.232774182
2024,Mississippi,Pike County,39394,-293,516,576,-60,6,-241,-235,2,973,13.049910851,14.567342345,-1.517431494,0.1517431494,-6.095016502,-5.943273353
2024,Mississippi,Pontotoc County,31535,168,415,414,1,39,127,166,1,202,13.195128931,13.163333439,0.0317954914,1.2400241646,4.0380274077,5.2780515723
2024,Mississippi,Prentiss County,25135,244,285,336,-51,101,193,294,1,1313,11.394075081,13.433014832,-2.038939751,4.0379002918,7.7159876864,11.753887978
2024,Mississippi,Quitman County,5546,-128,59,127,-68,4,-65,-61,1,116,10.516934046,22.638146168,-12.12121212,0.7130124777,-11.58645276,-10.87344029
2024,Mississippi,Rankin County,160417,1439,1740,1341,399,223,826,1049,-9,5659,10.895599493,8.397125816,2.4984736768,1.3963900499,5.1722788397,6.5686688896
2024,Mississippi,Scott County,27507,-53,445,356,89,140,-280,-140,-2,177,16.162129769,12.929703815,3.2324259538,5.0847149836,-10.16942997,-5.084714984
2024,Mississippi,Sharkey County,3336,-126,43,78,-35,0,-91,-91,0,87,12.650779641,22.947925861,-10.29714622,0.0,-26.77258017,-26.77258017
2024,Mississippi,Simpson County,25715,92,341,361,-20,13,99,112,0,481,13.284506603,14.063656551,-0.779149947,0.5064474658,3.8567922397,4.3632397055
2024,Mississippi,Smith County,14099,17,180,203,-23,1,41,42,-2,145,12.774564423,14.406869877,-1.632305454,0.0709698023,2.9097618963,2.9807316987
2024,Mississippi,Stone County,18756,115,213,251,-38,2,152,154,-1,1249,11.391288071,13.423536647,-2.032248576,0.1069604514,8.1289943044,8.2359547557
2024,Mississippi,Sunflower County,24468,-369,285,359,-74,37,-334,-297,2,4049,11.560693642,14.562417605,-3.001723963,1.5008619815,-13.54832167,-12.04745969
2024,Mississippi,Tallahatchie County,11837,-230,134,189,-55,25,-200,-175,0,1663,11.211512718,15.813253012,-4.601740295,2.0917001339,-16.73360107,-14.64190094
2024,Mississippi,Tate County,28261,2,292,389,-97,9,87,96,3,1323,10.332625619,13.765038924,-3.432413305,0.3184713376,3.0785562633,3.3970276008
2024,Mississippi,Tippah County,21287,-151,255,306,-51,18,-118,-100,0,563,11.936805149,14.324166179,-2.38736103,0.8425980105,-5.523698069,-4.681100059
2024,Mississippi,Tishomingo County,18507,-114,205,350,-145,-2,32,30,1,290,11.04287869,18.853695324,-7.810816634,-0.107735402,1.7237664296,1.6160310278
2024,Mississippi,Tunica County,9234,-173,111,159,-48,0,-125,-125,0,82,11.909232337,17.059170645,-5.149938308,0.0,-13.41129768,-13.41129768
2024,Mississippi,Union County,28284,152,358,355,3,14,133,147,2,218,12.691435054,12.585082246,0.1063528077,0.4963131027,4.7149744753,5.211287578
2024,Mississippi,Walthall County,13863,39,177,223,-46,20,65,85,0,124,12.785783942,16.108643045,-3.322859104,1.4447213494,4.6953443855,6.1400657348
2024,Mississippi,Warren County,42298,-337,501,582,-81,70,-328,-258,2,452,11.797534527,13.704920349,-1.907385822,1.6483581176,-7.723735179,-6.075377062
2024,Mississippi,Washington County,41946,-578,565,631,-66,-1,-516,-517,5,829,13.377530484,14.940215461,-1.562684977,-0.023677045,-12.21735527,-12.24103232
2024,Mississippi,Wayne County,19703,120,260,278,-18,35,106,141,-3,84,13.236267373,14.152624345,-0.916356972,1.7818052232,5.3963243904,7.1781296136
2024,Mississippi,Webster County,9988,44,132,189,-57,0,100,100,1,144,13.245033113,18.964479229,-5.719446117,0.0,10.034115994,10.034115994
2024,Mississippi,Wilkinson County,8058,-145,100,117,-17,0,-126,-126,-2,968,12.299366583,14.390258902,-2.090892319,0.0,-15.49720189,-15.49720189
2024,Mississippi,Winston County,17416,-88,201,277,-76,4,-16,-12,0,449,11.512027491,15.864833906,-4.352806415,0.2290950745,-0.916380298,-0.687285223
2024,Mississippi,Yalobusha County,12386,-27,136,189,-53,0,27,27,-1,324,10.968184201,15.242550103,-4.274365902,0.0,2.1775071575,2.1775071575
2024,Mississippi,Yazoo County,25796,-97,289,335,-46,21,-72,-51,0,4485,11.182263151,12.962138946,-1.779875796,0.8125519937,-2.78589255,-1.973340556
2024,Missouri,Missouri,6196156,18988,68334,68389,-55,7852,11171,19023,20,162999,11.045374711,11.054264804,-0.008890093,1.2691819918,1.8056586896,3.0748406815
2024,Missouri,Adair County,25122,-29,275,256,19,101,-150,-49,1,2645,10.940266147,10.184393213,0.7558729338,4.0180613848,-5.967417898,-1.949356513
2024,Missouri,Andrew County,18127,111,169,183,-14,0,127,127,-2,129,9.3517416927,10.126442188,-0.774700495,0.0,7.027640207,7.027640207
2024,Missouri,Atchison County,5107,-54,46,93,-47,0,-7,-7,0,86,8.9598753409,18.11453058,-9.15465524,0.0,-1.363459291,-1.363459291
2024,Missouri,Audrain County,24394,-88,287,331,-44,0,-47,-47,3,1303,11.744005238,13.544479908,-1.800474671,0.0,-1.923234307,-1.923234307
2024,Missouri,Barry County,35265,321,407,488,-81,2,400,402,0,230,11.593955191,13.901351679,-2.307396488,0.0569727528,11.394550556,11.451523309
2024,Missouri,Barton County,11731,36,133,166,-33,-1,72,71,-2,20,11.354904807,14.172287202,-2.817382396,-0.085375224,6.1470161359,6.0616409118
2024,Missouri,Bates County,16242,72,179,242,-63,4,131,135,0,347,11.045291867,14.93274096,-3.887449093,0.2468221646,8.0834258916,8.3302480563
2024,Missouri,Benton County,20552,319,159,362,-203,-5,529,524,-2,273,7.7969841854,17.751624372,-9.954640186,-0.245188182,25.940909648,25.695721466
2024,Missouri,Bollinger County,10544,13,130,158,-28,0,41,41,0,223,12.336892052,14.994068802,-2.65717675,0.0,3.8908659549,3.8908659549
2024,Missouri,Boone County,189463,1742,1954,1339,615,697,424,1121,6,10751,10.360990922,7.0999830322,3.26100789,3.6958089421,2.248239586,5.944048528
2024,Missouri,Buchanan County,82956,65,989,1018,-29,151,-58,93,1,3631,11.926655291,12.276375213,-0.349719923,1.8209554589,-0.699439845,1.1215156138
2024,Missouri,Butler County,41948,-218,513,661,-148,1,-72,-71,1,952,12.19773165,15.716765342,-3.519033692,0.0237772547,-1.711962337,-1.688185082
2024,Missouri,Caldwell County,8955,16,102,131,-29,3,43,46,-1,216,11.400469431,14.641779367,-3.241309936,0.3353079244,4.8060802504,5.1413881748
2024,Missouri,Callaway County,44731,8,460,487,-27,1,35,36,-1,3074,10.284615557,10.888277774,-0.603662217,0.0223578599,0.7825250967,0.8048829566
2024,Missouri,Camden County,44044,284,366,588,-222,-2,506,504,2,603,8.3367500342,13.393467268,-5.056717234,-0.045556011,11.525670812,11.480114801
2024,Missouri,Cape Girardeau County,82984,53,897,871,26,83,-60,23,4,4300,10.812765573,10.499352078,0.3134134949,1.0005123105,-0.723261911,0.2772503993
2024,Missouri,Carroll County,8391,-29,88,114,-26,-2,-1,-3,0,108,10.469335554,13.562548331,-3.093212777,-0.237939444,-0.118969722,-0.356909167
2024,Missouri,Carter County,5303,49,84,89,-5,-1,55,54,0,43,15.913611822,16.86085062,-0.947238799,-0.18944776,10.419626788,10.230179028
2024,Missouri,Cass County,111732,1375,1199,1170,29,-7,1356,1349,-3,938,10.797473085,10.536316522,0.2611565634,-0.063037791,12.211320687,12.148282896
2024,Missouri,Cedar County,14672,71,213,226,-13,-1,84,83,1,375,14.552659447,15.44084993,-0.888190483,-0.068322345,5.7390769651,5.6707546203
2024,Missouri,Chariton County,7399,4,76,119,-43,6,41,47,0,228,10.274435582,16.087603082,-5.8131675,0.8111396512,5.5427876166,6.3539272678
2024,Missouri,Christian County,94422,1300,1045,867,178,54,1074,1128,-6,620,11.144051529,9.2458303118,1.8982212174,0.5758648637,11.453312289,12.029177153
2024,Missouri,Clark County,6641,-74,81,94,-13,0,-63,-63,2,63,12.129380054,14.07607068,-1.946690626,0.0,-9.433962264,-9.433962264
2024,Missouri,Clay County,259772,2842,2984,2072,912,378,1544,1922,8,2260,11.550177859,8.0200966902,3.5300811686,1.4631257475,5.9763654873,7.4394912348
2024,Missouri,Clinton County,21548,245,232,254,-22,-2,272,270,-3,384,10.828218711,11.855032555,-1.026813843,-0.093346713,12.695152972,12.601806259
2024,Missouri,Cole County,77278,322,812,752,60,92,171,263,-1,4170,10.529455243,9.7514166786,0.7780385648,1.192992466,2.2174099096,3.4104023756
2024,Missouri,Cooper County,16947,184,184,210,-26,0,212,212,-2,759,10.916641946,12.459210917,-1.542568971,0.0,12.577870068,12.577870068
2024,Missouri,Crawford County,22719,60,237,377,-140,7,193,200,0,470,10.445590374,16.615981313,-6.170390938,0.3085195469,8.5063246507,8.8148441976
2024,Missouri,Dade County,7716,51,61,125,-64,2,113,115,0,175,7.931863988,16.253819648,-8.32195566,0.2600611144,14.693452961,14.953514076
2024,Missouri,Dallas County,17768,181,211,255,-44,8,218,226,-1,204,11.936076934,14.425116674,-2.48903974,0.45255268,12.332060529,12.784613209
2024,Missouri,Daviess County,8551,94,115,104,11,1,83,84,-1,136,13.523047977,12.22953904,1.293508937,0.1175917215,9.7601128881,9.8777046096
2024,Missouri,DeKalb County,9899,-1411,97,134,-37,-6,-1382,-1388,14,772,9.1470602103,12.636145033,-3.489084822,-0.565797539,-130.3220331,-130.8878306
2024,Missouri,Dent County,14647,159,149,257,-108,-2,271,269,-2,193,10.228247812,17.642011327,-7.413763515,-0.137291917,18.603054745,18.465762828
2024,Missouri,Douglas County,12228,247,147,211,-64,4,310,314,-3,132,12.144243876,17.431533727,-5.287289851,0.3304556157,25.610310215,25.940765831
2024,Missouri,Dunklin County,27032,-379,349,480,-131,8,-256,-248,0,704,12.820748306,17.633120879,-4.812372573,0.293885348,-9.404331135,-9.110445787
2024,Missouri,Franklin County,106404,611,1090,1245,-155,15,754,769,-3,1052,10.273472292,11.734378903,-1.46090661,0.1413780591,7.1066037691,7.2479818282
2024,Missouri,Gasconade County,14705,-67,145,234,-89,-1,24,23,-1,250,9.8381789192,15.87678529,-6.038606371,-0.06784951,1.6283882349,1.5605387251
2024,Missouri,Gentry County,6287,13,78,94,-16,1,29,30,-1,145,12.41939336,14.966961229,-2.547567869,0.1592229918,4.6174667622,4.776689754
2024,Missouri,Greene County,304611,1414,3262,3247,15,363,1024,1387,12,9697,10.733652732,10.684295041,0.0493576919,1.194456144,3.3694851006,4.5639412446
2024,Missouri,Grundy County,9815,-29,143,154,-11,6,-23,-17,-1,272,14.548044153,15.667124472,-1.119080319,0.610407447,-2.339895213,-1.729487766
2024,Missouri,Harrison County,8220,3,84,112,-28,7,25,32,-1,133,10.22084322,13.627790959,-3.40694774,0.851736935,3.0419176249,3.8936545598
2024,Missouri,Henry County,22485,64,249,343,-94,2,157,159,-1,310,11.089832094,15.276355053,-4.186522959,0.0890749566,6.9923840912,7.0814590478
2024,Missouri,Hickory County,8718,143,92,188,-96,1,237,238,1,171,10.640143411,21.742901752,-11.10275834,0.1156537327,27.409934656,27.525588388
2024,Missouri,Holt County,4248,-6,46,76,-30,6,19,25,-1,88,10.820983298,17.878146319,-7.05716302,1.4114326041,4.4695365796,5.8809691837
2024,Missouri,Howard County,10101,-78,95,127,-32,1,-47,-46,0,842,9.3688362919,12.524654832,-3.15581854,0.0986193294,-4.635108481,-4.536489152
2024,Missouri,Howell County,40735,112,445,624,-179,-8,301,293,-2,712,10.939305293,15.339610118,-4.400304826,-0.196661668,7.3993952654,7.2027335972
2024,Missouri,Iron County,9440,27,86,186,-100,6,123,129,-2,281,9.1232164642,19.731607702,-10.60839124,0.6365034742,13.048321222,13.684824696
2024,Missouri,Jackson County,718560,2342,8531,7078,1453,1262,-385,877,12,11022,11.891735167,9.8663347222,2.0254004452,1.7591571658,-0.536668391,1.2224887753
2024,Missouri,Jasper County,125056,1040,1579,1428,151,119,763,882,7,2428,12.679064688,11.466563885,1.212500803,0.9555469904,6.126742468,7.0822894585
2024,Missouri,Jefferson County,231230,2010,2281,2327,-46,37,2022,2059,-3,1784,9.9076989901,10.107503529,-0.199804539,0.1607123466,8.7827125638,8.9434249104
2024,Missouri,Johnson County,54962,513,712,494,218,112,181,293,2,3202,13.01514473,9.030170641,3.9849740885,2.0473261372,3.3086252753,5.3559514126
2024,Missouri,Knox County,3723,-54,47,62,-15,0,-39,-39,0,106,12.533333333,16.533333333,-4.0,0.0,-10.4,-10.4
2024,Missouri,Laclede County,36680,335,470,494,-24,10,348,358,1,378,12.872304005,13.529613146,-0.657309141,0.2738788086,9.5309825402,9.8048613489
2024,Missouri,Lafayette County,33196,229,355,436,-81,-2,313,311,-1,833,10.731073258,13.179571664,-2.448498405,-0.060456751,9.4614814927,9.4010247419
2024,Missouri,Lawrence County,38872,183,494,527,-33,6,212,218,-2,522,12.738360774,13.589303903,-0.850943129,0.1547169325,5.4666649476,5.6213818801
2024,Missouri,Lewis County,9818,-68,96,144,-48,2,-21,-19,-1,980,9.7442143727,14.616321559,-4.872107186,0.2030044661,-2.131546894,-1.928542428
2024,Missouri,Lincoln County,64699,1517,813,592,221,22,1273,1295,1,736,12.714945926,9.2586076118,3.4563383145,0.3440698775,19.909134273,20.253204151
2024,Missouri,Linn County,11791,-35,135,175,-40,0,5,5,0,151,11.432442732,14.819833171,-3.387390439,0.0,0.4234238049,0.4234238049
2024,Missouri,Livingston County,14557,222,156,212,-56,5,274,279,-1,1437,10.798837048,14.675342655,-3.876505607,0.3461165721,18.967188149,19.313304721
2024,Missouri,McDonald County,23903,310,342,299,43,89,175,264,3,118,14.401212734,12.59053394,1.810678794,3.7476840155,7.3690416035,11.116725619
2024,Missouri,Macon County,15161,85,173,213,-40,5,120,125,0,200,11.442934154,14.088699276,-2.645765122,0.3307206403,7.9372953666,8.2680160069
2024,Missouri,Madison County,12698,-59,127,208,-81,10,11,21,1,415,9.978393243,16.342565311,-6.364172068,0.7857002554,0.8642702809,1.6499705362
2024,Missouri,Maries County,8430,-2,97,133,-36,6,29,35,-1,80,11.50515953,15.775115645,-4.269956114,0.7116593524,3.4396868699,4.1513462223
2024,Missouri,Marion County,28336,-153,339,387,-48,22,-126,-104,-1,1141,11.931368236,13.620765508,-1.689397272,0.7743070832,-4.43466784,-3.660360757
2024,Missouri,Mercer County,3469,3,51,50,1,6,-4,2,0,56,14.708002884,14.419610671,0.2883922134,1.7303532805,-1.153568854,0.5767844268
2024,Missouri,Miller County,25590,187,305,320,-15,-3,203,200,2,353,11.962426215,12.550742259,-0.588316043,-0.117663209,7.9618771204,7.8442139117
2024,Missouri,Mississippi County,11822,157,144,214,-70,0,226,226,1,932,12.26210244,18.222846681,-5.960744241,0.0,19.244688551,19.244688551
2024,Missouri,Moniteau County,15256,-4,199,179,20,4,-27,-23,-1,585,13.042338445,11.731550662,1.3107877835,0.2621575567,-1.769563508,-1.507405951
2024,Missouri,Monroe County,8698,63,93,123,-30,7,89,96,-3,134,10.730975596,14.192580627,-3.461605031,0.8077078405,10.269428258,11.077136099
2024,Missouri,Montgomery County,11459,-20,123,188,-65,0,44,44,1,245,10.724561862,16.392013253,-5.667451391,0.0,3.8364286337,3.8364286337
2024,Missouri,Morgan County,21970,184,260,322,-62,-3,248,245,1,343,11.884084468,14.717981534,-2.833897066,-0.137124052,11.335588262,11.198464211
2024,Missouri,New Madrid County,15424,-286,188,296,-108,-2,-174,-176,-2,275,12.07682919,19.014582129,-6.937752939,-0.128476906,-11.17749085,-11.30596775
2024,Missouri,Newton County,60677,581,692,753,-61,122,525,647,-5,1029,11.459514958,12.469674513,-1.010159556,2.0203191111,8.6939961746,10.714315286
2024,Missouri,Nodaway County,20695,-20,214,179,35,25,-80,-55,0,1928,10.335667713,8.6452547694,1.6904129437,1.207437817,-3.863801014,-2.656363197
2024,Missouri,Oregon County,8720,17,106,184,-78,1,96,97,-2,106,12.167824141,21.121506055,-8.953681915,0.1147907938,11.019916203,11.134706996
2024,Missouri,Osage County,13468,70,164,154,10,0,61,61,-1,222,12.208739671,11.464304325,0.7444353458,0.0,4.5410556093,4.5410556093
2024,Missouri,Ozark County,8970,16,83,161,-78,2,91,93,1,51,9.261325597,17.964740013,-8.703414416,0.2231644722,10.153983486,10.377147958
2024,Missouri,Pemiscot County,14613,-252,181,285,-104,16,-164,-148,0,233,12.280344664,19.336454305,-7.056109641,1.0855553294,-11.12694213,-10.0413868
2024,Missouri,Perry County,18950,72,206,221,-15,11,76,87,0,329,10.891403193,11.684466533,-0.793063339,0.5815797822,4.0181875859,4.5997673681
2024,Missouri,Pettis County,43530,133,581,504,77,87,-32,55,1,995,13.367538279,11.595936821,1.7716014587,2.0016795702,-0.736249957,1.2654296134
2024,Missouri,Phelps County,45284,11,431,541,-110,166,-44,122,-1,2798,9.5188665702,11.948275672,-2.429409101,3.6661991895,-0.971763641,2.6944355489
2024,Missouri,Pike County,17935,291,194,217,-23,0,314,314,0,1552,10.905309312,12.198206807,-1.292897496,0.0,17.650861463,17.650861463
2024,Missouri,Platte County,111940,1370,1205,866,339,207,827,1034,-3,1232,10.830973889,7.7839198238,3.047054065,1.8605905353,7.433373781,9.2939643162
2024,Missouri,Polk County,32780,121,381,409,-28,19,131,150,-1,1171,11.644432219,12.500191018,-0.855758798,0.5806934703,4.0037286633,4.5844221336
2024,Missouri,Pulaski County,53812,2,712,418,294,37,-328,-291,-1,10321,13.231495419,7.7679284905,5.4635669287,0.6875917563,-6.095408002,-5.407816246
2024,Missouri,Putnam County,4638,-24,61,85,-24,3,-3,0,0,59,13.11827957,18.279569892,-5.161290323,0.6451612903,-0.64516129,0.0
2024,Missouri,Ralls County,10489,79,99,134,-35,1,114,115,-1,92,9.4741375185,12.823580076,-3.349442557,0.0956983588,10.9096129,11.005311259
2024,Missouri,Randolph County,24109,-517,282,326,-44,2,-480,-478,5,1569,11.572791628,13.378475428,-1.8056838,0.0820765364,-19.69836873,-19.61629219
2024,Missouri,Ray County,23182,61,245,338,-93,-2,160,158,-4,218,10.582467659,14.599485994,-4.017018336,-0.086387491,6.9109992873,6.8246117962
2024,Missouri,Reynolds County,5950,-46,59,103,-44,-1,-2,-3,1,200,9.8777833584,17.244265863,-7.366482505,-0.167420057,-0.334840114,-0.502260171
2024,Missouri,Ripley County,10806,92,133,220,-87,-3,185,182,-3,109,12.360594796,20.446096654,-8.085501859,-0.278810409,17.19330855,16.914498141
2024,Missouri,St. Charles County,416659,2861,4078,3353,725,550,1602,2152,-16,5439,9.8210985036,8.0750719182,1.7460265854,1.3245718923,3.8581166755,5.1826885679
2024,Missouri,St. Clair County,9752,157,116,152,-36,5,188,193,0,192,11.991523234,15.713030444,-3.72150721,0.5168760014,19.434537654,19.951413656
2024,Missouri,Ste. Genevieve County,18642,29,182,227,-45,0,76,76,-2,743,9.7705006039,12.18628372,-2.415783116,0.0,4.0799892632,4.0799892632
2024,Missouri,St. Francois County,67058,152,654,903,-249,30,367,397,4,6294,9.7638171449,13.481233764,-3.717416619,0.4478815204,5.479083933,5.9269654534
2024,Missouri,St. Louis County,987059,-3732,10035,10364,-329,2107,-5574,-3467,64,20101,10.147382259,10.480066739,-0.332684481,2.1305963546,-5.636423389,-3.505827034
2024,Missouri,Saline County,23049,46,242,294,-52,33,66,99,-1,2258,10.509858421,12.768175106,-2.258316685,1.4331625119,2.8663250239,4.2994875358
2024,Missouri,Schuyler County,4053,53,62,59,3,5,46,51,-1,39,15.397988327,14.652924376,0.7450639513,1.2417732522,11.42431392,12.666087172
2024,Missouri,Scotland County,4676,29,83,59,24,-1,5,4,1,58,17.805427438,12.656870106,5.1485573313,-0.214523222,1.0726161107,0.8580928886
2024,Missouri,Scott County,37889,21,467,526,-59,5,73,78,2,518,12.3288937,13.886505537,-1.557611838,0.1320010032,1.9272146468,2.05921565
2024,Missouri,Shannon County,7238,22,87,124,-37,1,59,60,-1,75,12.03819012,17.157880172,-5.119690051,0.1383700014,8.1638300816,8.302200083
2024,Missouri,Shelby County,5931,-65,65,92,-27,6,-42,-36,-2,189,10.899639473,15.427182024,-4.527542551,1.0061205668,-7.042843967,-6.036723401
2024,Missouri,Stoddard County,28397,7,331,447,-116,-1,122,121,2,439,11.65759769,15.74303978,-4.085442091,-0.035219328,4.2967580608,4.2615387325
2024,Missouri,Stone County,32658,524,272,465,-193,10,711,721,-4,273,8.3960982837,14.353623904,-5.95752562,0.308680084,21.94715397,22.255834054
2024,Missouri,Sullivan County,5797,-19,66,81,-15,8,-11,-3,-1,117,11.366571945,13.949883751,-2.583311806,1.3777662964,-1.894428658,-0.516662361
2024,Missouri,Taney County,56775,26,579,721,-142,-9,174,165,3,2279,10.200486241,12.702159896,-2.501673655,-0.158556781,3.0654310983,2.9068743173
2024,Missouri,Texas County,25619,315,276,388,-112,-2,428,426,1,1809,10.839895529,15.238693714,-4.398798185,-0.078549968,16.809693066,16.731143098
2024,Missouri,Vernon County,19710,111,236,322,-86,9,189,198,-1,684,12.007428324,16.383016612,-4.375588288,0.4579104022,9.6161184462,10.074028848
2024,Missouri,Warren County,37806,516,440,422,18,-1,493,492,6,178,11.718333866,11.238947481,0.4793863854,-0.026632577,13.129860445,13.103227868
2024,Missouri,Washington County,23534,142,265,366,-101,3,241,244,-1,1018,11.294378383,15.599028257,-4.304649874,0.1278608874,10.271491284,10.399352172
2024,Missouri,Wayne County,10811,-6,116,216,-100,2,90,92,2,178,10.726835584,19.974107638,-9.247272055,0.1849454411,8.3225448493,8.5074902904
2024,Missouri,Webster County,41472,1106,609,464,145,15,945,960,1,724,14.883061658,11.339475549,3.5435861091,0.3665778734,23.094406022,23.460983895
2024,Missouri,Worth County,1907,-33,23,41,-18,0,-16,-16,1,35,11.957369379,21.315310632,-9.357941253,0.0,-8.318170003,-8.318170003
2024,Missouri,Wright County,19403,260,251,291,-40,-1,303,302,-2,202,13.023400612,15.098842941,-2.075442329,-0.051886058,15.721475639,15.669589581
2024,Missouri,St. Louis city,281754,-4439,3415,3099,316,698,-5403,-4705,-50,11017,12.02577001,10.912990121,1.1127798897,2.4579758323,-19.02642324,-16.56844741
2024,Montana,Montana,1132812,9934,11206,11377,-171,609,9485,10094,11,29307,9.9357624496,10.087379028,-0.151616579,0.5399678147,8.4098435512,8.9498113659
2024,Montana,Beaverhead County,9885,138,87,116,-29,2,165,167,0,413,8.8630806846,11.817440913,-2.954360228,0.2037489813,16.809290954,17.013039935
2024,Montana,Big Horn County,12751,-75,155,160,-5,-2,-68,-70,0,295,12.1202643,12.511240568,-0.390976268,-0.156390507,-5.317277241,-5.473667748
2024,Montana,Blaine County,6899,-73,84,69,15,0,-87,-87,-1,230,12.11159974,9.9488140725,2.1627856679,0.0,-12.54415687,-12.54415687
2024,Montana,Broadwater County,8032,261,84,87,-3,2,261,263,1,63,10.630892868,11.010567614,-0.379674745,0.2531164969,33.031702841,33.284819338
2024,Montana,Carbon County,11419,183,76,105,-29,12,199,211,1,75,6.7093356875,9.2694769367,-2.560141249,1.0593687928,17.567865813,18.627234606
2024,Montana,Carter County,1418,15,14,12,2,0,14,14,-1,20,9.9255583127,8.5076214108,1.4179369018,0.0,9.9255583127,9.9255583127
2024,Montana,Cascade County,84900,-101,948,886,62,8,-170,-162,-1,3101,11.159439909,10.429603122,0.7298367873,0.0941724887,-2.001165385,-1.906992896
2024,Montana,Chouteau County,5847,-61,34,66,-32,3,-32,-29,0,45,5.7847724373,11.229264143,-5.444491706,0.5104210974,-5.444491706,-4.934070608
2024,Montana,Custer County,11985,-15,104,147,-43,-1,29,28,0,482,8.6720867209,12.257661038,-3.585574317,-0.083385449,2.4181780279,2.3347925787
2024,Montana,Daniels County,1633,-12,15,20,-5,0,-7,-7,0,19,9.1519219036,12.202562538,-3.050640635,0.0,-4.270896888,-4.270896888
2024,Montana,Dawson County,8810,3,84,128,-44,3,45,48,-1,455,9.5362434013,14.531418516,-4.995175115,0.3405801215,5.1087018221,5.4492819436
2024,Montana,Deer Lodge County,9673,129,70,123,-53,6,174,180,2,580,7.2852162148,12.801165635,-5.51594942,0.6244471041,18.10896602,18.733413124
2024,Montana,Fallon County,2994,-56,33,33,0,-1,-55,-56,0,46,10.919920582,10.919920582,0.0,-0.330906684,-18.19986764,-18.53077432
2024,Montana,Fergus County,11772,100,104,163,-59,1,158,159,0,454,8.8722061082,13.905476881,-5.033270773,0.0853096741,13.47892851,13.564238185
2024,Montana,Flathead County,113679,1794,1157,1092,65,85,1643,1728,1,1196,10.25872923,9.682396127,0.5763331028,0.7536663652,14.567927506,15.321593871
2024,Montana,Gallatin County,126409,1471,1266,606,660,113,686,799,12,4169,10.073722782,4.8220189618,5.2517038198,0.899155351,5.4585891218,6.3577444728
2024,Montana,Garfield County,1211,-7,19,18,1,0,-8,-8,0,18,15.644298065,14.820913956,0.8233841087,0.0,-6.587072869,-6.587072869
2024,Montana,Glacier County,13609,-41,164,171,-7,1,-36,-35,1,539,12.032723137,12.546314979,-0.513591841,0.073370263,-2.641329469,-2.567959206
2024,Montana,Golden Valley County,835,9,5,17,-12,0,22,22,-1,0,6.0204695966,20.469596629,-14.44912703,0.0,26.490066225,26.490066225
2024,Montana,Granite County,3595,98,29,37,-8,0,107,107,-1,99,8.1782289904,10.43429216,-2.25606317,0.0,30.174844896,30.174844896
2024,Montana,Hill County,16276,158,233,177,56,-3,105,102,0,874,14.385380009,10.92794962,3.4574303883,-0.185219485,6.4826819781,6.2974624931
2024,Montana,Jefferson County,13048,217,110,161,-51,23,245,268,0,269,8.501101279,12.442520963,-3.941419684,1.7775029947,18.934271031,20.711774025
2024,Montana,Judith Basin County,2093,14,19,20,-1,1,16,17,-2,83,9.1083413231,9.5877277085,-0.479386385,0.4793863854,7.6701821668,8.1495685523
2024,Montana,Lake County,33338,485,311,345,-34,3,514,517,2,282,9.397047937,10.424377937,-1.02733,0.0906467647,15.530812346,15.621459111
2024,Montana,Lewis and Clark County,75011,1227,699,689,10,36,1183,1219,-2,1527,9.3954769986,9.2610638798,0.1344131187,0.4838872274,15.901071945,16.384959172
2024,Montana,Liberty County,1974,0,20,15,5,-2,-3,-5,0,260,10.131712259,7.5987841945,2.5329280648,-1.013171226,-1.519756839,-2.532928065
2024,Montana,Lincoln County,21895,385,168,308,-140,5,522,527,-2,217,7.7410436586,14.191913374,-6.450869715,0.2303882041,24.052528511,24.282916715
2024,Montana,McCone County,1676,-35,26,24,2,0,-36,-36,-1,14,15.352819604,14.171833481,1.1809861234,0.0,-21.25775022,-21.25775022
2024,Montana,Madison County,9521,269,63,103,-40,13,296,309,0,69,6.7117668993,10.9732062,-4.261439301,1.3849677729,31.534650828,32.919618601
2024,Montana,Meagher County,2071,45,22,18,4,0,42,42,-1,14,10.739565536,8.7869172565,1.9526482792,0.0,20.502806932,20.502806932
2024,Montana,Mineral County,5090,70,34,78,-44,1,111,112,2,16,6.7260138477,15.430267062,-8.704253215,0.1978239367,21.958456973,22.15628091
2024,Montana,Missoula County,121849,838,1113,940,173,76,582,658,7,3127,9.1657745203,7.741085399,1.4246891213,0.6258749897,4.7928847896,5.4187597793
2024,Montana,Musselshell County,5308,139,39,90,-51,-1,192,191,-1,47,7.4448792593,17.180490598,-9.735611339,-0.19089434,36.651713277,36.460818937
2024,Montana,Park County,17903,150,138,199,-61,4,208,212,-1,139,7.7406327126,11.162216738,-3.421584025,0.2243661656,11.66704061,11.891406776
2024,Montana,Petroleum County,554,33,11,8,3,0,31,31,-1,0,20.465116279,14.88372093,5.5813953488,0.0,57.674418605,57.674418605
2024,Montana,Phillips County,4249,21,44,55,-11,0,32,32,0,158,10.381031025,12.976288781,-2.595257756,0.0,7.5498407455,7.5498407455
2024,Montana,Pondera County,6125,33,71,60,11,6,15,21,1,195,11.623148072,9.8223786527,1.8007694197,0.9822378653,2.4555946632,3.4378325284
2024,Montana,Powder River County,1743,11,18,22,-4,0,15,15,0,21,10.35971223,12.661870504,-2.302158273,0.0,8.6330935252,8.6330935252
2024,Montana,Powell County,7133,55,41,81,-40,-1,97,96,-1,1679,5.7701780311,11.399620013,-5.629441982,-0.14073605,13.651396805,13.510660756
2024,Montana,Prairie County,1112,4,5,12,-7,3,9,12,-1,16,4.5045045045,10.810810811,-6.306306306,2.7027027027,8.1081081081,10.810810811
2024,Montana,Ravalli County,47738,561,408,581,-173,15,719,734,0,441,8.5971658853,12.242532792,-3.645366907,0.3160722752,15.150397724,15.466469999
2024,Montana,Richland County,11173,-57,144,120,24,28,-111,-83,2,66,12.855421149,10.712850957,2.1425701915,2.4996652234,-9.909387136,-7.409721912
2024,Montana,Roosevelt County,10319,-218,145,185,-40,4,-181,-177,-1,263,13.9048715,17.74069812,-3.835826621,0.3835826621,-17.35711546,-16.9735328
2024,Montana,Rosebud County,8160,8,120,115,5,23,-19,4,-1,74,14.713094654,14.100049044,0.6130456106,2.8200098087,-2.32957332,0.4904364885
2024,Montana,Sanders County,13684,300,109,209,-100,2,397,399,1,174,8.0537904537,15.442589035,-7.388798581,0.1477759716,29.333530368,29.48130634
2024,Montana,Sheridan County,3498,-57,34,58,-24,1,-33,-32,-1,68,9.6412873954,16.446902028,-6.805614632,0.2835672763,-9.357720119,-9.074152843
2024,Montana,Silver Bow County,36360,413,354,496,-142,60,495,555,0,1017,9.7915831109,13.719280291,-3.92769718,1.6595903578,13.691620452,15.351210809
2024,Montana,Stillwater County,9173,4,87,127,-40,-2,46,44,0,114,9.4864245993,13.847999128,-4.361574528,-0.218078726,5.0158107077,4.7977319812
2024,Montana,Sweet Grass County,3763,36,24,40,-16,0,51,51,1,27,6.4085447263,10.680907877,-4.272363151,0.0,13.618157543,13.618157543
2024,Montana,Teton County,6430,84,64,87,-23,1,109,110,-3,263,10.018785222,13.619286162,-3.600500939,0.1565435191,17.063243582,17.219787101
2024,Montana,Toole County,5133,56,49,67,-18,14,59,73,1,993,9.5984329089,13.124387855,-3.525954946,2.7424094025,11.557296768,14.29970617
2024,Montana,Treasure County,772,18,9,9,0,0,19,19,-1,0,11.795543906,11.795543906,0.0,0.0,24.901703801,24.901703801
2024,Montana,Valley County,7474,-68,84,89,-5,9,-72,-63,0,155,11.188066063,11.854022376,-0.665956313,1.1987213639,-9.589770911,-8.391049547
2024,Montana,Wheatland County,2057,19,26,33,-7,0,25,25,1,396,12.698412698,16.117216117,-3.418803419,0.0,12.21001221,12.21001221
2024,Montana,Wibaux County,910,-17,10,21,-11,0,-6,-6,0,27,10.887316277,22.863364181,-11.9760479,0.0,-6.532389766,-6.532389766
2024,Montana,Yellowstone County,170843,973,1822,1679,143,58,771,829,1,3923,10.695218556,9.8558023909,0.8394161655,0.3404625007,4.525803242,4.8662657427
2024,Nebraska,Nebraska,1978379,10319,24195,18496,5699,5441,-834,4607,13,47479,12.261687055,9.3735136917,2.8881733634,2.7574225777,-0.422659517,2.3347630611
2024,Nebraska,Adams County,30899,-48,386,370,16,115,-181,-66,2,902,12.482618116,11.965203894,0.5174142224,3.7189147237,-5.853248391,-2.134333667
2024,Nebraska,Antelope County,6302,-3,82,72,10,7,-19,-12,-1,56,13.00864599,11.422225748,1.5864202427,1.1104941699,-3.014198461,-1.903704291
2024,Nebraska,Arthur County,412,-13,4,5,-1,0,-12,-12,0,0,9.5579450418,11.947431302,-2.38948626,0.0,-28.67383513,-28.67383513
2024,Nebraska,Banner County,674,17,6,6,0,1,16,17,0,0,9.0157776108,9.0157776108,0.0,1.5026296018,24.042073629,25.544703231
2024,Nebraska,Blaine County,436,-16,7,8,-1,0,-14,-14,-1,0,15.765765766,18.018018018,-2.252252252,0.0,-31.53153153,-31.53153153
2024,Nebraska,Boone County,5310,-56,66,79,-13,4,-46,-42,-1,89,12.364181341,14.799550393,-2.435369052,0.7493443237,-8.617459723,-7.868115399
2024,Nebraska,Box Butte County,10692,9,110,136,-26,45,-10,35,0,125,10.292397661,12.725146199,-2.432748538,4.2105263158,-0.935672515,3.2748538012
2024,Nebraska,Boyd County,1725,-5,10,39,-29,0,25,25,-1,30,5.7887120116,22.575976845,-16.78726483,0.0,14.471780029,14.471780029
2024,Nebraska,Brown County,2853,-30,37,41,-4,4,-29,-25,-1,23,12.90097629,14.29567643,-1.394700139,1.3947001395,-10.11157601,-8.716875872
2024,Nebraska,Buffalo County,50697,165,606,428,178,49,-64,-15,2,2361,11.972853629,8.4560748402,3.5167787887,0.9681020261,-1.264459789,-0.296357763
2024,Nebraska,Burt County,6727,-43,64,88,-24,1,-20,-19,0,81,9.4835889457,13.0399348,-3.556345855,0.1481810773,-2.963621546,-2.815440468
2024,Nebraska,Butler County,8459,16,96,105,-9,0,26,26,-1,137,11.359602414,12.42456514,-1.064962726,0.0,3.0765589871,3.0765589871
2024,Nebraska,Cass County,27446,294,262,259,3,19,273,292,-1,237,9.597421151,9.4875270156,0.1098941353,0.6959961903,10.000366314,10.696362504
2024,Nebraska,Cedar County,8262,-104,84,102,-18,0,-86,-86,0,91,10.103439981,12.268462834,-2.165022853,0.0,-10.34399808,-10.34399808
2024,Nebraska,Chase County,3724,-30,42,59,-17,12,-26,-14,1,101,11.232949987,15.779620219,-4.546670233,3.2094142819,-6.953730944,-3.744316662
2024,Nebraska,Cherry County,5492,7,76,56,20,0,-14,-14,1,11,13.847134918,10.203152045,3.6439828733,0.0,-2.550788011,-2.550788011
2024,Nebraska,Cheyenne County,9541,15,103,129,-26,15,26,41,0,77,10.804006923,13.531231971,-2.727225049,1.5733990664,2.7272250485,4.300624115
2024,Nebraska,Clay County,6116,67,79,81,-2,6,66,72,-3,61,12.988080559,13.316892725,-0.328812166,0.9864364982,10.85080148,11.837237978
2024,Nebraska,Colfax County,10566,113,158,66,92,220,-197,23,-2,48,15.034016842,6.2800323517,8.7539844902,20.933441172,-18.74494505,2.1884961226
2024,Nebraska,Cuming County,8918,-35,121,113,8,13,-56,-43,0,80,13.541491802,12.646186559,0.8953052431,1.4548710201,-6.267136702,-4.812265682
2024,Nebraska,Custer County,10581,77,130,132,-2,0,81,81,-2,93,12.331041024,12.520749348,-0.189708323,0.0,7.6831870998,7.6831870998
2024,Nebraska,Dakota County,21268,152,375,180,195,163,-206,-43,0,199,17.695356738,8.4937712344,9.201585504,7.691581729,-9.720649302,-2.029067573
2024,Nebraska,Dawes County,8133,-119,80,105,-25,-2,-91,-93,-1,723,9.7650289899,12.816600549,-3.051571559,-0.244125725,-11.10772048,-11.3518462
2024,Nebraska,Dawson County,24085,180,369,241,128,247,-198,49,3,210,15.378203792,10.043759116,5.334444676,10.293811211,-8.251719108,2.0420921025
2024,Nebraska,Deuel County,1871,-30,20,23,-3,0,-26,-26,-1,0,10.604453871,12.195121951,-1.590668081,0.0,-13.78579003,-13.78579003
2024,Nebraska,Dixon County,5491,-25,60,63,-3,23,-44,-21,-1,78,10.902153175,11.447260834,-0.545107659,4.1791587172,-7.994912329,-3.815753611
2024,Nebraska,Dodge County,37187,142,489,448,41,37,63,100,1,667,13.17491109,12.070266192,1.1046448971,0.9968746632,1.6973811833,2.6942558465
2024,Nebraska,Douglas County,589540,3434,7842,4562,3280,2066,-1927,139,15,11950,13.340750532,7.7608395725,5.5799109596,3.5146634276,-3.278197689,0.2364657388
2024,Nebraska,Dundy County,1561,-34,18,15,3,0,-37,-37,0,21,11.406844106,9.5057034221,1.9011406844,0.0,-23.44740177,-23.44740177
2024,Nebraska,Fillmore County,5548,7,61,87,-26,0,32,32,1,123,11.001893769,15.691225539,-4.68933177,0.0,5.7714852557,5.7714852557
2024,Nebraska,Franklin County,2825,-25,24,49,-25,0,0,0,0,24,8.4581497797,17.268722467,-8.810572687,0.0,0.0,0.0
2024,Nebraska,Frontier County,2585,-26,19,32,-13,0,-11,-11,-2,118,7.3133179369,12.317167052,-5.003849115,0.0,-4.234026174,-4.234026174
2024,Nebraska,Furnas County,4556,-14,56,57,-1,5,-17,-12,-1,45,12.272627657,12.491781723,-0.219154065,1.0957703265,-3.72561911,-2.629848784
2024,Nebraska,Gage County,21634,70,206,337,-131,9,195,204,-3,414,9.537478587,15.602574193,-6.065095606,0.4166859577,9.0281957498,9.4448817075
2024,Nebraska,Garden County,1794,-41,17,36,-19,0,-21,-21,-1,25,9.3689721686,19.840176357,-10.47120419,0.0,-11.57343621,-11.57343621
2024,Nebraska,Garfield County,1763,-24,22,40,-18,0,-5,-5,-1,71,12.394366197,22.535211268,-10.14084507,0.0,-2.816901408,-2.816901408
2024,Nebraska,Gosper County,1847,12,17,25,-8,0,21,21,-1,32,9.2341118957,13.579576317,-4.345464422,0.0,11.406844106,11.406844106
2024,Nebraska,Grant County,565,-19,8,2,6,0,-25,-25,0,3,13.925152306,3.4812880766,10.44386423,0.0,-43.51610096,-43.51610096
2024,Nebraska,Greeley County,2219,-16,26,25,1,0,-16,-16,-1,23,11.674898967,11.225864392,0.4490345757,0.0,-7.184553211,-7.184553211
2024,Nebraska,Hall County,62197,101,923,603,320,333,-557,-224,5,1027,14.852002929,9.7028794864,5.1491234422,5.358306582,-8.962692992,-3.60438641
2024,Nebraska,Hamilton County,9537,98,108,108,0,0,100,100,-2,96,11.382799325,11.382799325,0.0,0.0,10.539629005,10.539629005
2024,Nebraska,Harlan County,3045,13,32,56,-24,3,37,40,-3,49,10.531512259,18.430146454,-7.898634195,0.9873292743,12.17706105,13.164390324
2024,Nebraska,Hayes County,846,-18,10,8,2,7,-27,-20,0,0,11.695906433,9.3567251462,2.3391812865,8.1871345029,-31.57894737,-23.39181287
2024,Nebraska,Hitchcock County,2552,-62,29,45,-16,0,-47,-47,1,33,11.22725513,17.421602787,-6.194347658,0.0,-18.19589624,-18.19589624
2024,Nebraska,Holt County,10093,80,129,123,6,35,39,74,0,109,12.831990451,12.235153685,0.5968367651,3.4815477967,3.8794389734,7.3609867701
2024,Nebraska,Hooker County,679,-3,6,11,-5,0,2,2,0,3,8.8170462895,16.164584864,-7.347538575,0.0,2.9390154298,2.9390154298
2024,Nebraska,Howard County,6527,18,78,89,-11,6,23,29,0,111,11.966861,13.654495244,-1.687634244,0.9205277693,3.5286897821,4.4492175514
2024,Nebraska,Jefferson County,7054,-86,78,124,-46,5,-46,-41,1,104,10.990559391,17.47217134,-6.481611949,0.7045230379,-6.481611949,-5.777088911
2024,Nebraska,Johnson County,5198,-47,37,67,-30,9,-26,-17,0,1108,7.0860863736,12.831561812,-5.745475438,1.7236426314,-4.979412046,-3.255769415
2024,Nebraska,Kearney County,6770,64,80,73,7,24,32,56,1,63,11.872959335,10.834075393,1.0388839418,3.5618878005,4.749183734,8.3110715346
2024,Nebraska,Keith County,8113,-66,81,130,-49,0,-16,-16,-1,49,9.9435305671,15.958752762,-6.015222195,0.0,-1.964154186,-1.964154186
2024,Nebraska,Keya Paha County,805,0,5,6,-1,0,1,1,0,0,6.2111801242,7.4534161491,-1.242236025,0.0,1.2422360248,1.2422360248
2024,Nebraska,Kimball County,3289,-47,26,49,-23,9,-32,-23,-1,69,7.8490566038,14.79245283,-6.943396226,2.7169811321,-9.660377358,-6.943396226
2024,Nebraska,Knox County,8298,-9,83,120,-37,3,27,30,-2,118,9.9969888588,14.453477868,-4.456489009,0.3613369467,3.2520325203,3.613369467
2024,Nebraska,Lancaster County,326716,2282,3664,2529,1135,1088,43,1131,16,13244,11.253935345,7.7677954388,3.4861399063,3.3417799278,0.1320740229,3.4738539507
2024,Nebraska,Lincoln County,33365,-249,343,481,-138,15,-127,-112,1,595,10.242016154,14.3627107,-4.120694546,0.4479015811,-3.792233387,-3.344331805
2024,Nebraska,Logan County,655,-30,6,4,2,1,-34,-33,1,0,8.9552238806,5.9701492537,2.9850746269,1.4925373134,-50.74626866,-49.25373134
2024,Nebraska,Loup County,592,-9,3,5,-2,0,-6,-6,-1,0,5.0293378039,8.3822296731,-3.352891869,0.0,-10.05867561,-10.05867561
2024,Nebraska,McPherson County,383,4,4,0,4,0,-1,-1,1,0,10.498687664,0.0,10.498687664,0.0,-2.624671916,-2.624671916
2024,Nebraska,Madison County,35627,213,466,368,98,35,80,115,0,1417,13.119184696,10.360214524,2.7589701722,0.9853464901,2.2522205487,3.2375670388
2024,Nebraska,Merrick County,7755,40,86,98,-12,8,45,53,-1,157,11.118293471,12.669683258,-1.551389787,1.0342598578,5.8177117001,6.8519715579
2024,Nebraska,Morrill County,4504,-18,57,74,-17,5,-6,-1,0,94,12.630179481,16.397075116,-3.766895635,1.1079104808,-1.329492577,-0.221582096
2024,Nebraska,Nance County,3274,-43,38,57,-19,0,-24,-24,0,102,11.530875436,17.296313154,-5.765437718,0.0,-7.28265817,-7.28265817
2024,Nebraska,Nemaha County,7076,40,82,95,-13,1,53,54,-1,467,11.621315193,13.463718821,-1.842403628,0.141723356,7.5113378685,7.6530612245
2024,Nebraska,Nuckolls County,4095,26,43,57,-14,0,41,41,-1,45,10.534051935,13.963743263,-3.429691328,0.0,10.044096031,10.044096031
2024,Nebraska,Otoe County,16335,149,197,200,-3,81,71,152,0,243,12.115248609,12.29974478,-0.184496172,4.981396636,4.366409397,9.347806033
2024,Nebraska,Pawnee County,2512,-19,31,43,-12,2,-9,-7,0,30,12.294269284,17.053341265,-4.759071981,0.7931786635,-3.569303986,-2.776125322
2024,Nebraska,Perkins County,2795,-32,24,38,-14,13,-32,-19,1,0,8.537886873,13.518320882,-4.980434009,4.6246887229,-11.38384916,-6.759160441
2024,Nebraska,Phelps County,9057,69,117,114,3,7,60,67,-1,205,12.967581047,12.635078969,0.3325020781,0.7758381823,6.6500415628,7.4258797451
2024,Nebraska,Pierce County,7299,-18,93,77,16,20,-55,-35,1,72,12.725779967,10.536398467,2.1893814997,2.7367268747,-7.525998905,-4.789272031
2024,Nebraska,Platte County,34609,254,454,306,148,161,-55,106,0,353,13.166289658,8.8741952323,4.2920944261,4.6691027203,-1.595035091,3.0740676295
2024,Nebraska,Polk County,5228,-12,54,76,-22,16,-4,12,-2,93,10.31715705,14.520443256,-4.203286206,3.0569354222,-0.764233856,2.2927015667
2024,Nebraska,Red Willow County,10457,-71,108,163,-55,3,-19,-16,0,302,10.293066476,15.534905885,-5.241839409,0.2859185132,-1.81081725,-1.524898737
2024,Nebraska,Richardson County,7689,-41,71,121,-50,-1,8,7,2,150,9.2094169531,15.69492185,-6.485504897,-0.129710098,1.0376807834,0.9079706855
2024,Nebraska,Rock County,1271,30,15,25,-10,0,39,39,1,31,11.942675159,19.904458599,-7.961783439,0.0,31.050955414,31.050955414
2024,Nebraska,Saline County,14555,7,172,134,38,59,-91,-32,1,858,11.820087276,9.2086726454,2.6114146308,4.0545648215,-6.253650826,-2.199086005
2024,Nebraska,Sarpy County,199886,3459,2363,1278,1085,301,2069,2370,4,1247,11.924917931,6.449447785,5.4754701461,1.5190013954,10.44124215,11.960243545
2024,Nebraska,Saunders County,23463,286,244,241,3,5,280,285,-2,335,10.463121784,10.334476844,0.12864494,0.2144082333,12.006861063,12.221269297
2024,Nebraska,Scotts Bluff County,35699,-70,433,434,-1,77,-146,-69,0,1012,12.117311244,12.145295797,-0.027984553,2.1548105446,-4.085744669,-1.930934124
2024,Nebraska,Seward County,17671,46,172,191,-19,2,63,65,0,1282,9.7461468722,10.82275612,-1.076609248,0.1133272892,3.5698096102,3.6831368994
2024,Nebraska,Sheridan County,4928,-78,46,71,-25,4,-57,-53,0,156,9.2611234145,14.294342662,-5.033219247,0.8053150795,-11.47573988,-10.6704248
2024,Nebraska,Sherman County,2983,-23,32,39,-7,0,-17,-17,1,50,10.68625814,13.023877108,-2.337618968,0.0,-5.677074637,-5.677074637
2024,Nebraska,Sioux County,1154,27,12,13,-1,5,23,28,0,0,10.521701008,11.398509426,-0.876808417,4.3840420868,20.166593599,24.550635686
2024,Nebraska,Stanton County,5856,91,62,46,16,0,77,77,-2,73,10.670338181,7.9167025213,2.7536356596,0.0,13.251871612,13.251871612
2024,Nebraska,Thayer County,4829,-25,50,88,-38,1,13,14,-1,90,10.327377879,18.176185067,-7.848807188,0.2065475576,2.6851182485,2.8916658061
2024,Nebraska,Thomas County,677,12,8,11,-3,0,16,16,-1,0,11.922503726,16.393442623,-4.470938897,0.0,23.845007452,23.845007452
2024,Nebraska,Thurston County,6557,2,132,109,23,6,-28,-22,1,101,20.134228188,16.625991458,3.5082367297,0.9151921904,-4.270896888,-3.355704698
2024,Nebraska,Valley County,4012,-46,51,57,-6,0,-38,-38,-2,29,12.639405204,14.126394052,-1.486988848,0.0,-9.417596035,-9.417596035
2024,Nebraska,Washington County,21152,-15,205,211,-6,12,-21,-9,0,153,9.6883196673,9.9718802429,-0.283560576,0.5671211513,-0.992462015,-0.425340863
2024,Nebraska,Wayne County,9874,-25,107,72,35,10,-70,-60,0,1319,10.822839225,7.2826581702,3.540181055,1.0114803014,-7.08036211,-6.068881809
2024,Nebraska,Webster County,3351,12,33,64,-31,0,42,42,1,67,9.865470852,19.13303438,-9.267563528,0.0,12.556053812,12.556053812
2024,Nebraska,Wheeler County,775,-7,13,8,5,0,-11,-11,-1,0,16.698779705,10.276172126,6.4226075787,0.0,-14.12973667,-14.12973667
2024,Nebraska,York County,14356,44,161,185,-24,11,58,69,-1,839,11.232035719,12.906376448,-1.674340728,0.7674061672,4.0463234268,4.813729594
2024,Nevada,Nevada,3194176,16755,33055,29322,3733,4266,8642,12908,114,35093,10.375734686,9.2039719398,1.1717627465,1.3390677408,2.7126637168,4.0517314576
2024,Nevada,Churchill County,25803,5,280,376,-96,-4,106,102,-1,387,10.852502858,14.573360981,-3.720858123,-0.155035755,4.1084475107,3.9534117556
2024,Nevada,Clark County,2336573,14038,24876,20042,4834,3693,5404,9097,107,19667,10.678438877,8.6033635623,2.0750753148,1.5852819896,2.3197573441,3.9050393337
2024,Nevada,Douglas County,49545,-117,326,613,-287,-2,172,170,0,223,6.5721168869,12.357998932,-5.785882045,-0.040319736,3.4674972532,3.4271775177
2024,Nevada,Elko County,54293,314,566,495,71,-15,253,238,5,612,10.455149993,9.1436382444,1.3115117482,-0.277079947,4.6734151027,4.3963351559
2024,Nevada,Esmeralda County,736,-11,3,12,-9,1,-3,-2,0,1,4.0458530007,16.183412003,-12.137559,1.3486176669,-4.045853001,-2.697235334
2024,Nevada,Eureka County,1917,54,18,28,-10,6,59,65,-1,0,9.5238095238,14.814814815,-5.291005291,3.1746031746,31.216931217,34.391534392
2024,Nevada,Humboldt County,17136,-160,198,202,-4,7,-162,-155,-1,69,11.500929368,11.733271375,-0.232342007,0.406598513,-9.409851301,-9.003252788
2024,Nevada,Lander County,5769,8,60,74,-14,-1,23,22,0,42,10.407632264,12.836079792,-2.428447528,-0.173460538,3.9895923677,3.81613183
2024,Nevada,Lincoln County,4452,12,30,69,-39,0,51,51,0,210,6.7476383266,15.519568151,-8.771929825,0.0,11.470985155,11.470985155
2024,Nevada,Lyon County,62583,955,633,835,-202,-30,1188,1158,-1,255,10.192334012,13.444863981,-3.252529969,-0.483049005,19.128740611,18.645691605
2024,Nevada,Mineral County,4528,-9,35,88,-53,-1,45,44,0,57,7.722007722,19.415333701,-11.69332598,-0.220628792,9.9282956426,9.7076668505
2024,Nevada,Nye County,55720,951,368,991,-623,-21,1592,1571,3,1375,6.6612965997,17.938437311,-11.27714071,-0.380128339,28.817348333,28.437219995
2024,Nevada,Pershing County,6364,-86,50,90,-40,5,-51,-46,0,1438,7.8039644139,14.047135945,-6.243171531,0.7803964414,-7.960043702,-7.179647261
2024,Nevada,Storey County,4177,12,18,49,-31,0,45,45,-2,0,4.3155118677,11.747782306,-7.432270439,0.0,10.788779669,10.788779669
2024,Nevada,Washoe County,498022,1042,5003,4333,670,613,-241,372,0,7282,10.056261193,8.7095302321,1.3467309613,1.2321583273,-0.484421137,0.7477371905
2024,Nevada,White Pine County,8522,-224,67,111,-44,-3,-178,-181,1,540,7.7600185314,12.856150104,-5.096131573,-0.347463516,-20.61616864,-20.96363215
2024,Nevada,Carson City,58036,-29,524,914,-390,18,339,357,4,2935,9.026623371,15.744911758,-6.718288387,0.3100748486,5.8397429824,6.149817831
2024,New Hampshire,New Hampshire,1402054,3051,12155,14264,-2109,859,4298,5157,3,41525,8.678866585,10.184726694,-1.505860109,0.6133398928,3.0688415123,3.6821814051
2024,New Hampshire,Belknap County,65027,322,458,831,-373,-21,717,696,-1,898,7.0607097709,12.811025807,-5.750316036,-0.323744334,11.053556563,10.729812228
2024,New Hampshire,Carroll County,52448,294,310,658,-348,4,638,642,0,567,5.9272289249,12.581021395,-6.653792471,0.0764803732,12.198619529,12.275099902
2024,New Hampshire,Cheshire County,77703,240,656,883,-227,5,463,468,-1,3560,8.4554606035,11.381359318,-2.925898715,0.0644471083,5.9678022247,6.032249333
2024,New Hampshire,Coos County,31372,-104,224,569,-345,1,240,241,0,1415,7.1283095723,18.107179226,-10.97886965,0.0318228106,7.6374745418,7.6692973523
2024,New Hampshire,Grafton County,93146,15,662,978,-316,82,250,332,-1,7570,7.107694455,10.500491204,-3.392796749,0.8804092829,2.6841746431,3.5645839261
2024,New Hampshire,Hillsborough County,427354,-139,4170,3952,218,593,-956,-363,6,8463,9.756131799,9.2460990095,0.5100327895,1.3873827714,-2.236657554,-0.849274783
2024,New Hampshire,Merrimack County,157103,644,1298,1603,-305,60,884,944,5,7633,8.2790644274,10.224453218,-1.945388791,0.3826994342,5.6384383312,6.0211377654
2024,New Hampshire,Rockingham County,320689,1056,2877,2945,-68,80,1053,1133,-9,2720,8.9861038665,9.1984970062,-0.21239314,0.249874282,3.2889702368,3.5388445189
2024,New Hampshire,Strafford County,133243,672,1155,1309,-154,36,787,823,3,7907,8.6902871933,9.8489921524,-1.158704959,0.2708660943,5.9214337845,6.1922998789
2024,New Hampshire,Sullivan County,43969,51,345,536,-191,19,222,241,1,792,7.8509904764,12.197480856,-4.34649038,0.4323733886,5.0519416979,5.4843150864
2024,New Jersey,New Jersey,9290841,30024,102055,76563,25492,49298,-44666,4632,-100,168097,11.00225112,8.2540331436,2.748217976,5.3146732222,-4.815310847,0.4993623751
2024,New Jersey,Atlantic County,275213,-169,2779,2998,-219,924,-881,43,7,5781,10.094534095,10.890037142,-0.795503047,3.356369019,-3.200174357,0.1561946621
2024,New Jersey,Bergen County,957736,4196,9117,6960,2157,4778,-2728,2050,-11,10601,9.54022339,7.2830925518,2.2571308382,4.9998011799,-2.854637425,2.1451637545
2024,New Jersey,Burlington County,469167,3066,4731,4254,477,849,1751,2600,-11,11304,10.116886283,9.096857799,1.0200284838,1.8155223957,3.7443812896,5.5599036854
2024,New Jersey,Camden County,527196,2547,6227,5011,1216,1171,152,1323,8,6432,11.84014755,9.5280198128,2.3121277375,2.2265637998,0.2890159672,2.515579767
2024,New Jersey,Cape May County,94610,-795,744,1383,-639,37,-188,-151,-5,1330,7.8309607136,14.55674552,-6.725784806,0.3894429387,-1.978791148,-1.589348209
2024,New Jersey,Cumberland County,152326,979,1857,1717,140,447,382,829,10,9187,12.23026084,11.308216404,0.922044436,2.9439561634,2.5158641038,5.4598202672
2024,New Jersey,Essex County,851117,1393,9950,6183,3767,7484,-9874,-2390,16,24634,11.700094247,7.2705208776,4.4295733699,8.8003522963,-11.61072669,-2.810374397
2024,New Jersey,Gloucester County,308423,1656,3057,2884,173,323,1178,1501,-18,7626,9.9383930168,9.375965149,0.5624278678,1.0500820885,3.8297111461,4.8797932346
2024,New Jersey,Hudson County,705472,3091,8855,3986,4869,9343,-10956,-1613,-165,7920,12.579438336,5.6625230049,6.9169153314,13.272692533,-15.56412495,-2.291432415
2024,New Jersey,Hunterdon County,130183,378,1116,1004,112,214,68,282,-16,2972,8.5850116159,7.7234333892,0.8615782267,1.646229826,0.5231010662,2.1693308922
2024,New Jersey,Mercer County,381671,892,4130,3145,985,2761,-2892,-131,38,15396,10.833497279,8.2497212932,2.5837759853,7.2424421274,-7.586071218,-0.34362909
2024,New Jersey,Middlesex County,863623,2529,8603,6134,2469,7001,-7000,1,59,22266,9.9761294172,7.1130510107,2.8630784065,8.118433343,-8.117273732,0.0011596105
2024,New Jersey,Monmouth County,642799,-1429,6315,5769,546,924,-2915,-1991,16,6785,9.8133139398,8.9648468913,0.8484670485,1.4358673128,-4.529819499,-3.093952186
2024,New Jersey,Morris County,514423,3204,5024,3951,1073,2013,135,2148,-17,8170,9.796790693,7.7044426808,2.0923480123,3.9253462709,0.2632497499,4.1885960208
2024,New Jersey,Ocean County,659197,3534,10251,7528,2723,628,200,828,-17,6604,15.592534566,11.450648738,4.1418858281,0.9552347778,0.3042148974,1.2594496753
2024,New Jersey,Passaic County,513395,-239,6332,3852,2480,3661,-6396,-2735,16,9175,12.330713154,7.5012487476,4.8294644066,7.1293020937,-12.45534449,-5.3260424
2024,New Jersey,Salem County,65338,181,721,808,-87,41,229,270,-2,768,11.05023181,12.383616231,-1.333384421,0.6283765662,3.5097130158,4.138089582
2024,New Jersey,Somerset County,348842,1795,3190,2494,696,1750,-641,1109,-10,3975,9.1681288251,7.1678098087,2.0003190164,5.0295377567,-1.84224783,3.187289927
2024,New Jersey,Sussex County,146132,557,1416,1358,58,121,392,513,-14,464,9.7083717566,9.3107124615,0.3976592951,0.8295995639,2.6876283394,3.5172279033
2024,New Jersey,Union County,572726,2309,6624,4013,2611,4646,-4975,-329,27,5213,11.589101276,7.0209938739,4.5681074021,8.1284668672,-8.704072894,-0.575606027
2024,New Jersey,Warren County,111252,349,1016,1131,-115,182,293,475,-11,1494,9.146766897,10.182080079,-1.035313182,1.6384956449,2.6377979339,4.2762935788
2024,New Mexico,New Mexico,2114371,895,20728,22344,-1616,3642,-1088,2554,-43,43081,9.805463632,10.569918921,-0.764455289,1.7228627242,-0.514682769,1.2081799554
2024,New Mexico,Bernalillo County,671586,-1371,6473,6250,223,1603,-3170,-1567,-27,11219,9.6285503699,9.2968391491,0.3317112208,2.384453305,-4.715356816,-2.330903511
2024,New Mexico,Catron County,3825,32,22,73,-51,15,68,83,0,41,5.7757941717,19.165135206,-13.38934103,3.9380414807,17.852454713,21.790496193
2024,New Mexico,Chaves County,63561,-331,738,764,-26,88,-395,-307,2,2121,11.580739567,11.988733102,-0.407993535,1.380901195,-6.198363318,-4.817462123
2024,New Mexico,Cibola County,26780,-91,225,368,-143,17,33,50,2,2253,8.3875417047,13.718290433,-5.330748728,0.6337253732,1.2301727834,1.8638981566
2024,New Mexico,Colfax County,12255,-17,85,175,-90,25,48,73,0,632,6.9311371142,14.269988176,-7.338851062,2.0385697395,3.9140538998,5.9526236393
2024,New Mexico,Curry County,47222,-208,754,531,223,53,-479,-426,-5,833,15.93204581,11.220048176,4.7119976334,1.1198918142,-10.1212864,-9.001394582
2024,New Mexico,De Baca County,1657,-35,14,39,-25,0,-10,-10,0,2,8.360704688,23.290534488,-14.9298298,0.0,-5.97193192,-5.97193192
2024,New Mexico,Doña Ana County,225210,1680,2285,2008,277,342,1049,1391,12,4612,10.184070954,8.949503053,1.2345679012,1.5242679503,4.6753130989,6.1995810492
2024,New Mexico,Eddy County,60275,72,734,726,8,25,41,66,-2,945,12.184797224,12.051992895,0.1328043294,0.4150135294,0.6806221883,1.0956357177
2024,New Mexico,Grant County,27472,-221,214,405,-191,29,-55,-26,-4,661,7.7585425542,14.683223058,-6.924680504,1.0513912807,-1.994017946,-0.942626665
2024,New Mexico,Guadalupe County,4292,-24,23,59,-36,10,2,12,0,612,5.343866171,13.708178439,-8.364312268,2.3234200743,0.4646840149,2.7881040892
2024,New Mexico,Harding County,624,3,0,15,-15,1,18,19,-1,0,0.0,24.096385542,-24.09638554,1.6064257028,28.915662651,30.522088353
2024,New Mexico,Hidalgo County,3965,-46,43,61,-18,3,-30,-27,-1,72,10.782347041,15.295887663,-4.513540622,0.7522567703,-7.522567703,-6.770310933
2024,New Mexico,Lea County,72101,-242,810,688,122,223,-590,-367,3,2134,11.215419124,9.5261831575,1.6892359669,3.0877018083,-8.169255905,-5.081554097
2024,New Mexico,Lincoln County,20029,-314,181,306,-125,-11,-174,-185,-4,115,8.9666105221,15.159021104,-6.192410582,-0.544932131,-8.61983553,-9.164767661
2024,New Mexico,Los Alamos County,19444,171,170,135,35,130,6,136,0,65,8.7816721337,6.973680812,1.8079913216,6.7153963375,0.3099413694,7.025337707
2024,New Mexico,Luna County,25316,-377,326,403,-77,39,-338,-299,-1,788,12.782058068,15.801133133,-3.019075065,1.5291419161,-13.25256327,-11.72342136
2024,New Mexico,McKinley County,68797,-1134,756,905,-149,66,-1053,-987,2,875,10.899025431,13.047113777,-2.148088346,0.9515022202,-15.18078542,-14.2292832
2024,New Mexico,Mora County,4123,-24,28,56,-28,0,5,5,-1,2,6.7714631197,13.542926239,-6.77146312,0.0,1.2091898428,1.2091898428
2024,New Mexico,Otero County,68835,318,687,774,-87,232,170,402,3,3659,10.003494671,11.270312773,-1.266818102,3.3781816064,2.4753916943,5.8535733007
2024,New Mexico,Quay County,8510,-19,62,164,-102,0,86,86,-3,55,7.2774223839,19.249955983,-11.9725336,0.0,10.094489113,10.094489113
2024,New Mexico,Rio Arriba County,39876,-115,405,535,-130,71,-54,17,-2,216,10.141860844,13.397272966,-3.255412123,1.7779558516,-1.352248112,0.4257077391
2024,New Mexico,Roosevelt County,18787,-71,228,208,20,-14,-77,-91,0,1032,12.113162439,11.05060433,1.0625581086,-0.743790676,-4.090848718,-4.834639394
2024,New Mexico,Sandoval County,155936,2339,1307,1378,-71,134,2280,2414,-4,1050,8.4449800183,8.9037356275,-0.458755609,0.8658204456,14.731870269,15.597690715
2024,New Mexico,San Juan County,120675,106,1326,1490,-164,72,195,267,3,1311,10.993019516,12.352638822,-1.359619307,0.596906037,1.616620517,2.213526554
2024,New Mexico,San Miguel County,26668,-234,223,371,-148,39,-126,-87,1,1056,8.3255553481,13.851036028,-5.525480679,1.4560388277,-4.704125443,-3.248086616
2024,New Mexico,Santa Fe County,155956,195,1129,1418,-289,337,156,493,-9,2690,7.2437499398,9.0979959386,-1.854245999,2.1622176526,1.0009078748,3.1631255273
2024,New Mexico,Sierra County,11488,14,67,269,-202,-2,221,219,-3,174,5.8357285951,23.430014807,-17.59428621,-0.174200854,19.249194321,19.074993467
2024,New Mexico,Socorro County,15963,-148,152,212,-60,1,-90,-89,1,849,9.4780819355,13.219430068,-3.741348132,0.0623558022,-5.612022199,-5.549666396
2024,New Mexico,Taos County,34405,-185,235,394,-159,22,-46,-24,-2,234,6.8120878325,11.421117472,-4.60902964,0.6377273715,-1.333429959,-0.695702587
2024,New Mexico,Torrance County,15633,250,154,238,-84,0,336,336,-2,296,9.9303585246,15.34691772,-5.416559195,0.0,21.666236781,21.666236781
2024,New Mexico,Union County,3964,-18,35,59,-24,0,7,7,-1,450,8.8094638812,14.850239114,-6.040775233,0.0,1.7618927762,1.7618927762
2024,New Mexico,Valencia County,79141,940,837,867,-30,92,878,970,0,2027,10.639244448,11.020579375,-0.381334926,1.1694271078,11.160402181,12.329829289
2024,New York,New York,19571216,-101984,207450,165914,41536,73867,-216778,-142911,-609,616970,10.572204718,8.455419492,2.1167852262,3.7644591271,-11.04758445,-7.283125324
2024,New York,Albany County,316659,738,2861,2943,-82,1140,-328,812,8,19426,9.0454962218,9.3047519681,-0.259255746,3.6042872048,-1.037022985,2.5672642195
2024,New York,Allegany County,46651,-75,496,540,-44,22,-54,-32,1,5221,10.623601101,11.566017328,-0.942416227,0.4712081133,-1.156601733,-0.685393619
2024,New York,Bronx County,1356476,-25332,16614,10648,5966,10224,-41473,-31249,-49,53988,12.134606929,7.7771334164,4.3574735126,7.4674504179,-30.29123349,-22.82378307
2024,New York,Broome County,196077,-1181,1873,2326,-453,455,-1189,-734,6,13152,9.5236884589,11.827068529,-2.30338007,2.3135495189,-6.045737094,-3.732187575
2024,New York,Cattaraugus County,75600,-450,791,1102,-311,27,-170,-143,4,2754,10.431915595,14.533465216,-4.101549621,0.3560830861,-2.242004616,-1.88592153
2024,New York,Cayuga County,74485,-194,669,877,-208,27,-13,14,0,3305,8.9699927596,11.758869432,-2.788876673,0.362017645,-0.174304792,0.187712853
2024,New York,Chautauqua County,124891,-453,1273,1765,-492,70,-29,41,-2,4653,10.17443603,14.106739665,-3.932303635,0.5594740944,-0.231782125,0.3276919695
2024,New York,Chemung County,81325,-316,820,1073,-253,87,-150,-63,0,3240,10.063448818,13.168390953,-3.104942135,1.0677073745,-1.840874784,-0.773167409
2024,New York,Chenango County,45920,-411,473,650,-177,2,-239,-237,3,796,10.254631386,14.091988163,-3.837356777,0.0433599636,-5.181515648,-5.138155684
2024,New York,Clinton County,78115,78,676,813,-137,74,139,213,2,4682,8.6582304421,10.41293099,-1.754700548,0.9477944567,1.7803166146,2.7281110713
2024,New York,Columbia County,60470,-638,463,721,-258,51,-430,-379,-1,1860,7.6165095659,11.860698482,-4.244188916,0.8389675764,-7.073648193,-6.234680617
2024,New York,Cortland County,45752,-329,419,536,-117,17,-229,-212,0,4080,9.1252599828,11.673363606,-2.548103623,0.3702372785,-4.987313929,-4.61707665
2024,New York,Delaware County,44410,-364,354,634,-280,18,-100,-82,-2,2474,7.9386437029,14.217796914,-6.279153211,0.4036598493,-2.242554718,-1.838894869
2024,New York,Dutchess County,297150,-459,2726,2896,-170,504,-800,-296,7,18231,9.1667381242,9.738398242,-0.571660118,1.6948041139,-2.69016526,-0.995361146
2024,New York,Erie County,946147,-2276,9592,9885,-293,2074,-4097,-2023,40,27135,10.12578052,10.435085534,-0.309305014,2.1894150124,-4.324991951,-2.135576938
2024,New York,Essex County,36775,12,267,467,-200,39,175,214,-2,1676,7.2615518507,12.700916533,-5.439364682,1.060676113,4.7594440969,5.82012021
2024,New York,Franklin County,46502,109,451,540,-89,29,167,196,2,3120,9.7098875074,11.626029388,-1.916141881,0.6243608375,3.5954572367,4.2198180742
2024,New York,Fulton County,52234,-22,481,757,-276,16,237,253,1,1056,9.2066226433,14.489424825,-5.282802182,0.3062494019,4.536319265,4.8425686669
2024,New York,Genesee County,57529,131,542,691,-149,10,272,282,-2,2012,9.4320742732,12.025024581,-2.592950308,0.1740235106,4.7334394877,4.9074629983
2024,New York,Greene County,47062,-283,393,617,-224,22,-78,-56,-3,2409,8.325653818,13.071064646,-4.745410828,0.4660671349,-1.652419842,-1.186352707
2024,New York,Hamilton County,5082,-39,27,78,-51,-2,15,13,-1,122,5.2925610115,15.2896207,-9.997059688,-0.392041556,2.940311673,2.5482701166
2024,New York,Herkimer County,59484,-100,563,776,-213,16,99,115,-2,1292,9.4567809991,13.034568482,-3.577787483,0.2687539893,1.6629153089,1.9316692982
2024,New York,Jefferson County,114787,-674,1856,1023,833,273,-1772,-1499,-8,6602,16.121746986,8.8860706716,7.2356763142,2.371356103,-15.39209895,-13.02074285
2024,New York,Kings County,2561225,-28306,31066,16892,14174,13292,-55308,-42016,-464,45473,12.062695263,6.5590371588,5.5036581038,5.1611841058,-21.4756824,-16.3144983
2024,New York,Lewis County,26548,-47,289,299,-10,7,-44,-37,0,283,10.876314849,11.252657923,-0.376343074,0.263440152,-1.655909527,-1.392469375
2024,New York,Livingston County,61158,-182,518,642,-124,55,-114,-59,1,4538,8.4572809352,10.481803785,-2.024522849,0.8979738445,-1.861254878,-0.963281033
2024,New York,Madison County,66921,-133,546,684,-138,44,-40,4,1,4630,8.1507743982,10.210860235,-2.060085837,0.6568389625,-0.59712633,0.059712633
2024,New York,Monroe County,748482,-2405,7776,7332,444,1584,-4457,-2873,24,27492,10.372363307,9.780114168,0.5922491395,2.1128888219,-5.945167601,-3.832278779
2024,New York,Montgomery County,49368,35,603,704,-101,27,111,138,-2,1252,12.218721188,14.265306329,-2.046585141,0.5471069189,2.2492173332,2.796324252
2024,New York,Nassau County,1381715,-3579,14213,10994,3219,2743,-9618,-6875,77,22314,10.273186679,7.9464866215,2.3267000577,1.9826462437,-6.95191089,-4.969264646
2024,New York,New York County,1597451,2908,13309,10288,3021,10499,-10303,196,-309,76930,8.3389881059,6.446127405,1.8928607009,6.5783331673,-6.455525919,0.1228072484
2024,New York,Niagara County,209457,-1010,2001,2746,-745,161,-431,-270,5,3841,9.5302959583,13.078557072,-3.548261114,0.7668054219,-2.052752403,-1.285946981
2024,New York,Oneida County,227555,-803,2481,2788,-307,438,-939,-501,5,11222,10.883655434,12.230403608,-1.346748173,1.9214192181,-4.119206954,-2.197787736
2024,New York,Onondaga County,467873,-1855,4930,4744,186,1118,-3179,-2061,20,19734,10.516200388,10.119443132,0.396757256,2.3848097432,-6.781136112,-4.396326369
2024,New York,Ontario County,112494,13,983,1118,-135,102,47,149,-1,3664,8.7387487499,9.938882098,-1.200133348,0.9067674186,0.4178242027,1.3245916213
2024,New York,Orange County,407470,979,5585,2933,2652,760,-2466,-1706,33,13465,13.723016213,7.2067334921,6.5162827212,1.8674113379,-6.059258367,-4.19184703
2024,New York,Orleans County,39124,-39,391,465,-74,37,-1,36,-1,1382,9.9888870438,11.879366945,-1.890479901,0.9452399504,-0.025547026,0.9196929248
2024,New York,Oswego County,118162,-77,1148,1242,-94,58,-42,16,1,5448,9.7123108616,10.507569765,-0.795258903,0.4906916637,-0.355328446,0.1353632176
2024,New York,Otsego County,60126,-283,483,691,-208,46,-122,-76,1,8149,8.0142697142,11.465549425,-3.451279711,0.7632637823,-2.024308292,-1.26104451
2024,New York,Putnam County,98060,-252,926,723,203,131,-588,-457,2,2323,9.4310797873,7.3635752551,2.0675045322,1.3342024321,-5.988633817,-4.654431385
2024,New York,Queens County,2252196,-26362,23304,15544,7760,16290,-50161,-33871,-251,35103,10.287029488,6.8615510796,3.4254784082,7.1908560915,-22.14245134,-14.95159525
2024,New York,Rensselaer County,159305,-116,1496,1674,-178,330,-267,63,-1,6826,9.3873734807,10.504320325,-1.116946845,2.0707441501,-1.675420267,0.3953238832
2024,New York,Richmond County,490687,-671,4920,4046,874,1200,-2767,-1567,22,7265,10.019907438,8.2399482712,1.7799591668,2.4438798629,-5.635179651,-3.191299788
2024,New York,Rockland County,340807,450,6236,2311,3925,937,-4460,-3523,48,6414,18.309834342,6.7854437404,11.524390602,2.7511729921,-13.0952311,-10.34405811
2024,New York,St. Lawrence County,106940,-149,1022,1193,-171,125,-104,21,1,10040,9.5501076957,11.148021997,-1.597914301,1.1680660097,-0.97183092,0.1962350896
2024,New York,Saratoga County,238711,243,2122,2177,-55,224,72,296,2,3756,8.893937076,9.1244585365,-0.230521461,0.9388510391,0.3017735483,1.2406245874
2024,New York,Schenectady County,159902,208,1835,1730,105,310,-210,100,3,6254,11.4832476,10.826168037,0.6570795629,1.9399491858,-1.314159126,0.62579006
2024,New York,Schoharie County,30105,14,267,350,-83,8,90,98,-1,1424,8.8710213303,11.628679646,-2.757658316,0.2657983919,2.9902319091,3.256030301
2024,New York,Schuyler County,17507,-102,177,258,-81,2,-22,-20,-1,218,10.080874815,14.69415651,-4.613281695,0.11390819,-1.25299009,-1.1390819
2024,New York,Seneca County,32349,-237,343,397,-54,17,-200,-183,0,1313,10.564410564,12.227612228,-1.663201663,0.5236005236,-6.16000616,-5.636405636
2024,New York,Steuben County,92162,-343,993,1185,-192,81,-235,-154,3,1456,10.754493223,12.833911852,-2.079418629,0.8772547342,-2.54512176,-1.667867026
2024,New York,Suffolk County,1523170,-4804,16113,12881,3232,3416,-11561,-8145,109,35299,10.561940046,8.4433904136,2.1185496325,2.2391601314,-7.578141182,-5.338981051
2024,New York,Sullivan County,79920,185,995,850,145,134,-93,41,-1,4250,12.464376311,10.647959663,1.8164166484,1.6786195233,-1.165012057,0.5136074661
2024,New York,Tioga County,47715,-51,464,531,-67,-1,19,18,-2,647,9.719211152,11.122631728,-1.403420576,-0.020946576,0.3979849394,0.3770383637
2024,New York,Tompkins County,103558,-741,699,718,-19,532,-1263,-731,9,14612,6.7257778184,6.9085958135,-0.182817995,5.1189038618,-12.15258567,-7.03368181
2024,New York,Ulster County,182333,13,1576,1894,-318,229,102,331,0,12247,8.6438340011,10.387957867,-1.744123866,1.25598857,0.5594359569,1.8154245269
2024,New York,Warren County,65380,-47,525,823,-298,20,235,255,-4,1094,8.0270933513,12.583424434,-4.556331083,0.3057940324,3.593079881,3.8988739135
2024,New York,Washington County,60047,-763,562,738,-176,27,-617,-590,3,2212,9.3002473998,12.212780393,-2.912532994,0.4468090388,-10.21041396,-9.763604922
2024,New York,Wayne County,90829,-129,900,984,-84,18,-67,-49,4,1176,9.9016981412,10.825856634,-0.924158493,0.1980339628,-0.737126417,-0.539092454
2024,New York,Westchester County,990817,-919,10278,7313,2965,3628,-7565,-3937,53,25748,10.368449166,7.3773563683,2.991092798,3.6599273765,-7.631574036,-3.97164666
2024,New York,Wyoming County,39532,-69,350,403,-53,33,-50,-17,1,3038,8.8458670845,10.1853841,-1.339517016,0.8340388965,-1.263695298,-0.429656401
2024,New York,Yates County,24472,-30,345,271,74,10,-113,-103,-1,1152,14.089108507,11.067096827,3.0220116797,0.4083799567,-4.614693511,-4.206313554
2024,North Carolina,North Carolina,10835491,139526,121148,108491,12657,29448,97264,126712,157,281967,11.2531173,10.077442046,1.1756752539,2.735346834,9.0345957096,11.769942544
2024,North Carolina,Alamance County,179165,2547,1944,1926,18,315,2208,2523,6,5880,10.928009489,10.826824216,0.101185273,1.7707422783,12.41206016,14.182802439
2024,North Carolina,Alexander County,36473,157,352,502,-150,-2,308,306,1,1209,9.6717910673,13.793292943,-4.121501875,-0.054953358,8.4628171839,8.4078638256
2024,North Carolina,Alleghany County,11342,149,102,167,-65,1,214,215,-1,246,9.052584868,14.821388951,-5.768804083,0.088750832,18.992678056,19.081428888
2024,North Carolina,Anson County,21897,-61,267,367,-100,6,33,39,0,1676,12.176490708,16.736974119,-4.560483411,0.2736290047,1.5049595257,1.7785885304
2024,North Carolina,Ashe County,27063,1,205,434,-229,17,214,231,-1,433,7.5750577367,16.036951501,-8.461893764,0.6281755196,7.9076212471,8.5357967667
2024,North Carolina,Avery County,17561,20,137,239,-102,39,82,121,1,2048,7.80582303,13.617457695,-5.811634665,2.2220956071,4.6720984559,6.894194063
2024,North Carolina,Beaufort County,44481,81,443,683,-240,25,295,320,1,379,9.9683846941,15.368863987,-5.400479293,0.5625499263,6.6380891304,7.2006390567
2024,North Carolina,Bertie County,16922,-146,152,304,-152,-1,9,8,-2,1342,8.9438070021,17.887614004,-8.943807002,-0.058840836,0.5295675199,0.4707266843
2024,North Carolina,Bladen County,29484,93,349,507,-158,-2,255,253,-2,320,11.855626327,17.222929936,-5.367303609,-0.067940552,8.6624203822,8.5944798301
2024,North Carolina,Brunswick County,159964,7056,1127,1921,-794,25,7796,7821,29,942,7.2042240916,12.279782147,-5.075558056,0.1598097625,49.835076325,49.994886088
2024,North Carolina,Buncombe County,275901,2111,2432,2901,-469,512,2051,2563,17,7917,8.8486076723,10.555020912,-1.706413239,1.8628647731,7.4623743158,9.3252390889
2024,North Carolina,Burke County,88338,366,861,1227,-366,36,697,733,-1,2949,9.766887868,13.918665986,-4.151778118,0.4083716182,7.9065282741,8.3148998922
2024,North Carolina,Cabarrus County,240016,4107,2723,1893,830,345,2942,3287,-10,1779,11.442979461,7.955034932,3.4879445291,1.4498082681,12.363292536,13.813100804
2024,North Carolina,Caldwell County,80574,227,753,1228,-475,5,696,701,1,1123,9.3586293896,15.262147265,-5.903517875,0.0621422934,8.6502072445,8.712349538
2024,North Carolina,Camden County,11137,47,77,111,-34,7,74,81,0,10,6.9285103703,9.9878526117,-3.059342241,0.6298645791,6.6585684078,7.2884329869
2024,North Carolina,Carteret County,69615,289,488,990,-502,31,762,793,-2,825,7.0245643834,14.250653155,-7.226088771,0.4462325735,10.96868455,11.414917123
2024,North Carolina,Caswell County,22807,376,192,355,-163,4,540,544,-5,1335,8.488438923,15.694769884,-7.206330961,0.1768424776,23.873734471,24.050576949
2024,North Carolina,Catawba County,164645,1478,1670,2019,-349,195,1626,1821,6,2719,10.188766732,12.318035947,-2.129269215,1.1897062951,9.9203201835,11.110026479
2024,North Carolina,Chatham County,81624,1685,689,828,-139,153,1676,1829,-5,784,8.5291805673,10.249871567,-1.720691,1.893998007,20.747324573,22.64132258
2024,North Carolina,Cherokee County,29959,500,285,481,-196,-3,700,697,-1,341,9.5930526103,16.19038002,-6.597327409,-0.100979501,23.561883604,23.460904103
2024,North Carolina,Chowan County,13891,-7,137,240,-103,-2,99,97,-1,273,9.8600165533,17.273021699,-7.413005146,-0.143941847,7.1251214509,6.9811796034
2024,North Carolina,Clay County,11864,249,90,169,-79,2,326,328,0,91,7.6664253162,14.395843094,-6.729417778,0.170365007,27.769496145,27.939861153
2024,North Carolina,Cleveland County,101378,725,1127,1427,-300,26,999,1025,0,1962,11.156703674,14.126544936,-2.969841262,0.2573862427,9.8895714024,10.146957645
2024,North Carolina,Columbus County,50121,46,583,823,-240,3,280,283,3,2490,11.637191105,16.427801509,-4.790610404,0.05988263,5.5890454709,5.6489281009
2024,North Carolina,Craven County,102391,1304,1257,1287,-30,136,1192,1328,6,3344,12.355144045,12.650016218,-0.294872173,1.3367538505,11.716254337,13.053008188
2024,North Carolina,Cumberland County,337890,1109,5281,3231,2050,1175,-2125,-950,9,16148,15.655037789,9.5780017223,6.0770360665,3.4831792088,-6.299366654,-2.816187445
2024,North Carolina,Currituck County,31593,585,290,288,2,-6,589,583,0,135,9.2650277152,9.2011309723,0.0638967429,-0.191690229,18.817590773,18.625900545
2024,North Carolina,Dare County,38110,123,283,395,-112,64,169,233,2,264,7.4378753433,10.381486787,-2.943611443,1.6820636819,4.44169941,6.1237630918
2024,North Carolina,Davidson County,174804,2424,1779,2174,-395,200,2616,2816,3,1879,10.248168118,12.5236186,-2.275450482,1.1521268261,15.069818886,16.221945712
2024,North Carolina,Davie County,44599,484,420,569,-149,23,613,636,-3,415,9.4686295286,12.827738576,-3.359109047,0.5185201885,13.819690241,14.338210429
2024,North Carolina,Duplin County,49520,586,720,656,64,229,293,522,0,424,14.626119812,13.326020273,1.3000995389,4.6519186625,5.9520182014,10.603936864
2024,North Carolina,Durham County,336892,3600,4190,2280,1910,2338,-615,1723,-33,17793,12.504028744,6.8041015602,5.6999271842,6.9771883542,-1.835316868,5.141871486
2024,North Carolina,Edgecombe County,48832,443,592,716,-124,52,521,573,-6,653,12.178438815,14.729328026,-2.550889211,1.0697277337,10.717849024,11.787576758
2024,North Carolina,Forsyth County,392921,3260,4504,3955,549,900,1798,2698,13,11516,11.510614862,10.107567003,1.4030478595,2.3000784582,4.595045631,6.8951240892
2024,North Carolina,Franklin County,77001,2601,846,735,111,86,2406,2492,-2,1270,11.175619712,9.7093149979,1.466304714,1.1360559045,31.783145422,32.919201326
2024,North Carolina,Gaston County,237242,3272,2752,2822,-70,307,3020,3327,15,3408,11.680517474,11.97762366,-0.297106186,1.3030228432,12.818009728,14.121032571
2024,North Carolina,Gates County,10343,-27,86,159,-73,-4,51,47,-1,117,8.3039636943,15.352677063,-7.048713368,-0.38623087,4.9244435862,4.5382127167
2024,North Carolina,Graham County,8052,20,96,115,-19,9,31,40,-1,238,11.937329023,14.299925392,-2.362596369,1.1191245959,3.8547624969,4.9738870928
2024,North Carolina,Granville County,62192,490,644,689,-45,14,522,536,-1,3843,10.395983663,11.122411093,-0.72642743,0.2259996449,8.4265581868,8.6525578317
2024,North Carolina,Greene County,20530,163,199,235,-36,31,168,199,0,3413,9.7317651661,11.492285498,-1.760520332,1.5160036188,8.2157615473,9.7317651661
2024,North Carolina,Guilford County,549866,3409,5862,5185,677,2068,661,2729,3,25871,10.693928705,9.4588912209,1.2350374844,3.772610809,1.2058490062,4.9784598152
2024,North Carolina,Halifax County,47298,-413,528,785,-257,45,-198,-153,-3,1242,11.114736499,16.524750287,-5.410013788,0.9472786789,-4.168026187,-3.220747508
2024,North Carolina,Harnett County,141477,2999,1858,1299,559,210,2212,2422,18,2891,13.273561822,9.2800628672,3.9934989552,1.5002411102,15.802539694,17.302780804
2024,North Carolina,Haywood County,62969,354,519,964,-445,18,775,793,6,911,8.2653841254,15.352274175,-7.08689005,0.2866607211,12.342336603,12.628997324
2024,North Carolina,Henderson County,119230,932,1032,1552,-520,53,1399,1452,0,1326,8.6895018693,13.067933044,-4.378431174,0.4462631774,11.779663871,12.225927049
2024,North Carolina,Hertford County,19453,-181,183,307,-124,43,-101,-58,1,1413,9.3637270704,15.708547599,-6.344820529,2.200220022,-5.167958656,-2.967738634
2024,North Carolina,Hoke County,54446,755,932,479,453,72,231,303,-1,403,17.237393307,8.8591323969,8.3782609098,1.3316441181,4.2723582123,5.6040023304
2024,North Carolina,Hyde County,4607,-49,38,54,-16,-1,-32,-33,0,711,8.2046853071,11.659289647,-3.45460434,-0.215912771,-6.90920868,-7.125121451
2024,North Carolina,Iredell County,199710,3836,2016,1908,108,395,3342,3737,-9,1680,10.192525481,9.6464973305,0.5460281508,1.9970474033,16.896537777,18.89358518
2024,North Carolina,Jackson County,44574,652,346,428,-82,69,667,736,-2,4606,7.8195624661,9.6727535708,-1.853191105,1.5593925149,15.074127644,16.633520159
2024,North Carolina,Johnston County,241955,7053,2831,1923,908,419,5726,6145,0,2080,11.873580549,8.0653109842,3.8082695651,1.7573402509,24.015585385,25.772925636
2024,North Carolina,Jones County,9401,182,96,164,-68,7,246,253,-3,72,10.311493018,17.61546724,-7.303974221,0.7518796992,26.423200859,27.175080559
2024,North Carolina,Lee County,67059,1516,783,751,32,226,1250,1476,8,1018,11.809776625,11.327129304,0.4826473206,3.4086967014,18.853410959,22.262107661
2024,North Carolina,Lenoir County,54895,396,657,897,-240,32,603,635,1,1264,12.011627694,16.399436898,-4.387809203,0.5850412271,11.024370624,11.609411851
2024,North Carolina,Lincoln County,95675,2567,932,989,-57,110,2518,2628,-4,806,9.8737704136,10.477638347,-0.603867933,1.165359169,26.676130796,27.841489965
2024,North Carolina,McDowell County,44893,138,392,653,-261,52,346,398,1,1329,8.7453150098,14.568088524,-5.822773514,1.1600928074,7.7190790648,8.8791718722
2024,North Carolina,Macon County,38412,443,323,606,-283,32,693,725,1,255,8.4576007122,15.867820531,-7.410219819,0.8379047145,18.145873974,18.983778688
2024,North Carolina,Madison County,22071,190,189,295,-106,17,278,295,1,1055,8.6002912268,13.423734984,-4.823443757,0.7735711685,12.650163815,13.423734984
2024,North Carolina,Martin County,21447,-31,218,397,-179,1,146,147,1,162,10.157251019,18.49737915,-8.34012813,0.0465928946,6.8025626092,6.8491555038
2024,North Carolina,Mecklenburg County,1163701,19626,15062,7093,7969,8796,2805,11601,56,17200,13.053259935,6.1470437339,6.9062162012,7.622923542,2.4309118389,10.053835381
2024,North Carolina,Mitchell County,14999,-49,115,269,-154,12,94,106,-1,103,7.6546743435,17.905281725,-10.25060738,0.7987486272,6.256864246,7.0556128732
2024,North Carolina,Montgomery County,26085,244,253,381,-128,44,328,372,0,700,9.7446365982,14.674729423,-4.930092824,1.6947194084,12.633362863,14.328082271
2024,North Carolina,Moore County,106898,1407,1192,1345,-153,107,1452,1559,1,952,11.224686778,12.665439359,-1.440752581,1.0075851386,13.673024498,14.680609636
2024,North Carolina,Nash County,96551,731,1076,1174,-98,73,755,828,1,1519,11.186717333,12.205581922,-1.01886459,0.7589501536,7.8494159723,8.6083661259
2024,North Carolina,New Hanover County,238852,3068,2215,2266,-51,347,2748,3095,24,6837,9.3334681735,9.548369698,-0.214901525,1.4621731179,11.579399793,13.041572911
2024,North Carolina,Northampton County,16715,-112,161,319,-158,4,44,48,-2,314,9.5999045972,19.020928985,-9.421024387,0.2385069465,2.6235764117,2.8620833582
2024,North Carolina,Onslow County,213676,4645,3888,1563,2325,315,1988,2303,17,24256,18.395720913,7.3951933609,11.000527552,1.4903940555,9.4060424833,10.896436539
2024,North Carolina,Orange County,150626,373,1195,922,273,613,-522,91,9,10581,7.9433925266,6.1287095477,1.8146829789,4.0747277145,-3.469833388,0.6048943263
2024,North Carolina,Pamlico County,12423,189,87,212,-125,3,311,314,0,631,7.0568195644,17.195928134,-10.13910857,0.2433386057,25.226102121,25.469440727
2024,North Carolina,Pasquotank County,41444,276,429,489,-60,31,303,334,2,2598,10.385900353,11.838473829,-1.452573476,0.7504962959,7.3354960538,8.0859923498
2024,North Carolina,Pender County,68521,2823,672,732,-60,87,2798,2885,-2,1263,10.013485423,10.907546622,-0.894061198,1.2963887378,41.69305389,42.989442627
2024,North Carolina,Perquimans County,13377,156,114,199,-85,-7,248,241,0,96,8.5720730882,14.963531093,-6.391458004,-0.526355365,18.648018648,18.121663283
2024,North Carolina,Person County,39737,394,424,518,-94,12,476,488,0,354,10.723318159,13.100657562,-2.377339403,0.3034901366,12.038442084,12.341932221
2024,North Carolina,Pitt County,175119,1509,2059,1614,445,345,710,1055,9,4958,11.80859636,9.2564713574,2.5521250025,1.978613766,4.0719297793,6.0505435453
2024,North Carolina,Polk County,20060,48,136,332,-196,-3,248,245,-1,428,6.7877819924,16.570173687,-9.782391695,-0.149730485,12.377720104,12.227989619
2024,North Carolina,Randolph County,147458,1262,1550,1860,-310,120,1453,1573,-1,1523,10.55664149,12.667969788,-2.111328298,0.8172883734,9.8960000545,10.713288428
2024,North Carolina,Richmond County,42324,-249,526,685,-159,-2,-90,-92,2,954,12.391486154,16.13720155,-3.745715396,-0.047115917,-2.120216262,-2.167332179
2024,North Carolina,Robeson County,117365,899,1862,1702,160,162,573,735,4,3548,15.926032049,14.557522313,1.3685097357,1.3856161074,4.9009754908,6.2865915982
2024,North Carolina,Rockingham County,92518,552,919,1387,-468,25,995,1020,0,920,9.962923614,15.036534334,-5.07361072,0.2710262137,10.786843303,11.057869517
2024,North Carolina,Rowan County,151661,1988,1626,1941,-315,200,2106,2306,-3,3956,10.792011522,12.882714861,-2.090703339,1.3274306915,13.977845182,15.305275873
2024,North Carolina,Rutherford County,65507,562,630,1016,-386,24,925,949,-1,1203,9.6587250483,15.576610554,-5.917885506,0.3679514304,14.18146138,14.549412811
2024,North Carolina,Sampson County,59601,574,813,826,-13,141,447,588,-1,1094,13.706713423,13.925885963,-0.219172539,2.3771790808,7.536163469,9.9133425498
2024,North Carolina,Scotland County,34376,26,412,515,-103,63,64,127,2,3470,11.98964002,14.987050025,-2.997410005,1.8333672846,1.8624683526,3.6958356372
2024,North Carolina,Stanly County,65699,1468,704,844,-140,59,1551,1610,-2,1679,10.836604325,12.991610867,-2.155006542,0.9081813284,23.874393904,24.782575233
2024,North Carolina,Stokes County,45532,396,421,675,-254,-5,656,651,-1,624,9.2866281378,14.889486919,-5.602858781,-0.110292496,14.470375436,14.36008294
2024,North Carolina,Surry County,71462,-20,737,1053,-316,40,254,294,2,955,10.311730468,14.73304231,-4.421311842,0.5596597269,3.5538392657,4.1134989926
2024,North Carolina,Swain County,13916,-20,166,254,-88,25,42,67,1,369,11.920149361,18.239264685,-6.319115324,1.795203217,3.0159414046,4.8111446216
2024,North Carolina,Transylvania County,33549,176,245,483,-238,48,363,411,3,863,7.3219569051,14.434715041,-7.112758136,1.4345058426,10.848450435,12.282956277
2024,North Carolina,Tyrrell County,3461,-12,40,49,-9,3,-7,-4,1,213,11.537352178,14.133256418,-2.59590424,0.8653014133,-2.019036631,-1.153735218
2024,North Carolina,Union County,256452,7280,2512,1806,706,613,6010,6623,-49,2955,9.9362372039,7.1436482445,2.7925889594,2.4247266744,23.772605731,26.197332405
2024,North Carolina,Vance County,42301,147,522,631,-109,140,116,256,0,449,12.361612693,14.942868983,-2.58125629,3.3153750518,2.7470250429,6.0624000947
2024,North Carolina,Wake County,1190275,19497,13218,6484,6734,5326,7401,12727,36,16504,11.1966991,5.492464591,5.7042345089,4.5115463312,6.2692366499,10.780782981
2024,North Carolina,Warren County,18836,159,175,303,-128,17,272,289,-2,854,9.330098899,16.154399808,-6.824300909,0.9063524645,14.501639432,15.407991896
2024,North Carolina,Washington County,10713,-63,111,194,-83,6,13,19,1,155,10.330866955,18.055749453,-7.724882498,0.5584252408,1.2099213551,1.7683465959
2024,North Carolina,Watauga County,54748,-265,306,446,-140,34,-161,-127,2,7586,5.5757509498,8.1267481164,-2.550997167,0.6195278833,-2.933646742,-2.314118858
2024,North Carolina,Wayne County,118686,1237,1593,1352,241,291,707,998,-2,3790,13.492281957,11.451076715,2.0412052428,2.4646918077,5.9881000275,8.4527918352
2024,North Carolina,Wilkes County,66013,222,681,973,-292,49,467,516,-2,1044,10.333525538,14.764347061,-4.430821523,0.7435282692,7.0862796273,7.8298078966
2024,North Carolina,Wilson County,78970,664,887,1074,-187,61,789,850,1,881,11.279534067,13.657519265,-2.377985198,0.7757064015,10.033317226,10.809023627
2024,North Carolina,Yadkin County,37774,267,381,527,-146,44,371,415,-2,438,10.122075955,14.000876715,-3.87880076,1.1689536536,9.8564046705,11.025358324
2024,North Carolina,Yancey County,18938,170,174,299,-125,26,268,294,1,122,9.2293003766,15.8595449,-6.630244523,1.3790908609,14.215244258,15.594335119
2024,North Dakota,North Dakota,783926,5014,9649,6945,2704,2298,-9,2289,21,28831,12.34804887,8.8876774176,3.4603714524,2.9408038453,-0.011517509,2.9292863368
2024,North Dakota,Adams County,2163,30,20,28,-8,0,38,38,0,63,9.3109869646,13.03538175,-3.724394786,0.0,17.690875233,17.690875233
2024,North Dakota,Barnes County,10726,-35,85,144,-59,45,-19,26,-2,518,7.9117605994,13.403453251,-5.491692651,4.1885791409,-1.768511193,2.4200679481
2024,North Dakota,Benson County,5745,-27,104,89,15,7,-50,-43,1,48,18.060258748,15.455413736,2.6048450117,1.2155943388,-8.682816706,-7.467222367
2024,North Dakota,Billings County,1034,9,14,7,7,0,1,1,1,8,13.598834386,6.7994171928,6.7994171928,0.0,0.9713453133,0.9713453133
2024,North Dakota,Bottineau County,6349,-35,74,69,5,8,-49,-41,1,189,11.623340925,10.837980052,0.7853608733,1.2565773973,-7.696536559,-6.439959161
2024,North Dakota,Bowman County,2867,-32,30,35,-5,1,-28,-27,0,45,10.405827263,12.140131807,-1.734304544,0.3468609088,-9.712105446,-9.365244537
2024,North Dakota,Burke County,2134,2,22,21,1,0,1,1,0,0,10.31411158,9.8452883263,0.4688232536,0.0,0.4688232536,0.4688232536
2024,North Dakota,Burleigh County,100012,616,1144,820,324,318,-27,291,1,3967,11.47396293,8.2243440584,3.2496188719,3.1894407446,-0.270801573,2.9186391719
2024,North Dakota,Cass County,196362,3649,2408,1273,1135,1103,1394,2497,17,8412,12.378076206,6.5437255028,5.8343507036,5.6698579965,7.1657135514,12.835571548
2024,North Dakota,Cavalier County,3596,-12,36,47,-11,1,-1,0,-1,52,9.9944475292,13.048306496,-3.053858967,0.2776235425,-0.277623542,0.0
2024,North Dakota,Dickey County,4900,-28,58,71,-13,14,-30,-16,1,352,11.803011803,14.448514449,-2.645502646,2.849002849,-6.105006105,-3.256003256
2024,North Dakota,Divide County,2135,-34,19,30,-11,0,-23,-23,0,41,8.8289962825,13.940520446,-5.111524164,0.0,-10.68773234,-10.68773234
2024,North Dakota,Dunn County,4019,25,69,41,28,22,-25,-3,0,80,17.222014227,10.233370772,6.9886434544,5.4910769999,-6.239860227,-0.748783227
2024,North Dakota,Eddy County,2263,-44,31,47,-16,0,-30,-30,2,64,13.566739606,20.56892779,-7.002188184,0.0,-13.12910284,-13.12910284
2024,North Dakota,Emmons County,3224,-30,36,48,-12,0,-19,-19,1,47,11.114541525,14.8193887,-3.704847175,0.0,-5.866008027,-5.866008027
2024,North Dakota,Foster County,3309,-71,37,43,-6,0,-65,-65,0,66,11.062939154,12.856929287,-1.793990133,0.0,-19.43489311,-19.43489311
2024,North Dakota,Golden Valley County,1743,-3,18,19,-1,0,-3,-3,1,70,10.318142734,10.891372886,-0.573230152,0.0,-1.719690456,-1.719690456
2024,North Dakota,Grand Forks County,72708,287,853,546,307,303,-327,-24,4,4299,11.755059292,7.5243404144,4.2307188777,4.1755955047,-4.506335743,-0.330740238
2024,North Dakota,Grant County,2215,-23,21,43,-22,10,-11,-1,0,62,9.4318437009,19.312822816,-9.880979115,4.4913541433,-4.940489558,-0.449135414
2024,North Dakota,Griggs County,2248,-1,23,29,-6,0,5,5,0,85,10.229041583,12.897487214,-2.66844563,0.0,2.223704692,2.223704692
2024,North Dakota,Hettinger County,2415,4,24,27,-3,0,7,7,0,121,9.9461251554,11.1893908,-1.243265644,0.0,2.9009531703,2.9009531703
2024,North Dakota,Kidder County,2342,-39,20,28,-8,0,-30,-30,-1,0,8.4691933093,11.856870633,-3.387677324,0.0,-12.70378996,-12.70378996
2024,North Dakota,LaMoure County,4096,20,51,44,7,0,13,13,0,247,12.48164464,10.768477729,1.7131669114,0.0,3.1815956926,3.1815956926
2024,North Dakota,Logan County,1869,31,30,26,4,-1,29,28,-1,55,16.185594821,14.027515511,2.1580793094,-0.539519827,15.646074993,15.106555166
2024,North Dakota,McHenry County,5131,-64,62,72,-10,2,-58,-56,2,38,12.008522177,13.945380593,-1.936858416,0.3873716831,-11.23377881,-10.84640713
2024,North Dakota,McIntosh County,2488,-7,30,48,-18,5,6,11,0,93,12.040939193,19.265502709,-7.224563516,2.0068231989,2.4081878387,4.4150110375
2024,North Dakota,McKenzie County,14252,363,219,90,129,17,216,233,1,94,15.564478874,6.3963611812,9.168117693,1.2082015564,15.351266835,16.559468391
2024,North Dakota,McLean County,9832,-26,93,109,-16,5,-16,-11,1,196,9.4464195023,11.071609954,-1.625190452,0.5078720163,-1.625190452,-1.117318436
2024,North Dakota,Mercer County,8309,-18,78,97,-19,20,-19,1,0,112,9.3772541476,11.661457081,-2.284202933,2.4044241404,-2.284202933,0.120221207
2024,North Dakota,Morton County,33895,190,418,345,73,10,108,118,-1,728,12.366863905,10.207100592,2.1597633136,0.2958579882,3.1952662722,3.4911242604
2024,North Dakota,Mountrail County,9383,142,151,95,56,11,76,87,-1,66,16.215635739,10.201890034,6.0137457045,1.1812714777,8.1615120275,9.3427835052
2024,North Dakota,Nelson County,2991,-8,25,45,-20,11,0,11,1,112,8.347245409,15.025041736,-6.677796327,3.67278798,0.0,3.67278798
2024,North Dakota,Oliver County,1879,17,18,9,9,0,7,7,1,3,9.623095429,4.8115477145,4.8115477145,0.0,3.7423148891,3.7423148891
2024,North Dakota,Pembina County,6661,-84,61,88,-27,11,-66,-55,-2,120,9.1004028047,13.128449948,-4.028047143,1.6410562435,-9.846337461,-8.205281217
2024,North Dakota,Pierce County,3902,-29,28,62,-34,5,1,6,-1,128,7.1492403932,15.830460871,-8.681220477,1.2766500702,0.255330014,1.5319800843
2024,North Dakota,Ramsey County,11463,-53,134,143,-9,9,-52,-43,-1,432,11.662822577,12.446146482,-0.783323904,0.7833239044,-4.525871448,-3.742547543
2024,North Dakota,Ransom County,5603,-44,51,72,-21,8,-31,-23,0,378,9.0666666667,12.8,-3.733333333,1.4222222222,-5.511111111,-4.088888889
2024,North Dakota,Renville County,2279,29,28,30,-2,23,8,31,0,35,12.364760433,13.247957607,-0.883197174,10.156767498,3.5327886951,13.689556193
2024,North Dakota,Richland County,16558,-16,169,138,31,-7,-40,-47,0,1028,10.201617771,8.3303151032,1.8713026681,-0.422552215,-2.414584088,-2.837136303
2024,North Dakota,Rolette County,11728,-139,166,189,-23,7,-122,-115,-1,155,14.070777707,16.020343293,-1.949565586,0.5933460479,-10.34117398,-9.74782793
2024,North Dakota,Sargent County,3776,-28,42,47,-5,1,-22,-21,-2,39,11.081794195,12.401055409,-1.319261214,0.2638522427,-5.80474934,-5.540897098
2024,North Dakota,Sheridan County,1266,-20,8,19,-11,0,-9,-9,0,13,6.2695924765,14.890282132,-8.620689655,0.0,-7.053291536,-7.053291536
2024,North Dakota,Sioux County,3643,-43,55,61,-6,0,-40,-40,3,65,15.008868877,16.646200027,-1.63733115,0.0,-10.915541,-10.915541
2024,North Dakota,Slope County,674,-8,6,4,2,0,-11,-11,1,0,8.8495575221,5.8997050147,2.9498525074,0.0,-16.22418879,-16.22418879
2024,North Dakota,Stark County,33001,283,484,273,211,41,30,71,1,675,14.72937811,8.3080996363,6.4212784735,1.2477365754,0.912977982,2.1607145574
2024,North Dakota,Steele County,1782,-11,18,19,-1,0,-9,-9,-1,0,10.06993007,10.629370629,-0.559440559,0.0,-5.034965035,-5.034965035
2024,North Dakota,Stutsman County,21392,-84,204,235,-31,30,-83,-53,0,1877,9.5175888775,10.963889148,-1.446300271,1.3996454232,-3.872352337,-2.472706914
2024,North Dakota,Towner County,2030,-30,22,26,-4,8,-33,-25,-1,25,10.75794621,12.71393643,-1.95599022,3.9119804401,-16.13691932,-12.22493888
2024,North Dakota,Traill County,7908,-47,77,92,-15,8,-40,-32,0,372,9.7081258274,11.59931917,-1.891193343,1.0086364496,-5.043182248,-4.034545798
2024,North Dakota,Walsh County,10305,-155,125,126,-1,11,-165,-154,0,275,12.039489526,12.135805442,-0.096315916,1.0594750783,-15.89212617,-14.8326511
2024,North Dakota,Ward County,68332,-456,1001,531,470,150,-1072,-922,-4,2282,14.600350058,7.7450408401,6.8553092182,2.1878646441,-15.63593932,-13.44807468
2024,North Dakota,Wells County,3876,-46,29,60,-31,0,-14,-14,-1,83,7.4378045653,15.38856117,-7.950756604,0.0,-3.590664273,-3.590664273
2024,North Dakota,Williams County,39113,1147,620,245,375,81,690,771,1,516,16.087390859,6.3571141297,9.7302767291,2.1017397735,17.903709181,20.005448955
2024,Ohio,Ohio,11785935,26238,128826,131288,-2462,28081,637,28718,-18,296114,10.942666563,11.1517924,-0.209125837,2.3852407105,0.0541077003,2.4393484108
2024,Ohio,Adams County,27521,62,327,427,-100,32,131,163,-1,282,11.895234631,15.532921062,-3.637686431,1.1640596581,4.7653692252,5.9294288832
2024,Ohio,Allen County,100838,-259,1209,1236,-27,66,-302,-236,4,3553,11.974150098,12.241562879,-0.267412781,0.6536756877,-2.99106148,-2.337385792
2024,Ohio,Ashland County,52190,166,571,691,-120,20,269,289,-3,1171,10.958220585,13.261174122,-2.302953538,0.3838255897,5.1624541808,5.5462797705
2024,Ohio,Ashtabula County,96845,-115,1010,1328,-318,18,187,205,-2,3514,10.422847708,13.704496788,-3.28164908,0.1857537215,1.9297747736,2.1155284951
2024,Ohio,Athens County,62706,1825,456,607,-151,315,1645,1960,16,8762,7.379416929,9.8230396401,-2.443622711,5.0976235365,26.620922913,31.718546449
2024,Ohio,Auglaize County,46050,104,522,548,-26,6,127,133,-3,466,11.348319492,11.913561459,-0.565241967,0.1304404539,2.7609896082,2.8914300622
2024,Ohio,Belmont County,64918,-577,483,940,-457,-3,-118,-121,1,3801,7.4072370086,14.415740762,-7.008503753,-0.046007683,-1.809635542,-1.855643226
2024,Ohio,Brown County,43777,77,482,600,-118,3,195,198,-3,509,11.020039553,13.71789156,-2.697852007,0.0685894578,4.458314757,4.5269042148
2024,Ohio,Butler County,393043,3315,4310,3737,573,1631,1090,2721,21,12048,11.012160645,9.5481309348,1.4640297098,4.1672468704,2.7849779821,6.9522248525
2024,Ohio,Carroll County,26758,72,229,385,-156,1,233,234,-6,329,8.5697178355,14.407604221,-5.837886386,0.0374223486,8.71940723,8.7568295786
2024,Ohio,Champaign County,38845,102,432,476,-44,6,139,145,1,439,11.135742641,12.26993865,-1.13419601,0.1546630922,3.5830283033,3.7376913956
2024,Ohio,Clark County,134610,-122,1535,1933,-398,143,133,276,0,2529,11.398148079,14.353498526,-2.955350447,1.0618470198,0.9875919834,2.0494390032
2024,Ohio,Clermont County,211972,1293,2190,2154,36,251,998,1249,8,2109,10.363160149,10.192806831,0.1703533175,1.187741186,4.7225725244,5.9103137104
2024,Ohio,Clinton County,41938,48,484,556,-72,85,35,120,0,1194,11.547454311,13.265257432,-1.717803121,2.0279620175,0.8350431837,2.8630052011
2024,Ohio,Columbiana County,100182,-387,958,1415,-457,-7,78,71,-1,3729,9.5441616729,14.097065519,-4.552903846,-0.069738133,0.7770820569,0.7073439236
2024,Ohio,Coshocton County,36869,254,424,476,-52,12,295,307,-1,348,11.539927059,12.955201132,-1.415274073,0.3266017092,8.0289586849,8.3555603941
2024,Ohio,Crawford County,41529,20,442,630,-188,46,161,207,1,449,10.645728462,15.173775862,-4.5280474,1.1079264915,3.8777427202,4.9856692117
2024,Ohio,Cuyahoga County,1233088,-3906,13037,13916,-879,3965,-6999,-3034,7,26720,10.555924864,11.267642127,-0.711717263,3.2104197351,-5.667018342,-2.456598607
2024,Ohio,Darke County,51415,-111,586,664,-78,11,-46,-35,2,624,11.385162375,12.900593544,-1.515431169,0.2137146521,-0.893715818,-0.680001166
2024,Ohio,Defiance County,38315,187,407,457,-50,88,149,237,0,696,10.64845702,11.956621273,-1.308164253,2.3023690855,3.8983294742,6.2006985597
2024,Ohio,Delaware County,231636,5110,2162,1420,742,736,3666,4402,-34,1980,9.4377098057,6.198680816,3.2390289897,3.2128373807,16.003073149,19.215910529
2024,Ohio,Erie County,74035,-479,656,993,-337,49,-193,-144,2,2000,8.8321025386,13.369325946,-4.537223408,0.6597149762,-2.598469192,-1.938754216
2024,Ohio,Fairfield County,165360,2404,1727,1605,122,286,2014,2300,-18,3296,10.520352343,9.7771659011,0.7431864423,1.742223955,12.268667991,14.010891946
2024,Ohio,Fayette County,28817,-15,337,416,-79,24,40,64,0,360,11.691443043,14.43216708,-2.740724037,0.8326250239,1.3877083731,2.2203333969
2024,Ohio,Franklin County,1326063,4333,17429,10554,6875,9355,-11882,-2527,-15,29758,13.164926412,7.9719222764,5.1930041359,7.0662623551,-8.975021839,-1.908759484
2024,Ohio,Fulton County,42007,-151,440,509,-69,41,-125,-84,2,354,10.455652587,12.095289016,-1.639636428,0.9742767184,-2.970355849,-1.99607913
2024,Ohio,Gallia County,28986,-44,319,430,-111,5,62,67,0,577,10.996966354,14.823496966,-3.826530612,0.1723662438,2.1373414231,2.3097076669
2024,Ohio,Geauga County,95407,-84,914,962,-48,69,-101,-32,-4,1199,9.5757944033,10.078680761,-0.502886358,0.7228991399,-1.058156712,-0.335257572
2024,Ohio,Greene County,169691,664,1649,1652,-3,389,278,667,0,7459,9.736713136,9.7544269865,-0.01771385,2.2968959429,1.6414834759,3.9383794189
2024,Ohio,Guernsey County,38089,29,410,595,-185,3,215,218,-4,503,10.768362027,15.627257088,-4.858895061,0.0787928929,5.6468239898,5.7256168827
2024,Ohio,Hamilton County,827058,2337,10244,8060,2184,3200,-3058,142,11,24281,12.403596365,9.7591748049,2.64442156,3.8746103444,-3.70267451,0.171935834
2024,Ohio,Hancock County,74704,-70,840,851,-11,164,-226,-62,3,2007,11.23911211,11.386290959,-0.147178849,2.1943028406,-3.023856353,-0.829553513
2024,Ohio,Hardin County,30368,-23,365,428,-63,29,11,40,0,1824,12.014680953,14.088447802,-2.073766849,0.9545910894,0.3620862753,1.3166773647
2024,Ohio,Harrison County,14159,-192,135,250,-115,1,-78,-77,0,220,9.4703612767,17.537706068,-8.067344791,0.0701508243,-5.471764293,-5.401613469
2024,Ohio,Henry County,27520,-6,306,348,-42,4,32,36,0,320,11.117974058,12.643970497,-1.525996439,0.1453329942,1.1626639538,1.307996948
2024,Ohio,Highland County,43614,188,556,600,-44,10,222,232,0,402,12.775735294,13.786764706,-1.011029412,0.2297794118,5.1011029412,5.3308823529
2024,Ohio,Hocking County,27540,-278,276,402,-126,0,-153,-153,1,192,9.9714585064,14.523646085,-4.552187579,0.0,-5.527656346,-5.527656346
2024,Ohio,Holmes County,44386,11,779,366,413,7,-413,-406,4,732,17.552754025,8.2468651773,9.3058888476,0.1577269296,-9.305888848,-9.148161918
2024,Ohio,Huron County,58199,-20,650,710,-60,41,-2,39,1,445,11.166658077,12.197426515,-1.030768438,0.7043584325,-0.034358948,0.6699994846
2024,Ohio,Jackson County,32606,-5,377,471,-94,20,69,89,0,299,11.561402702,14.444086665,-2.882683963,0.6133370134,2.1160126961,2.7293497094
2024,Ohio,Jefferson County,64026,-247,533,1042,-509,20,244,264,-2,2710,8.3087163579,16.243306651,-7.934590293,0.3117717207,3.8036149931,4.1153867138
2024,Ohio,Knox County,63320,124,756,717,39,38,48,86,-1,3547,11.951057574,11.334534762,0.6165228113,0.6007145341,0.7587973063,1.3595118404
2024,Ohio,Lake County,231640,-96,2074,2758,-684,314,277,591,-3,2461,8.951693657,11.903939781,-2.952246124,1.3552708815,1.1955733573,2.5508442388
2024,Ohio,Lawrence County,56118,-454,524,962,-438,-1,-14,-15,-1,544,9.2998491437,17.073387168,-7.773538025,-0.017747804,-0.248469252,-0.266217056
2024,Ohio,Licking County,183201,1436,1902,1900,2,177,1256,1433,1,4137,10.422888707,10.411928782,0.010959925,0.9699533655,6.8828329214,7.8527862869
2024,Ohio,Logan County,46057,-5,524,537,-13,19,-9,10,-2,391,11.376588977,11.658832597,-0.28224362,0.4125099057,-0.195399429,0.2171104767
2024,Ohio,Lorain County,317910,1879,3200,3558,-358,321,1927,2248,-11,8173,10.095576718,11.225019363,-1.129442645,1.0127125395,6.0794301047,7.0921426442
2024,Ohio,Lucas County,425484,-1235,4957,4811,146,563,-1964,-1401,20,9849,11.633378432,11.290737066,0.342641366,1.3212814318,-4.60923043,-3.287948998
2024,Ohio,Madison County,44602,1021,449,474,-25,52,986,1038,8,4872,10.183368677,10.750371387,-0.56700271,1.1793656374,22.362586893,23.541952531
2024,Ohio,Mahoning County,225596,-326,2379,3197,-818,284,213,497,-5,7134,10.537785869,14.161118715,-3.623332846,1.2579786409,0.9434839807,2.2014626216
2024,Ohio,Marion County,64851,242,723,845,-122,8,351,359,5,5474,11.169473196,13.054225243,-1.884752047,0.1235902982,5.4225243318,5.54611463
2024,Ohio,Medina County,184042,553,1667,1761,-94,117,543,660,-13,1713,9.0713436418,9.5828651189,-0.511521477,0.6366809875,2.9548527879,3.5915337754
2024,Ohio,Meigs County,21767,-194,207,374,-167,17,-45,-28,1,178,9.4676180022,17.105744603,-7.638126601,0.7775338456,-2.058177827,-1.280643981
2024,Ohio,Mercer County,42439,15,650,437,213,24,-224,-200,2,533,15.318807961,10.298952429,5.0198555319,0.5656175247,-5.279096897,-4.713479373
2024,Ohio,Miami County,110876,663,1147,1280,-133,150,651,801,-5,960,10.375911963,11.579047352,-1.203135389,1.3569196116,5.8890311142,7.2459507257
2024,Ohio,Monroe County,13153,-62,121,220,-99,9,30,39,-2,78,9.1777912621,16.686893204,-7.509101942,0.6826456311,2.2754854369,2.958131068
2024,Ohio,Montgomery County,533796,322,6115,6581,-466,1282,-505,777,11,13382,11.459143422,12.332399487,-0.873256065,2.4023911475,-0.946339727,1.4560514209
2024,Ohio,Morgan County,13646,-23,137,231,-94,0,71,71,0,129,10.031118433,16.913783635,-6.882665202,0.0,5.198608823,5.198608823
2024,Ohio,Morrow County,35595,259,373,392,-19,0,280,280,-2,290,10.517263256,11.052995164,-0.535731908,0.0,7.8949965459,7.8949965459
2024,Ohio,Muskingum County,86305,191,985,1045,-60,7,245,252,-1,1551,11.425654945,12.121633927,-0.695978981,0.0811975478,2.8419141742,2.923111722
2024,Ohio,Noble County,14311,-14,147,149,-2,2,-14,-12,0,2746,10.266797039,10.406481352,-0.139684313,0.1396843135,-0.977790194,-0.838105881
2024,Ohio,Ottawa County,39803,-165,280,573,-293,14,114,128,0,473,7.020095022,14.366123027,-7.346028005,0.3510047511,2.8581815447,3.2091862958
2024,Ohio,Paulding County,18706,-56,220,224,-4,3,-57,-54,2,88,11.743354329,11.956869862,-0.213515533,0.1601366499,-3.042596349,-2.882459699
2024,Ohio,Perry County,35551,80,379,430,-51,2,131,133,-2,316,10.672749289,12.108923995,-1.436174706,0.0563205767,3.6889977753,3.7453183521
2024,Ohio,Pickaway County,61086,1079,625,701,-76,13,1142,1155,0,4176,10.322644579,11.57787816,-1.255233581,0.2147110072,18.861536175,19.076247182
2024,Ohio,Pike County,27001,-11,315,436,-121,-1,112,111,-1,365,11.663858701,16.144261567,-4.480402866,-0.037028123,4.1471497602,4.1101216374
2024,Ohio,Portage County,162665,923,1363,1720,-357,315,966,1281,-1,7133,8.4030245956,10.60396354,-2.200938944,1.9420049506,5.9554818484,7.897486799
2024,Ohio,Preble County,40556,-18,401,534,-133,7,112,119,-4,338,9.8853691606,13.164057685,-3.278688525,0.1725625539,2.7610008628,2.9335634167
2024,Ohio,Putnam County,34199,-131,416,370,46,16,-196,-180,3,398,12.140845481,10.798348145,1.3424973369,0.4669555954,-5.720206044,-5.253250449
2024,Ohio,Richland County,125064,-197,1354,1638,-284,65,21,86,1,7312,10.817936682,13.086986917,-2.269050235,0.5193248777,0.1677818836,0.6871067612
2024,Ohio,Ross County,76501,-7,776,1068,-292,3,279,282,3,5170,10.143194191,13.959963139,-3.816768948,0.0392133796,3.6468443033,3.6860576829
2024,Ohio,Sandusky County,58709,142,577,762,-185,83,245,328,-1,853,9.8400354719,12.994986186,-3.154950715,1.4154643746,4.1781779733,5.593642348
2024,Ohio,Scioto County,71969,-220,731,1152,-421,14,187,201,0,3182,10.141650134,15.982463686,-5.840813552,0.1942313295,2.5943756156,2.7886069452
2024,Ohio,Seneca County,54527,-7,592,669,-77,57,13,70,0,2288,10.856309772,12.268363576,-1.412053805,1.0452865827,0.2383986943,1.283685277
2024,Ohio,Shelby County,47765,81,619,546,73,33,-25,8,0,480,12.970277321,11.440664648,1.5296126727,0.6914687425,-0.523839956,0.1676287861
2024,Ohio,Stark County,372716,-69,3934,4637,-703,235,403,638,-4,7401,10.553976453,12.439956486,-1.885980032,0.6304485172,1.081152138,1.7116006551
2024,Ohio,Summit County,535733,-36,5430,6346,-916,1166,-300,866,14,8742,10.135305394,11.845054886,-1.709749492,2.1763841785,-0.559961624,1.6164225545
2024,Ohio,Trumbull County,200373,-353,1974,2854,-880,45,486,531,-4,3760,9.8429564771,14.230900601,-4.387944124,0.2243835063,2.4233418682,2.6477253745
2024,Ohio,Tuscarawas County,91874,-97,1131,1206,-75,69,-93,-24,2,1051,12.303842911,13.119747613,-0.815904702,0.7506323261,-1.011721831,-0.261089505
2024,Ohio,Union County,69637,2761,723,497,226,100,2437,2537,-2,2883,10.592397794,7.2813578194,3.3110399742,1.4650619355,35.703559368,37.168621303
2024,Ohio,Van Wert County,28704,-100,339,361,-22,26,-105,-79,1,369,11.789664047,12.554774988,-0.765110941,0.9042220213,-3.651665855,-2.747443834
2024,Ohio,Vinton County,12474,-103,149,220,-71,0,-32,-32,0,56,11.895732705,17.564169095,-5.66843639,0.0,-2.554788232,-2.554788232
2024,Ohio,Warren County,252148,2413,2462,2078,384,814,1243,2057,-28,4339,9.8110515798,8.2808144528,1.530237127,3.2437839098,4.9533457001,8.1971296099
2024,Ohio,Washington County,58577,-291,524,849,-325,42,-6,36,-2,1328,8.9233258121,14.457831325,-5.534505513,0.7152284048,-0.102175486,0.6130529184
2024,Ohio,Wayne County,116510,-42,1410,1346,64,152,-265,-113,7,3991,12.099784607,11.550574525,0.5492100814,1.3043739434,-2.274072993,-0.96969905
2024,Ohio,Williams County,36591,-57,404,471,-67,36,-27,9,1,998,11.032373462,12.861999754,-1.829626292,0.9830827838,-0.737312088,0.2457706959
2024,Ohio,Wood County,132650,1008,1254,1232,22,241,739,980,6,6022,9.4895040334,9.3230215065,0.1664825269,1.8237404083,5.5922994264,7.4160398347
2024,Ohio,Wyandot County,21457,-95,209,299,-90,6,-12,-6,1,270,9.718896045,13.904066591,-4.185170546,0.2790113697,-0.558022739,-0.27901137
2024,Oklahoma,Oklahoma,4053824,34553,48073,45506,2567,8380,23587,31967,19,117382,11.909434981,11.273495481,0.6359395003,2.0760315591,5.8433599506,7.9193915097
2024,Oklahoma,Adair County,19627,111,313,319,-6,6,111,117,0,193,15.992642363,16.299210587,-0.306568224,0.3065682242,5.6715121478,5.978080372
2024,Oklahoma,Alfalfa County,5673,-16,41,47,-6,18,-27,-9,-1,1162,7.2170392537,8.2731913396,-1.056152086,3.1684562577,-4.752684387,-1.584228129
2024,Oklahoma,Atoka County,14525,198,133,177,-44,23,219,242,0,1581,9.2194648551,12.269513379,-3.050048523,1.5943435464,15.180923333,16.775266879
2024,Oklahoma,Beaver County,5018,-1,64,57,7,33,-41,-8,0,52,12.752814586,11.357975491,1.3948390953,6.5756700209,-8.169771844,-1.594101823
2024,Oklahoma,Beckham County,22042,66,221,285,-64,-4,133,129,1,2399,10.041346722,12.949248035,-2.907901313,-0.181743832,6.0429824163,5.8612385842
2024,Oklahoma,Blaine County,8539,94,120,147,-27,60,61,121,0,88,14.130946773,17.310409797,-3.179463024,7.0654733867,7.1832312765,14.248704663
2024,Oklahoma,Bryan County,48967,929,526,644,-118,42,1008,1050,-3,907,10.844801814,13.2776661,-2.432864285,0.8659347456,20.782433895,21.648368641
2024,Oklahoma,Caddo County,26214,-23,307,419,-112,83,6,89,0,3624,11.706163848,15.976816457,-4.270652609,3.16485863,0.2287849612,3.3936435912
2024,Oklahoma,Canadian County,175829,6575,1977,1185,792,158,5634,5792,-9,2298,11.458112976,6.8679129369,4.5902000388,0.9157217249,32.653013913,33.568735638
2024,Oklahoma,Carter County,48596,260,608,747,-139,79,316,395,4,599,12.544876821,15.412866752,-2.867989931,1.6300086659,6.5200346635,8.1500433293
2024,Oklahoma,Cherokee County,48185,111,514,588,-74,38,145,183,2,1882,10.679520876,12.217039446,-1.53751857,0.7895365628,3.0127053055,3.8022418683
2024,Oklahoma,Choctaw County,14276,-131,177,290,-113,4,-21,-17,-1,137,12.34180525,20.221036851,-7.879231601,0.2789108531,-1.464281979,-1.185371126
2024,Oklahoma,Cimarron County,2191,-42,23,31,-8,0,-34,-34,0,4,10.397830018,14.014466546,-3.616636528,0.0,-15.37070524,-15.37070524
2024,Oklahoma,Cleveland County,301193,1709,2688,2227,461,662,588,1250,-2,13178,8.9499015278,7.4149667792,1.5349347486,2.2041796173,1.9577909592,4.1619705765
2024,Oklahoma,Coal County,5266,-25,65,94,-29,2,2,4,0,47,12.314104386,17.808089419,-5.493985034,0.3788955196,0.3788955196,0.7577910391
2024,Oklahoma,Comanche County,121574,-651,1553,1286,267,142,-1057,-915,-3,9310,12.740003035,10.549674117,2.1903289185,1.1648940316,-8.671077404,-7.506183372
2024,Oklahoma,Cotton County,5427,-22,57,104,-47,0,27,27,-2,36,10.481794777,19.124678191,-8.642883413,0.0,4.9650606841,4.9650606841
2024,Oklahoma,Craig County,14494,318,159,216,-57,41,338,379,-4,985,11.091733519,15.068015347,-3.976281828,2.8601325427,23.578653645,26.438786188
2024,Oklahoma,Creek County,73332,646,774,945,-171,20,803,823,-6,731,10.6014327,12.943609692,-2.342176992,0.2739388295,10.998644003,11.272582832
2024,Oklahoma,Custer County,28266,227,357,328,29,18,183,201,-3,1381,12.680934198,11.650830299,1.0301038984,0.6393748335,6.5003108072,7.1396856407
2024,Oklahoma,Delaware County,41703,223,436,705,-269,12,476,488,4,549,10.482911172,16.950578844,-6.467667672,0.288520491,11.444646142,11.733166633
2024,Oklahoma,Dewey County,4286,-118,63,80,-17,1,-102,-101,0,58,14.499424626,18.411967779,-3.912543153,0.2301495972,-23.47525892,-23.24510932
2024,Oklahoma,Ellis County,3648,-35,40,50,-10,9,-34,-25,0,45,10.912563088,13.64070386,-2.728140772,2.4553266949,-9.275678625,-6.82035193
2024,Oklahoma,Garfield County,62023,72,819,781,38,121,-89,32,2,1611,13.212447771,12.599416007,0.6130317647,1.9520221982,-1.435784923,0.5162372756
2024,Oklahoma,Garvin County,25865,94,325,426,-101,23,172,195,0,154,12.588116818,16.500116198,-3.91199938,0.890851344,6.6620187466,7.5528700906
2024,Oklahoma,Grady County,57375,727,572,650,-78,33,776,809,-4,1641,10.033063505,11.401208528,-1.368145023,0.5788305868,13.61128895,14.190119537
2024,Oklahoma,Grant County,4083,-39,45,70,-25,1,-14,-13,-1,78,10.968921389,17.062766606,-6.093845216,0.2437538087,-3.412553321,-3.168799512
2024,Oklahoma,Greer County,5466,-80,53,93,-40,2,-42,-40,0,870,9.6258626952,16.890664729,-7.264802034,0.3632401017,-7.628042136,-7.264802034
2024,Oklahoma,Harmon County,2392,-24,27,47,-20,0,-4,-4,0,53,11.231281198,19.550748752,-8.319467554,0.0,-1.663893511,-1.663893511
2024,Oklahoma,Harper County,3190,25,27,38,-11,24,12,36,0,43,8.4972462628,11.959087333,-3.46184107,7.5531077891,3.7765538946,11.329661684
2024,Oklahoma,Haskell County,11832,165,152,189,-37,9,192,201,1,60,12.936720712,16.085790885,-3.149070173,0.7659900421,16.341120899,17.107110941
2024,Oklahoma,Hughes County,13436,2,158,222,-64,-1,66,65,1,1791,11.760327503,16.524004466,-4.763676963,-0.074432453,4.9125418683,4.8381094157
2024,Oklahoma,Jackson County,24669,10,358,276,82,52,-121,-69,-3,726,14.515082712,11.190398962,3.3246837496,2.1083360363,-4.905935777,-2.797599741
2024,Oklahoma,Jefferson County,5347,-61,57,93,-36,3,-29,-26,1,55,10.59972106,17.294281729,-6.694560669,0.5578800558,-5.392840539,-4.834960483
2024,Oklahoma,Johnston County,10216,-130,117,175,-58,4,-74,-70,-2,385,11.380215932,17.021690497,-5.641474565,0.3890672114,-7.19774341,-6.808676199
2024,Oklahoma,Kay County,43641,-97,553,631,-78,9,-28,-19,0,1102,12.657503519,14.442829513,-1.785325994,0.2059991531,-0.640886254,-0.434887101
2024,Oklahoma,Kingfisher County,15481,253,153,166,-13,74,193,267,-1,266,9.9645055196,10.811162851,-0.846657332,4.8194340421,12.569605002,17.389039044
2024,Oklahoma,Kiowa County,8398,-82,107,141,-34,4,-50,-46,-2,132,12.679227397,16.708140775,-4.028913378,0.4739898092,-5.924872615,-5.450882806
2024,Oklahoma,Latimer County,9526,-30,101,162,-61,2,31,33,-2,302,10.585892464,16.979352269,-6.393459805,0.209621633,3.2491353108,3.4587569437
2024,Oklahoma,Le Flore County,49596,594,769,736,33,35,525,560,1,1666,15.598693685,14.929308911,0.6693847745,0.7099535488,10.649303231,11.35925678
2024,Oklahoma,Lincoln County,34562,428,325,452,-127,7,555,562,-7,224,9.4619774077,13.159427041,-3.697449633,0.2037964365,16.158146035,16.361942471
2024,Oklahoma,Logan County,53029,1105,541,467,74,83,950,1033,-2,1952,10.309376578,8.8992215563,1.4101550218,1.5816603623,18.103341496,19.685001858
2024,Oklahoma,Love County,10296,122,101,140,-39,10,151,161,0,77,9.868099658,13.678553981,-3.810454323,0.9770395701,14.753297509,15.730337079
2024,Oklahoma,McClain County,47072,1662,455,403,52,16,1599,1615,-5,316,9.8397526005,8.7152094462,1.1245431543,0.3460132783,34.579701996,34.925715274
2024,Oklahoma,McCurtain County,30660,-113,356,554,-198,41,45,86,-1,291,11.589862126,18.035909039,-6.446046913,1.3347874921,1.465010662,2.7997981541
2024,Oklahoma,McIntosh County,19603,200,189,393,-204,1,404,405,-1,321,9.6908167974,20.150746039,-10.45992924,0.0512741629,20.714761832,20.766035994
2024,Oklahoma,Major County,7581,45,86,115,-29,7,66,73,1,97,11.377918899,15.214658993,-3.836740094,0.9261096778,8.7318912483,9.6580009261
2024,Oklahoma,Marshall County,15970,49,214,257,-43,52,38,90,2,177,13.420714308,16.117399893,-2.696685585,3.2611081496,2.383117494,5.6442256436
2024,Oklahoma,Mayes County,39889,319,478,607,-129,4,445,449,-1,420,12.031362086,15.278319637,-3.24695755,0.1006808543,11.200745038,11.301425893
2024,Oklahoma,Murray County,13754,73,153,216,-63,-1,138,137,-1,413,11.153635867,15.746309459,-4.592673592,-0.072899581,10.060142154,9.9872425734
2024,Oklahoma,Muskogee County,66677,370,845,1045,-200,39,527,566,4,3636,12.708295735,15.716176382,-3.007880647,0.5865367262,7.9257655056,8.5123022318
2024,Oklahoma,Noble County,10832,-13,88,171,-83,15,56,71,-1,357,8.119204687,15.777090926,-7.657886239,1.3839553444,5.166766619,6.5507219634
2024,Oklahoma,Nowata County,9438,25,107,151,-44,8,60,68,1,108,11.352182908,16.020370272,-4.668187364,0.8487613389,6.3657100419,7.2144713808
2024,Oklahoma,Okfuskee County,11300,73,140,179,-39,12,100,112,0,1235,12.42952901,15.892040662,-3.462511653,1.0653882008,8.8782350069,9.9436232077
2024,Oklahoma,Oklahoma County,808866,5763,10906,7664,3242,2539,-56,2483,38,16000,13.531277587,9.5088677264,4.0224098602,3.15018465,-0.069480244,3.0807044056
2024,Oklahoma,Okmulgee County,37035,24,432,636,-204,3,225,228,0,1315,11.668422332,17.178510656,-5.510088323,0.0810307106,6.0773032979,6.1583340086
2024,Oklahoma,Osage County,46130,278,420,569,-149,-1,429,428,-1,1400,9.1322215216,12.371985823,-3.239764302,-0.021743385,9.3279119828,9.3061685982
2024,Oklahoma,Ottawa County,30287,-42,432,533,-101,27,31,58,1,994,14.253662399,17.586115877,-3.332453478,0.8908539,1.0228322555,1.9136861555
2024,Oklahoma,Pawnee County,15864,183,162,256,-94,0,279,279,-2,174,10.271041369,16.230781423,-5.959740054,0.0,17.689015692,17.689015692
2024,Oklahoma,Payne County,83352,651,750,692,58,463,130,593,0,9463,9.033260465,8.3346883224,0.6985721426,5.5765327937,1.5657651473,7.142297941
2024,Oklahoma,Pittsburg County,43479,3,487,699,-212,12,204,216,-1,2055,11.201196021,16.077281352,-4.876085331,0.2760048301,4.6920821114,4.9680869415
2024,Oklahoma,Pontotoc County,38396,364,458,549,-91,11,446,457,-2,727,11.985136337,14.366462553,-2.381326216,0.2878526195,11.671115298,11.958967918
2024,Oklahoma,Pottawatomie County,73791,440,841,1033,-192,18,608,626,6,3436,11.43113455,14.04085849,-2.60972394,0.2446616194,8.2641258104,8.5087874298
2024,Oklahoma,Pushmataha County,10800,91,100,249,-149,6,235,241,-1,116,9.298433214,23.153098703,-13.85466549,0.5579059928,21.851318053,22.409224046
2024,Oklahoma,Roger Mills County,3295,-42,35,43,-8,7,-41,-34,0,6,10.554885404,12.967430639,-2.412545235,2.1109770808,-12.36429433,-10.25331725
2024,Oklahoma,Rogers County,100248,1188,1055,988,67,57,1073,1130,-9,1787,10.586629739,9.9143034901,0.6723262488,0.5719790475,10.767254701,11.339233749
2024,Oklahoma,Seminole County,23565,101,286,398,-112,12,201,213,0,604,12.162708116,16.925726679,-4.763018563,0.5103234175,8.5479172426,9.05824066
2024,Oklahoma,Sequoyah County,40291,490,600,594,6,2,481,483,1,411,14.982769815,14.832942117,0.1498276981,0.049942566,12.011187135,12.061129701
2024,Oklahoma,Stephens County,44014,398,480,640,-160,40,520,560,-2,603,10.955152345,14.606869793,-3.651717448,0.9129293621,11.868081707,12.781011069
2024,Oklahoma,Texas County,20371,-134,339,152,187,191,-512,-321,0,368,16.586750171,7.4371269204,9.1496232508,9.3453371171,-25.05137489,-15.70603777
2024,Oklahoma,Tillman County,6869,-102,63,125,-62,0,-39,-39,-1,118,9.1040462428,18.063583815,-8.959537572,0.0,-5.63583815,-5.63583815
2024,Oklahoma,Tulsa County,682868,5807,8632,6662,1970,2642,1152,3794,43,11953,12.694780389,9.7975703143,2.8972100749,3.8854969634,1.6942060946,5.579703058
2024,Oklahoma,Wagoner County,89280,2583,914,816,98,100,2391,2491,-6,284,10.387721123,9.273939208,1.1137819147,1.1365121578,27.174005694,28.310517852
2024,Oklahoma,Washington County,53706,468,579,702,-123,89,508,597,-6,1160,10.828096948,13.128366248,-2.3002693,1.6644225015,9.500299222,11.164721724
2024,Oklahoma,Washita County,10736,0,117,155,-38,7,29,36,2,226,10.897913562,14.437406855,-3.539493294,0.6520119225,2.7011922504,3.3532041729
2024,Oklahoma,Woods County,8564,-38,87,93,-6,3,-36,-33,1,1017,10.136315973,10.835372247,-0.699056274,0.349528137,-4.194337644,-3.844809507
2024,Oklahoma,Woodward County,19947,-68,211,241,-30,16,-55,-39,1,1360,10.56003203,12.061458385,-1.501426355,0.8007607227,-2.752614984,-1.951854262
2024,Oregon,Oregon,4233358,-6021,39046,43285,-4239,4304,-6051,-1747,-35,97030,9.2168563712,10.21747754,-1.000621169,1.0159644988,-1.428346,-0.412381501
2024,Oregon,Baker County,16912,-25,144,270,-126,4,98,102,-1,426,8.5083754321,15.953203935,-7.444828503,0.236343762,5.790422169,6.026765931
2024,Oregon,Benton County,97713,52,620,670,-50,323,-223,100,2,6493,6.3468015191,6.8586403513,-0.511838832,3.3064788559,-2.282801192,1.0236776644
2024,Oregon,Clackamas County,423173,55,3638,3881,-243,228,76,304,-6,3921,8.5975155118,9.1717860641,-0.574270552,0.5388217528,0.1796072509,0.7184290037
2024,Oregon,Clatsop County,41102,-550,304,540,-236,27,-334,-307,-7,509,7.3470768785,13.050728666,-5.703651787,0.6525364333,-8.07211736,-7.419580927
2024,Oregon,Columbia County,53880,273,442,563,-121,-6,401,395,-1,502,8.2242503745,10.475685432,-2.251435057,-0.111641408,7.4613674212,7.3497260134
2024,Oregon,Coos County,64212,-711,507,1117,-610,22,-111,-89,-12,1315,7.8522476478,17.299725094,-9.447477446,0.3407286948,-1.719131142,-1.378402447
2024,Oregon,Crook County,26952,575,244,326,-82,0,657,657,0,157,9.1507434979,12.225993362,-3.075249864,0.0,24.63950196,24.63950196
2024,Oregon,Curry County,23296,-317,144,469,-325,-10,21,11,-3,178,6.1395467821,19.996162783,-13.856616,-0.426357415,0.8953505724,0.468993157
2024,Oregon,Deschutes County,208513,2030,1848,1729,119,48,1841,1889,22,1699,8.9061099384,8.3326104348,0.5734995036,0.2313275309,8.8723746735,9.1037022044
2024,Oregon,Douglas County,112435,145,951,1889,-938,4,1078,1082,1,1661,8.4636778285,16.811658694,-8.347980866,0.0355990655,9.5939481589,9.6295472244
2024,Oregon,Gilliam County,2026,18,18,36,-18,-1,38,37,-1,25,8.9241447695,17.848289539,-8.924144769,-0.495785821,18.83986118,18.344075359
2024,Oregon,Grant County,7215,-10,69,115,-46,5,30,35,1,68,9.5567867036,15.927977839,-6.371191136,0.6925207756,4.1551246537,4.8476454294
2024,Oregon,Harney County,7440,-92,78,109,-31,-2,-59,-61,0,135,10.419449639,14.560512958,-4.141063318,-0.267165375,-7.881378573,-8.148543949
2024,Oregon,Hood River County,23745,-290,221,194,27,-2,-313,-315,-2,374,9.2507325241,8.1205525324,1.1301799916,-0.083717036,-13.1017162,-13.18543324
2024,Oregon,Jackson County,220768,-901,2083,2758,-675,-9,-216,-225,-1,3273,9.4160298528,12.46731173,-3.051281877,-0.040683758,-0.976410201,-1.017093959
2024,Oregon,Jefferson County,25454,130,262,293,-31,-3,162,159,2,1095,10.319429674,11.540430895,-1.221001221,-0.118161408,6.3807160581,6.2625546497
2024,Oregon,Josephine County,87821,21,802,1446,-644,23,644,667,-2,1502,9.1333041037,16.46727897,-7.333974866,0.2619276738,7.3339748663,7.5959025401
2024,Oregon,Klamath County,70003,-187,740,1009,-269,-12,93,81,1,1034,10.556875165,14.394441948,-3.837566783,-0.17119257,1.3267424194,1.1555498491
2024,Oregon,Lake County,8293,-80,81,145,-64,13,-29,-16,0,543,9.7203888156,17.400696028,-7.680307212,1.5600624025,-3.480139206,-1.920076803
2024,Oregon,Lane County,381181,-1000,3033,4439,-1406,255,154,409,-3,13194,7.9464264661,11.630130921,-3.683704455,0.6680971806,0.4034782973,1.071575478
2024,Oregon,Lincoln County,50821,69,356,765,-409,32,442,474,4,567,7.0097368395,15.063058096,-8.053321257,0.6300887047,8.7031002333,9.333188938
2024,Oregon,Linn County,131496,874,1391,1576,-185,10,1045,1055,4,1418,10.613540467,12.025118458,-1.411577992,0.0763015131,7.9735081147,8.0498096277
2024,Oregon,Malheur County,32044,186,365,376,-11,11,188,199,-2,3190,11.423742606,11.76801978,-0.344277174,0.3442771744,5.8840098901,6.2282870646
2024,Oregon,Marion County,346741,22,3847,3380,467,265,-712,-447,2,10681,11.095088397,9.7482190754,1.346869322,0.7642834482,-2.053471,-1.289187552
2024,Oregon,Morrow County,12302,10,139,126,13,18,-21,-3,0,28,11.303569976,10.246401561,1.0571684151,1.4637716516,-1.707733594,-0.243961942
2024,Oregon,Multnomah County,789698,-4865,7271,6731,540,1158,-6518,-5360,-45,22225,9.1790430996,8.4973372443,0.6817058553,1.4618803341,-8.228442157,-6.766561823
2024,Oregon,Polk County,89805,212,864,885,-21,43,192,235,-2,2084,9.632214406,9.8663307283,-0.234116322,0.479381041,2.1404920902,2.6198731313
2024,Oregon,Sherman County,1951,4,22,25,-3,1,7,8,-1,0,11.287839918,12.827090816,-1.539250898,0.5130836326,3.5915854284,4.1046690611
2024,Oregon,Tillamook County,27417,-104,209,419,-210,-3,107,104,2,402,7.6085769413,15.253558557,-7.644981616,-0.109214023,3.8953001565,3.7860861335
2024,Oregon,Umatilla County,80053,-208,789,842,-53,27,-185,-158,3,4569,9.8431827538,10.504385144,-0.66120239,0.3368389536,-2.307970608,-1.971131654
2024,Oregon,Union County,25944,-221,255,351,-96,7,-132,-125,0,359,9.7871768792,13.471761116,-3.684584237,0.2686676006,-5.066303326,-4.797635725
2024,Oregon,Wallowa County,7674,24,60,115,-55,0,80,80,-1,61,7.830853563,15.009135996,-7.178282433,0.0,10.441138084,10.441138084
2024,Oregon,Wasco County,26333,-222,248,388,-140,0,-80,-80,-2,669,9.3783088791,14.672515504,-5.294206625,0.0,-3.025260929,-3.025260929
2024,Oregon,Washington County,598865,-1221,5973,4131,1842,1709,-4782,-3073,10,7231,9.9637099431,6.8910239034,3.0726860397,2.8508254299,-7.976973204,-5.126147774
2024,Oregon,Wheeler County,1436,1,7,21,-14,0,14,14,1,9,4.8763497039,14.629049112,-9.752699408,0.0,9.7526994079,9.7526994079
2024,Oregon,Yamhill County,108644,282,1021,1156,-135,119,296,415,2,5433,9.4098780679,10.654083297,-1.244205229,1.0967438688,2.7280351695,3.8247790384
2024,Pennsylvania,Pennsylvania,12961683,-10408,129489,140568,-11079,25776,-24825,951,-280,433964,9.9861285133,10.840535589,-0.854407075,1.9878325461,-1.91449189,0.0733406561
2024,Pennsylvania,Adams County,106748,789,953,1142,-189,76,909,985,-7,4805,8.9606830053,10.737775438,-1.777092432,0.7145980151,8.5469683649,9.26156638
2024,Pennsylvania,Allegheny County,1224825,-7780,11896,13684,-1788,2674,-8665,-5991,-1,39263,9.6816592945,11.136838079,-1.455178784,2.1762573095,-7.052082867,-4.875825558
2024,Pennsylvania,Armstrong County,64074,-630,526,977,-451,12,-192,-180,1,676,8.169097206,15.173399183,-7.004301977,0.1863672366,-2.981875786,-2.79550855
2024,Pennsylvania,Beaver County,165631,-106,1463,2202,-739,63,568,631,2,2877,8.8300620458,13.290359962,-4.460297917,0.3802419063,3.4282127423,3.8084546486
2024,Pennsylvania,Bedford County,47350,-71,463,675,-212,19,126,145,-4,313,9.7709214844,14.244863935,-4.473942451,0.4009665404,2.6590412679,3.0600078083
2024,Pennsylvania,Berks County,432821,1248,4567,4304,263,1086,-103,983,2,13644,10.566940539,9.9584217382,0.6085188005,2.5127430315,-0.238317249,2.2744257827
2024,Pennsylvania,Blair County,120273,-461,1123,1685,-562,54,46,100,1,4127,9.3192313916,13.982996345,-4.663764953,0.4481197642,0.3817316509,0.8298514151
2024,Pennsylvania,Bradford County,59695,-159,622,788,-166,41,-34,7,0,636,10.405775038,13.182878987,-2.777103949,0.6859112163,-0.568804423,0.117106793
2024,Pennsylvania,Bucks County,645984,427,5821,6193,-372,875,-52,823,-24,8899,9.014038269,9.5900943137,-0.576056045,1.3549705352,-0.080523963,1.274446572
2024,Pennsylvania,Butler County,198413,1045,1615,2207,-592,120,1530,1650,-13,7191,8.1610789805,11.15263239,-2.99155341,0.6063959614,7.7315485079,8.3379444693
2024,Pennsylvania,Cambria County,130668,-761,1125,1876,-751,41,-46,-5,-5,6200,8.5846079886,14.315310744,-5.730702755,0.3128612689,-0.351015082,-0.038153813
2024,Pennsylvania,Cameron County,4380,-26,27,80,-53,1,27,28,-1,26,6.1461415889,18.210789893,-12.0646483,0.2276348737,6.1461415889,6.3737764626
2024,Pennsylvania,Carbon County,65458,-35,583,911,-328,25,267,292,1,824,8.9040938977,13.913601271,-5.009507373,0.3818222083,4.0778611847,4.459683393
2024,Pennsylvania,Centre County,157795,262,1088,1133,-45,828,-528,300,7,19670,6.9007509641,7.1861680536,-0.28541709,5.2516744469,-3.34889385,1.9027805967
2024,Pennsylvania,Chester County,549784,3146,5675,3971,1704,1163,279,1442,0,15031,10.351853575,7.2435613295,3.1082922451,2.1214459396,0.5089281317,2.6303740713
2024,Pennsylvania,Clarion County,36970,-257,344,576,-232,22,-48,-26,1,2187,9.2726121002,15.526234214,-6.253622114,0.5930158901,-1.293852851,-0.700836961
2024,Pennsylvania,Clearfield County,77090,-734,675,1142,-467,28,-298,-270,3,3828,8.7145125683,14.743664227,-6.029151658,0.3614908917,-3.847295919,-3.485805027
2024,Pennsylvania,Clinton County,37607,-169,349,472,-123,10,-56,-46,0,1811,9.2593820888,12.522717324,-3.263335235,0.2653118077,-1.485746123,-1.220434315
2024,Pennsylvania,Columbia County,65439,150,542,821,-279,28,403,431,-2,4044,8.2920261918,12.560430818,-4.268404626,0.4283703568,6.1654733492,6.593843706
2024,Pennsylvania,Crawford County,82001,-404,870,1141,-271,18,-152,-134,1,3203,10.583555345,13.88027201,-3.296716665,0.2189701106,-1.849080934,-1.630110823
2024,Pennsylvania,Cumberland County,270738,2206,2508,2504,4,451,1773,2224,-22,14200,9.301463089,9.2866282196,0.0148348694,1.6726315204,6.575555844,8.2481873644
2024,Pennsylvania,Dauphin County,289234,547,3081,2887,194,823,-482,341,12,6882,10.662356966,9.990984927,0.6713720387,2.8481401437,-1.668048055,1.1800920887
2024,Pennsylvania,Delaware County,576720,847,6383,5362,1021,1585,-1788,-203,29,23036,11.075895828,9.3042383565,1.7716574715,2.7503203646,-3.102569597,-0.352249233
2024,Pennsylvania,Elk County,30198,-269,259,445,-186,-2,-81,-83,0,296,8.538696118,14.670732712,-6.132036594,-0.065935877,-2.670403033,-2.73633891
2024,Pennsylvania,Erie County,267571,-1269,2738,3050,-312,366,-1332,-966,9,13506,10.208590055,11.371877161,-1.163287106,1.3646252594,-4.966341108,-3.601715848
2024,Pennsylvania,Fayette County,123915,-1453,723,2112,-1389,84,-148,-64,0,3746,5.8006362247,16.944597104,-11.14396088,0.6739328394,-1.187405479,-0.51347264
2024,Pennsylvania,Forest County,6449,-154,23,117,-94,2,-62,-60,0,2448,3.5243640821,17.928286853,-14.40392277,0.3064664419,-9.5004597,-9.193993258
2024,Pennsylvania,Franklin County,157854,903,1718,1855,-137,226,818,1044,-4,1620,10.914693223,11.785073299,-0.870380077,1.4358094694,5.1968679024,6.6326773717
2024,Pennsylvania,Fulton County,14468,-86,135,231,-96,4,6,10,0,130,9.3032871615,15.918958032,-6.61567087,0.2756529529,0.4134794294,0.6891323823
2024,Pennsylvania,Greene County,34357,-172,158,507,-349,-4,181,177,0,2784,4.5872891444,14.719972128,-10.13268298,-0.116133902,5.2550590831,5.1389251807
2024,Pennsylvania,Huntingdon County,43514,217,417,567,-150,10,355,365,2,4788,9.6070774441,13.062860697,-3.455783253,0.2303855502,8.1786870327,8.409072583
2024,Pennsylvania,Indiana County,83094,30,733,1038,-305,78,256,334,1,6031,8.822927575,12.494132091,-3.671204516,0.9388654173,3.0814044464,4.0202698636
2024,Pennsylvania,Jefferson County,43612,-119,445,617,-172,3,50,53,0,614,10.189711826,14.128207183,-3.938495357,0.0686946865,1.1449114411,1.2136061276
2024,Pennsylvania,Juniata County,23243,-38,263,342,-79,29,12,41,0,268,11.305992606,14.702089244,-3.396096638,1.2466683862,0.5158627805,1.7625311667
2024,Pennsylvania,Lackawanna County,216123,373,2093,2675,-582,403,565,968,-13,8470,9.6926642786,12.387901073,-2.695236794,1.8662893953,2.6165099462,4.4827993415
2024,Pennsylvania,Lancaster County,558589,1929,6887,5280,1607,871,-556,315,7,15743,12.350605112,9.4687374748,2.8818676367,1.561983019,-0.997086749,0.5648962698
2024,Pennsylvania,Lawrence County,84472,-340,766,1313,-547,7,200,207,0,2043,9.0498806739,15.512393374,-6.462512701,0.0827012594,2.3628931263,2.4455943858
2024,Pennsylvania,Lebanon County,144252,350,1578,1707,-129,226,250,476,3,3350,10.952476801,11.847831368,-0.895354567,1.5686056761,1.7351832701,3.3037889462
2024,Pennsylvania,Lehigh County,377754,1480,3940,3605,335,1745,-616,1129,16,7725,10.450540298,9.5619791307,0.8885611675,4.6284753351,-1.63389158,2.9945837555
2024,Pennsylvania,Luzerne County,327388,892,3191,4124,-933,930,914,1844,-19,11011,9.7601409424,12.613858116,-2.853717173,2.8445412336,2.7956028898,5.6401441234
2024,Pennsylvania,Lycoming County,112724,-310,934,1436,-502,100,89,189,3,5138,8.274346867,12.721586832,-4.447239965,0.8859043755,0.7884548942,1.6743592697
2024,Pennsylvania,McKean County,39519,-300,324,592,-268,12,-44,-32,0,2861,8.1675867806,14.923491895,-6.755905115,0.3025032141,-1.109178452,-0.806675238
2024,Pennsylvania,Mercer County,108503,-634,1014,1654,-640,0,7,7,-1,5906,9.3181400478,15.199411873,-5.881271825,0.0,0.0643264106,0.0643264106
2024,Pennsylvania,Mifflin County,45922,-62,535,622,-87,7,17,24,1,636,11.642330207,13.535568951,-1.893238744,0.1523295541,0.3699432028,0.5222727569
2024,Pennsylvania,Monroe County,166053,-1398,1338,1702,-364,120,-1165,-1045,11,2984,8.0238917674,10.206774132,-2.182882364,0.7196315486,-6.986422951,-6.266791403
2024,Pennsylvania,Montgomery County,868742,3698,8700,7570,1130,1703,880,2583,-15,23659,10.03584064,8.7323349018,1.3035057383,1.9644869667,1.015119513,2.9796064797
2024,Pennsylvania,Montour County,17860,-194,180,237,-57,40,-175,-135,-2,674,10.023946093,13.19819569,-3.174249596,2.2275435763,-9.745503146,-7.51795957
2024,Pennsylvania,Northampton County,319091,1191,2787,3201,-414,599,1019,1618,-13,15032,8.7505160983,10.050377478,-1.29986138,1.88071731,3.1994172602,5.0801345702
2024,Pennsylvania,Northumberland County,90120,-3,874,1233,-359,29,327,356,0,3313,9.6980187858,13.681529935,-3.983511149,0.3217878087,3.6284349462,3.9502227548
2024,Pennsylvania,Perry County,46083,-30,433,544,-111,45,35,80,1,509,9.3930322357,11.800945811,-2.407913575,0.9761811792,0.7592520283,1.7354332075
2024,Pennsylvania,Philadelphia County,1550542,-16294,19208,14689,4519,7038,-27667,-20629,-184,57609,12.323176721,9.4239453797,2.8992313412,4.515333078,-17.75017338,-13.2348403
2024,Pennsylvania,Pike County,61247,671,420,649,-229,48,857,905,-5,463,6.8952496655,10.654802459,-3.759552794,0.7880285332,14.06959277,14.857621303
2024,Pennsylvania,Potter County,15999,-207,167,289,-122,0,-83,-83,-2,213,10.371060394,17.947523676,-7.576463282,0.0,-5.154479118,-5.154479118
2024,Pennsylvania,Schuylkill County,143786,598,1187,1936,-749,95,1268,1363,-16,6813,8.272526431,13.492511517,-5.219985086,0.6620808854,8.8370375017,9.499118387
2024,Pennsylvania,Snyder County,39717,211,406,421,-15,19,207,226,0,2362,10.249548742,10.628226651,-0.378677909,0.479658685,5.2257551469,5.7054138318
2024,Pennsylvania,Somerset County,72197,-432,576,1086,-510,5,72,77,1,4210,7.9543728336,14.997307113,-7.04293428,0.0690483753,0.9942966042,1.0633449795
2024,Pennsylvania,Sullivan County,5834,-11,37,131,-94,11,70,81,2,298,6.3361589177,22.433427519,-16.0972686,1.8837229215,11.987327682,13.871050604
2024,Pennsylvania,Susquehanna County,38109,-30,360,543,-183,11,144,155,-2,319,9.4428706327,14.242996538,-4.800125905,0.2885321582,3.7771482531,4.0656804113
2024,Pennsylvania,Tioga County,40840,-127,373,566,-193,3,63,66,0,1520,9.1190240444,13.837446673,-4.718422629,0.0733433569,1.5402104954,1.6135538524
2024,Pennsylvania,Union County,42042,-648,345,457,-112,37,-579,-542,6,7112,8.1433224756,10.786951801,-2.643629325,0.8733418307,-13.66661946,-12.79327763
2024,Pennsylvania,Venango County,49431,-303,459,805,-346,8,39,47,-4,875,9.257298442,16.235566984,-6.978268542,0.1613472495,0.7865678415,0.947915091
2024,Pennsylvania,Warren County,37572,-246,354,637,-283,11,27,38,-1,821,9.3911659371,16.898792943,-7.507627006,0.2918158907,0.7162753681,1.0080912588
2024,Pennsylvania,Washington County,210232,292,1867,2664,-797,103,996,1099,-10,4629,8.8868368192,12.68052131,-3.793684491,0.490275411,4.740915625,5.2311910361
2024,Pennsylvania,Wayne County,51262,178,396,774,-378,2,552,554,2,3130,7.7384558263,15.125163661,-7.386707834,0.0390831102,10.786938425,10.826021535
2024,Pennsylvania,Westmoreland County,351163,-835,2788,4710,-1922,90,1017,1107,-20,6345,7.9299051,13.396647425,-5.466742325,0.2559868935,2.8926518962,3.1486387897
2024,Pennsylvania,Wyoming County,25902,-122,249,396,-147,7,17,24,1,609,9.5905711975,15.252474675,-5.661903478,0.2696144513,0.6547779532,0.9243924046
2024,Pennsylvania,York County,464640,3591,4812,4706,106,612,2889,3501,-16,7978,10.396580277,10.167561676,0.2290186013,1.3222583395,6.2418371613,7.5640955008
2024,Rhode Island,Rhode Island,1095962,2120,10006,10434,-428,5777,-3224,2553,-5,44013,9.1387174377,9.5296200025,-0.390902565,5.276271301,-2.944555768,2.3317155325
2024,Rhode Island,Bristol County,50255,-52,342,573,-231,18,164,182,-3,3087,6.80177403,11.395954734,-4.594180704,0.3579881068,3.2616694179,3.6196575247
2024,Rhode Island,Kent County,171278,144,1458,1977,-519,339,319,658,5,1820,8.5160566803,11.547492494,-3.031435814,1.9800707919,1.8632524561,3.843323248
2024,Rhode Island,Newport County,83832,-889,632,845,-213,147,-818,-671,-5,4066,7.4991249043,10.026519848,-2.527394944,1.7442584825,-9.706145841,-7.961887359
2024,Rhode Island,Providence County,660615,3191,6744,5740,1004,4985,-2798,2187,0,27885,10.233384596,8.7099091909,1.5234754055,7.5642678252,-4.245701379,3.3185664461
2024,Rhode Island,Washington County,129982,-274,830,1299,-469,288,-91,197,-2,7155,6.3787763509,9.9831692528,-3.604392902,2.213358541,-0.699359817,1.5139987242
2024,South Carolina,South Carolina,5373555,90600,57581,58852,-1271,9291,82562,91853,18,139093,10.806727531,11.045267165,-0.238539634,1.7437228511,15.495129268,17.23885212
2024,South Carolina,Abbeville County,24434,96,217,404,-187,8,276,284,-1,840,8.8985483474,16.566882638,-7.66833429,0.3280570819,11.317969327,11.646026409
2024,South Carolina,Aiken County,177130,2902,2272,2225,47,130,2727,2857,-2,2703,12.932678351,12.665144952,0.267533399,0.7399859972,15.522629341,16.262615338
2024,South Carolina,Allendale County,7369,-49,68,152,-84,1,33,34,1,851,9.1972678704,20.558598769,-11.3613309,0.1352539393,4.4633799959,4.5986339352
2024,South Carolina,Anderson County,213076,3424,2265,2670,-405,177,3654,3831,-2,3197,10.716110596,12.632236332,-1.916125736,0.8374179141,17.287712193,18.125130107
2024,South Carolina,Bamberg County,12974,24,133,234,-101,28,97,125,0,846,10.260762228,18.052769634,-7.792007406,2.1601604691,7.4834130535,9.6435735226
2024,South Carolina,Barnwell County,20447,-24,260,315,-55,32,-2,30,1,474,12.708343516,15.396646952,-2.688303436,1.5641038174,-0.097756489,1.4663473288
2024,South Carolina,Beaufort County,198979,2832,1910,1906,4,402,2420,2822,6,8026,9.6678021694,9.6475554633,0.0202467061,2.0347939645,12.249257199,14.284051163
2024,South Carolina,Berkeley County,255217,10265,2826,1916,910,534,8801,9335,20,4244,11.300180539,7.6614104433,3.6387700957,2.1352782759,35.192105068,37.327383344
2024,South Carolina,Calhoun County,14186,-11,121,230,-109,0,97,97,1,164,8.5262304901,16.206884403,-7.680653913,0.0,6.835077335,6.835077335
2024,South Carolina,Charleston County,424367,5017,4931,3397,1534,1028,2440,3468,15,9214,11.688753456,8.0524630889,3.6362903675,2.4368360481,5.7839299196,8.2207659677
2024,South Carolina,Cherokee County,56714,593,659,843,-184,51,728,779,-2,1153,11.68077281,14.942172198,-3.261399388,0.9039748305,12.903797581,13.807772411
2024,South Carolina,Chester County,32226,233,334,516,-182,13,399,412,3,206,10.401905978,16.070010433,-5.668104455,0.4048646039,12.426228998,12.831093602
2024,South Carolina,Chesterfield County,44031,290,521,649,-128,74,345,419,-1,752,11.871667502,14.78831518,-2.916647678,1.6861869389,7.8612769448,9.5474638837
2024,South Carolina,Clarendon County,31004,77,287,539,-252,19,307,326,3,1335,9.2683793254,17.406468489,-8.138089164,0.6135860877,9.9142594177,10.527845505
2024,South Carolina,Colleton County,38874,294,456,693,-237,60,470,530,1,416,11.774730808,17.894492215,-6.119761407,1.5493066853,12.136235701,13.685542386
2024,South Carolina,Darlington County,62416,-20,726,997,-271,61,189,250,1,1022,11.629769647,15.970909557,-4.34113991,0.9771569538,3.0275846602,4.0047416141
2024,South Carolina,Dillon County,27698,-49,376,478,-102,32,20,52,1,353,13.562990351,17.242312201,-3.67932185,1.1542970511,0.721435657,1.8757327081
2024,South Carolina,Dorchester County,169833,3783,1919,1447,472,303,3021,3324,-13,1981,11.426597952,8.6160954856,2.8105024666,1.8041996767,17.988406677,19.792606354
2024,South Carolina,Edgefield County,27607,648,204,363,-159,79,729,808,-1,2390,7.4771835942,13.304988454,-5.82780486,2.8955759997,26.719935491,29.615511491
2024,South Carolina,Fairfield County,20422,-28,197,377,-180,-2,154,152,0,326,9.6398512429,18.44783715,-8.807985907,-0.09786651,7.5357212762,7.4378547661
2024,South Carolina,Florence County,137214,474,1568,1806,-238,120,594,714,-2,3127,11.447177263,13.184695241,-1.737517977,0.8760594844,4.336494448,5.2125539324
2024,South Carolina,Georgetown County,65731,1062,480,968,-488,39,1512,1551,-1,599,7.3619631902,14.846625767,-7.484662577,0.5981595092,23.190184049,23.788343558
2024,South Carolina,Greenville County,558036,10191,6521,5127,1394,1868,6908,8776,21,10266,11.7933123,9.2722453863,2.5210669141,3.3783020054,12.493206774,15.871508779
2024,South Carolina,Greenwood County,69460,237,741,948,-207,74,368,442,2,2792,10.686241284,13.671466582,-2.985225298,1.0671819906,5.3070671964,6.374249187
2024,South Carolina,Hampton County,18122,-14,195,289,-94,33,49,82,-2,1329,10.756246897,15.941309504,-5.185062607,1.8202879365,2.7028517844,4.5231397209
2024,South Carolina,Horry County,397478,14331,3199,4611,-1412,663,15061,15724,19,7940,8.1959967974,11.813610889,-3.617614091,1.6986389111,38.587029624,40.285668535
2024,South Carolina,Jasper County,33544,1558,408,385,23,102,1429,1531,4,1176,12.452311918,11.750343354,0.701968564,3.1130779796,43.613612086,46.726690066
2024,South Carolina,Kershaw County,69905,2055,724,915,-191,44,2209,2253,-7,369,10.511415194,13.284454285,-2.773039091,0.638815288,32.071431164,32.710246452
2024,South Carolina,Lancaster County,108215,3491,1248,1190,58,153,3280,3433,0,1790,11.721666768,11.176909819,0.5447569492,1.4370312625,30.806944712,32.243975974
2024,South Carolina,Laurens County,68873,922,723,1032,-309,84,1143,1227,4,1888,10.568321347,15.085072794,-4.516751447,1.2278547623,16.707595159,17.935449921
2024,South Carolina,Lee County,15967,-194,149,293,-144,61,-112,-51,1,1492,9.2753984064,18.239541833,-8.964143426,3.797310757,-6.972111554,-3.174800797
2024,South Carolina,Lexington County,309528,4423,3379,2905,474,421,3552,3973,-24,2563,10.995179237,9.452795408,1.542383829,1.3699231899,11.558116795,12.928039985
2024,South Carolina,McCormick County,9941,200,75,177,-102,0,300,300,2,757,7.6211767097,17.985977035,-10.36480033,0.0,30.484706839,30.484706839
2024,South Carolina,Marion County,28508,37,320,497,-177,-2,214,212,2,190,11.232208357,17.445023605,-6.212815248,-0.070201302,7.5115393391,7.4413380368
2024,South Carolina,Marlboro County,25704,-302,287,451,-164,-3,-135,-138,0,2590,11.100367434,17.443434539,-6.343067105,-0.116031715,-5.22142719,-5.337458905
2024,South Carolina,Newberry County,38825,510,418,540,-122,97,535,632,0,1458,10.837438424,14.000518538,-3.163080114,2.5149079596,13.870884107,16.385792066
2024,South Carolina,Oconee County,81221,1061,631,1089,-458,85,1437,1522,-3,703,7.820003594,13.496012542,-5.676008948,1.0534077741,17.808787899,18.862195674
2024,South Carolina,Orangeburg County,82820,-281,815,1301,-486,53,150,203,2,4053,9.8239523629,15.682161993,-5.85820963,0.6388582518,1.8080893919,2.4469476438
2024,South Carolina,Pickens County,135495,2025,1145,1499,-354,206,2176,2382,-3,9059,8.5141189374,11.146431692,-2.632312754,1.5317978176,16.180543937,17.712341755
2024,South Carolina,Richland County,425138,3612,4599,3522,1077,1019,1512,2531,4,27316,10.863813744,8.3197112432,2.5441025011,2.4070941956,3.5716647926,5.9787589882
2024,South Carolina,Saluda County,19123,139,242,276,-34,56,117,173,0,296,12.701078542,14.485527593,-1.784449051,2.9390925552,6.1406040885,9.0796966437
2024,South Carolina,Spartanburg County,356698,10750,3840,3772,68,645,10060,10705,-23,8173,10.930112745,10.736558665,0.1935540799,1.8359173752,28.634618286,30.470535661
2024,South Carolina,Sumter County,104165,229,1310,1364,-54,66,215,281,2,2710,12.590040413,13.109019178,-0.518978765,0.6343073796,2.0663043426,2.7006117222
2024,South Carolina,Union County,26629,-110,243,504,-261,15,135,150,1,403,9.1065807225,18.88772298,-9.781142258,0.5621346125,5.0592115125,5.621346125
2024,South Carolina,Williamsburg County,29891,-222,263,519,-256,33,0,33,1,1623,8.7660822612,17.298846744,-8.532764482,1.0999266716,0.0,1.0999266716
2024,South Carolina,York County,298320,4119,3376,2521,855,329,2948,3277,-13,3938,11.395376704,8.5094030423,2.8859736617,1.1105091634,9.9507021692,11.061211333
2024,South Dakota,South Dakota,919318,9449,11369,8556,2813,1788,4812,6600,36,32218,12.430659085,9.3549757351,3.07568335,1.9549668787,5.2613538146,7.2163206933
2024,South Dakota,Aurora County,2782,20,38,44,-6,5,20,25,1,99,13.708513709,15.873015873,-2.164502165,1.8037518038,7.215007215,9.0187590188
2024,South Dakota,Beadle County,19591,103,278,179,99,257,-252,5,-1,521,14.227590266,9.160930423,5.0666598429,13.152844239,-12.89695233,0.2558919113
2024,South Dakota,Bennett County,3305,-28,50,43,7,5,-41,-36,1,45,15.064778548,12.955709551,2.1090689967,1.5064778548,-12.35311841,-10.84664055
2024,South Dakota,Bon Homme County,7065,1,74,95,-21,4,17,21,1,1374,10.47490976,13.447519287,-2.972609527,0.5662113384,2.4063981881,2.9726095265
2024,South Dakota,Brookings County,35980,489,385,214,171,193,123,316,2,3208,10.773600481,5.9884428649,4.7851576164,5.4007919296,3.4419554784,8.842747408
2024,South Dakota,Brown County,37733,-168,412,363,49,57,-277,-220,3,1156,10.894571225,9.5988576566,1.295713568,1.5072586403,-7.324748129,-5.817489489
2024,South Dakota,Brule County,5311,10,63,48,15,7,-12,-5,0,421,11.873350923,9.0463626084,2.8269883151,1.3192612137,-2.261590652,-0.942329438
2024,South Dakota,Buffalo County,1884,30,38,41,-3,0,33,33,0,0,20.331728197,21.936864633,-1.605136437,0.0,17.656500803,17.656500803
2024,South Dakota,Butte County,10863,73,135,115,20,-2,54,52,1,104,12.469403778,10.6220847,1.8473190782,-0.184731908,4.9877615111,4.8030296033
2024,South Dakota,Campbell County,1340,-15,19,25,-6,4,-11,-7,-2,0,14.100185529,18.552875696,-4.452690167,2.9684601113,-8.163265306,-5.194805195
2024,South Dakota,Charles Mix County,9240,8,143,93,50,3,-47,-44,2,754,15.482893027,10.069294067,5.4135989606,0.3248159376,-5.088783023,-4.763967085
2024,South Dakota,Clark County,3948,25,59,35,24,23,-22,1,0,198,14.991741837,8.8934061746,6.0983356626,5.8442383433,-5.590141024,0.2540973193
2024,South Dakota,Clay County,15431,130,137,113,24,23,83,106,0,2541,8.9157881036,7.3538982168,1.5618898868,1.4968111415,5.4015358584,6.8983469999
2024,South Dakota,Codington County,28971,235,326,268,58,41,136,177,0,498,11.298455993,9.2883012459,2.0101547473,1.4209714593,4.7134663039,6.1344377632
2024,South Dakota,Corson County,3782,-35,78,68,10,0,-45,-45,0,7,20.529016976,17.897091723,2.6319252533,0.0,-11.84366364,-11.84366364
2024,South Dakota,Custer County,9117,96,77,92,-15,4,107,111,0,90,8.4904620135,10.14444812,-1.653986107,0.4410629617,11.798434226,12.239497188
2024,South Dakota,Davison County,19922,15,229,230,-1,79,-63,16,0,518,11.499158904,11.549373572,-0.050214668,3.9669587487,-3.163524065,0.8034346833
2024,South Dakota,Day County,5451,-24,46,77,-31,7,-1,6,1,101,8.4202818964,14.094819696,-5.6745378,1.2813472451,-0.183049606,1.0982976387
2024,South Dakota,Deuel County,4354,-7,56,47,9,0,-15,-15,-1,52,12.851405622,10.786001147,2.065404475,0.0,-3.442340792,-3.442340792
2024,South Dakota,Dewey County,5208,66,108,102,6,1,61,62,-2,5,20.869565217,19.710144928,1.1594202899,0.193236715,11.787439614,11.980676329
2024,South Dakota,Douglas County,2838,51,45,38,7,8,36,44,0,116,16.0,13.511111111,2.4888888889,2.8444444444,12.8,15.644444444
2024,South Dakota,Edmunds County,4057,-14,56,48,8,2,-24,-22,0,212,13.779527559,11.811023622,1.968503937,0.4921259843,-5.905511811,-5.413385827
2024,South Dakota,Fall River County,7393,-4,50,138,-88,-1,86,85,-1,231,6.7613252197,18.661257606,-11.89993239,-0.135226504,11.629479378,11.494252874
2024,South Dakota,Faulk County,2151,29,31,31,0,0,31,31,-2,382,14.509712146,14.509712146,0.0,0.0,14.509712146,14.509712146
2024,South Dakota,Grant County,7553,67,94,99,-5,46,25,71,1,243,12.500831172,13.165769001,-0.664937828,6.1174280205,3.3246891416,9.442117162
2024,South Dakota,Gregory County,4018,19,47,54,-7,7,20,27,-1,74,11.725084196,13.471373332,-1.746289136,1.7462891356,4.9893975302,6.7356866658
2024,South Dakota,Haakon County,1851,17,25,26,-1,0,18,18,0,44,13.568521031,14.111261872,-0.542740841,0.0,9.7693351425,9.7693351425
2024,South Dakota,Hamlin County,6451,57,140,53,87,20,-50,-30,0,99,21.798365123,8.252238225,13.546126898,3.1140521604,-7.785130401,-4.671078241
2024,South Dakota,Hand County,3107,-5,39,55,-16,3,7,10,1,61,12.542209358,17.687731146,-5.145521788,0.9647853353,2.2511657823,3.2159511175
2024,South Dakota,Hanson County,3471,-8,39,30,9,5,-22,-17,0,216,11.223021583,8.6330935252,2.5899280576,1.4388489209,-6.330935252,-4.892086331
2024,South Dakota,Harding County,1324,-15,17,6,11,1,-27,-26,0,3,12.767555389,4.5061960195,8.2613593691,0.7510326699,-20.27788209,-19.52684942
2024,South Dakota,Hughes County,17624,-57,219,189,30,-3,-85,-88,1,774,12.406174763,10.706698768,1.6994759949,-0.169947599,-4.815181986,-4.985129585
2024,South Dakota,Hutchinson County,7394,43,96,102,-6,9,41,50,-1,826,13.021363174,13.835198372,-0.813835198,1.2207527976,5.5612071889,6.7819599864
2024,South Dakota,Hyde County,1186,-13,13,25,-12,0,-1,-1,0,40,10.901467505,20.964360587,-10.06289308,0.0,-0.838574423,-0.838574423
2024,South Dakota,Jackson County,2776,-56,62,39,23,2,-79,-77,-2,32,22.111269615,13.908701854,8.2025677603,0.7132667618,-28.17403709,-27.46077033
2024,South Dakota,Jerauld County,1660,-2,18,18,0,1,-3,-2,0,29,10.836845274,10.836845274,0.0,0.6020469597,-1.806140879,-1.204093919
2024,South Dakota,Jones County,855,-20,8,12,-4,0,-15,-15,-1,0,9.2485549133,13.87283237,-4.624277457,0.0,-17.34104046,-17.34104046
2024,South Dakota,Kingsbury County,5276,-3,66,72,-6,4,-1,3,0,213,12.505921364,13.642823306,-1.136901942,0.7579346281,-0.189483657,0.5684509711
2024,South Dakota,Lake County,11031,91,109,108,1,10,83,93,-3,588,9.9221701334,9.8311410496,0.0910290838,0.9102908379,7.5554139548,8.4657047927
2024,South Dakota,Lawrence County,28053,813,203,272,-69,22,857,879,3,1034,7.3427016078,9.8384967356,-2.495795128,0.7957607654,30.998498906,31.794259671
2024,South Dakota,Lincoln County,73238,2214,834,328,506,63,1637,1700,8,260,11.562296377,4.5472820285,7.0150143489,0.8734108774,22.694819148,23.568230026
2024,South Dakota,Lyman County,3705,0,68,45,23,6,-27,-21,-2,88,18.353576248,12.145748988,6.2078272605,1.6194331984,-7.287449393,-5.668016194
2024,South Dakota,McCook County,5809,41,80,74,6,0,36,36,-1,212,13.820506176,12.783968213,1.0365379632,0.0,6.2192277792,6.2192277792
2024,South Dakota,McPherson County,2334,-62,20,37,-17,0,-44,-44,-1,205,8.4566596195,15.644820296,-7.188160677,0.0,-18.60465116,-18.60465116
2024,South Dakota,Marshall County,4390,27,65,56,9,13,6,19,-1,317,14.852050725,12.795612933,2.0564377928,2.9704101451,1.3709585285,4.3413686736
2024,South Dakota,Meade County,30954,252,272,244,28,9,212,221,3,1027,8.8231477877,7.9148825743,0.9082652134,0.29194239,6.8768651875,7.1688075775
2024,South Dakota,Mellette County,1851,-22,30,35,-5,0,-18,-18,1,43,16.111707841,18.796992481,-2.68528464,0.0,-9.667024705,-9.667024705
2024,South Dakota,Miner County,2280,-5,27,38,-11,0,6,6,0,65,11.829134721,16.648411829,-4.819277108,0.0,2.6286966046,2.6286966046
2024,South Dakota,Minnehaha County,206930,3085,2804,1512,1292,649,1123,1772,21,5211,13.652242712,7.3616943582,6.2905483537,3.1598807133,5.4677134684,8.6275941817
2024,South Dakota,Moody County,6450,68,93,68,25,20,23,43,0,79,14.495012469,10.598503741,3.8965087282,3.1172069825,3.5847880299,6.7019950125
2024,South Dakota,Oglala Lakota County,13434,-74,242,197,45,0,-121,-121,2,404,17.964516368,14.624007126,3.3405092421,0.0,-8.982258184,-8.982258184
2024,South Dakota,Pennington County,115903,1597,1450,1108,342,35,1213,1248,7,3924,12.597248587,9.6260354721,2.971213115,0.3040715176,10.538250025,10.842321543
2024,South Dakota,Perkins County,2834,25,34,38,-4,0,31,31,-2,61,12.05032784,13.468013468,-1.417685628,0.0,10.987063619,10.987063619
2024,South Dakota,Potter County,2413,-33,23,33,-10,0,-24,-24,1,38,9.466968512,13.583041778,-4.116073266,0.0,-9.878575839,-9.878575839
2024,South Dakota,Roberts County,10206,67,142,112,30,2,35,37,0,246,13.959203736,11.010076186,2.9491275498,0.1966085033,3.4406488081,3.6372573114
2024,South Dakota,Sanborn County,2399,-4,35,31,4,4,-13,-9,1,40,14.577259475,12.911286964,1.6659725115,1.6659725115,-5.414410662,-3.748438151
2024,South Dakota,Spink County,6166,-62,75,83,-8,4,-57,-53,-1,450,12.102630305,13.393577538,-1.290947233,0.6454736163,-9.197999032,-8.552525416
2024,South Dakota,Stanley County,3043,26,30,32,-2,0,28,28,0,0,9.900990099,10.561056106,-0.660066007,0.0,9.2409240924,9.2409240924
2024,South Dakota,Sully County,1494,12,12,14,-2,9,6,15,-1,0,8.064516129,9.4086021505,-1.344086022,6.0483870968,4.0322580645,10.080645161
2024,South Dakota,Todd County,9199,-34,195,119,76,29,-140,-111,1,92,21.158854167,12.912326389,8.2465277778,3.1467013889,-15.19097222,-12.04427083
2024,South Dakota,Tripp County,5621,42,66,60,6,1,35,36,0,245,11.785714286,10.714285714,1.0714285714,0.1785714286,6.25,6.4285714286
2024,South Dakota,Turner County,9027,139,92,107,-15,37,117,154,0,227,10.270722858,11.945297237,-1.674574379,4.1306168016,13.061680156,17.192296958
2024,South Dakota,Union County,17183,120,192,129,63,36,23,59,-2,95,11.212988378,7.5337265666,3.6792618116,2.1024353209,1.3432225661,3.4456578871
2024,South Dakota,Walworth County,5269,-17,76,69,7,-2,-22,-24,0,66,14.400757935,13.074372335,1.3263855992,-0.378967314,-4.168640455,-4.547607769
2024,South Dakota,Yankton County,23517,105,243,245,-2,25,81,106,1,1872,10.356069808,10.44130495,-0.085235142,1.0654392806,3.4520232692,4.5174625498
2024,South Dakota,Ziebach County,2322,-72,41,35,6,1,-79,-78,0,42,17.387616624,14.843087362,2.5445292621,0.4240882103,-33.50296862,-33.07888041
2024,Tennessee,Tennessee,7126489,77513,82244,81216,1028,13054,63417,76471,14,148006,11.60371106,11.458671726,0.1450393338,1.8417737972,8.9474313541,10.789205151
2024,Tennessee,Anderson County,80234,1305,830,1154,-324,64,1561,1625,4,1102,10.429559634,14.500857611,-4.071297978,0.8042070079,19.615111552,20.41931856
2024,Tennessee,Bedford County,53055,1091,713,612,101,125,863,988,2,1102,13.57849532,11.655033851,1.9234614689,2.3805216199,16.435121264,18.815642884
2024,Tennessee,Benton County,16103,109,157,317,-160,-1,267,266,3,134,9.7828457488,19.752624856,-9.969779107,-0.062311119,16.637068885,16.574757766
2024,Tennessee,Bledsoe County,15060,236,132,179,-47,5,277,282,1,1939,8.8341587472,11.979654665,-3.145495918,0.3346272253,18.53834828,18.872975505
2024,Tennessee,Blount County,141456,1646,1304,1708,-404,47,2004,2051,-1,1929,9.2723613946,12.145086857,-2.872725463,0.3342032098,14.249856008,14.584059218
2024,Tennessee,Bradley County,111579,1040,1183,1423,-240,218,1062,1280,0,2048,10.651995786,12.813009301,-2.161013515,1.9629206098,9.5624848054,11.525405415
2024,Tennessee,Campbell County,40223,659,430,711,-281,10,928,938,2,461,10.778698284,17.822452279,-7.043753995,0.250667402,23.261934902,23.512602304
2024,Tennessee,Cannon County,15063,256,183,204,-21,-1,278,277,0,108,12.253096753,13.659189823,-1.40609307,-0.066956813,18.613993974,18.547037161
2024,Tennessee,Carroll County,28860,442,274,463,-189,3,629,632,-1,1343,9.5673731625,16.166765599,-6.599392437,0.1047522609,21.963057369,22.06780963
2024,Tennessee,Carter County,57022,537,439,858,-419,45,909,954,2,1367,7.7352057582,15.118010343,-7.382804585,0.7929026404,16.016633335,16.809535976
2024,Tennessee,Cheatham County,42254,490,494,535,-41,15,514,529,2,330,11.759384894,12.735366231,-0.975981337,0.3570663429,12.235473351,12.592539694
2024,Tennessee,Chester County,17606,48,180,251,-71,15,103,118,1,1158,10.237743146,14.275964054,-4.038220908,0.8531452622,5.8582641338,6.711409396
2024,Tennessee,Claiborne County,32654,297,338,542,-204,42,457,499,2,1265,10.398240298,16.674101306,-6.275861008,1.2920890311,14.059159219,15.35124825
2024,Tennessee,Clay County,7714,58,76,133,-57,14,99,113,2,58,9.8893949252,17.306441119,-7.417046194,1.8217306441,12.882238126,14.70396877
2024,Tennessee,Cocke County,37404,555,373,673,-300,12,844,856,-1,228,10.046732119,18.127213715,-8.080481597,0.3232192639,22.733088225,23.056307489
2024,Tennessee,Coffee County,60633,854,702,802,-100,73,881,954,0,743,11.659967445,13.320931469,-1.660964024,1.2125037372,14.633093047,15.845596784
2024,Tennessee,Crockett County,13982,120,158,208,-50,1,166,167,3,208,11.348944117,14.940382129,-3.591438012,0.0718287602,11.923574199,11.995402959
2024,Tennessee,Cumberland County,64760,1278,532,1120,-588,4,1863,1867,-1,522,8.2968138363,17.466976498,-9.170162661,0.0623820589,29.054443942,29.116826001
2024,Tennessee,Davidson County,712334,4983,10032,5642,4390,4293,-3581,712,-119,23732,14.132712538,7.9482420396,6.1844704987,6.0478204672,-5.044781061,1.0030394066
2024,Tennessee,Decatur County,11656,107,105,213,-108,0,216,216,-1,144,9.0497737557,18.358112476,-9.30833872,0.0,18.61667744,18.61667744
2024,Tennessee,DeKalb County,21225,223,241,328,-87,16,292,308,2,165,11.414497833,15.535084188,-4.120586355,0.7578089848,13.830013972,14.587822957
2024,Tennessee,Dickson County,56729,1002,645,700,-55,24,1033,1057,0,767,11.471153162,12.449313509,-0.978160347,0.426833606,18.371629793,18.798463399
2024,Tennessee,Dyer County,36498,58,497,593,-96,0,156,156,-2,481,13.628012833,16.260385533,-2.6323727,0.0,4.2776056377,4.2776056377
2024,Tennessee,Fayette County,44175,837,450,534,-84,-5,926,921,0,512,10.284186349,12.203901135,-1.919714785,-0.114268737,21.162570132,21.048301395
2024,Tennessee,Fentress County,19696,361,211,356,-145,6,500,506,0,240,10.811918731,18.241910276,-7.429991545,0.307447926,25.620660501,25.928108427
2024,Tennessee,Franklin County,44654,535,438,599,-161,58,635,693,3,2532,9.8678652293,13.495094229,-3.627229,1.3067036148,14.306151645,15.61285526
2024,Tennessee,Gibson County,51045,219,629,860,-231,8,439,447,3,811,12.348951124,16.884098517,-4.535147392,0.1570613816,8.6187433126,8.7758046942
2024,Tennessee,Giles County,30721,181,304,492,-188,17,348,365,4,772,9.9247482085,16.062421443,-6.137673234,0.5550023669,11.361224923,11.91622729
2024,Tennessee,Grainger County,24681,496,266,377,-111,0,606,606,1,155,10.886915238,15.429951295,-4.543036058,0.0,24.80252118,24.80252118
2024,Tennessee,Greene County,72577,1285,647,1145,-498,12,1776,1788,-5,1984,8.9942934197,15.917258061,-6.922964641,0.1668184251,24.689126914,24.855945339
2024,Tennessee,Grundy County,13955,176,169,239,-70,-2,245,243,3,184,12.187207038,17.235162616,-5.047955578,-0.144227302,17.667844523,17.523617221
2024,Tennessee,Hamblen County,66216,1049,773,998,-225,102,1170,1272,2,469,11.7671236,15.19222426,-3.42510066,1.5527122992,17.810523431,19.363235731
2024,Tennessee,Hamilton County,379864,5262,4500,3913,587,703,3942,4645,30,7999,11.928966978,10.372899508,1.5560674702,1.8635697301,10.449775073,12.313344803
2024,Tennessee,Hancock County,6956,110,56,127,-71,0,181,181,0,154,8.1147659759,18.403129981,-10.28836401,0.0,26.228082887,26.228082887
2024,Tennessee,Hardeman County,25567,56,282,376,-94,-1,153,152,-2,3750,11.041935863,14.72258115,-3.680645288,-0.039155801,5.9908375426,5.9516817417
2024,Tennessee,Hardin County,27229,164,286,491,-205,-3,372,369,0,443,10.535234096,18.086713081,-7.551478985,-0.110509449,13.703171621,13.592662173
2024,Tennessee,Hawkins County,58600,697,500,940,-440,2,1132,1134,3,432,8.5834699536,16.136923513,-7.553453559,0.0343338798,19.432975975,19.467309855
2024,Tennessee,Haywood County,17328,-190,196,279,-83,3,-112,-109,2,197,11.24949779,16.013315732,-4.763817942,0.1721861907,-6.428284452,-6.256098261
2024,Tennessee,Henderson County,28070,163,307,414,-107,-2,274,272,-2,367,10.968790753,14.791789485,-3.822998732,-0.07145792,9.7897350698,9.7182771495
2024,Tennessee,Henry County,32554,172,314,521,-207,-4,382,378,1,312,9.6710607367,16.046568929,-6.375508193,-0.123198226,11.765430578,11.642232352
2024,Tennessee,Hickman County,25826,345,278,362,-84,16,414,430,-1,1354,10.836727932,14.111134933,-3.274407001,0.6236965716,16.138148791,16.761845362
2024,Tennessee,Houston County,8393,146,78,138,-60,0,208,208,-2,131,9.375,16.586538462,-7.211538462,0.0,25.0,25.0
2024,Tennessee,Humphreys County,19209,186,198,337,-139,5,320,325,0,425,10.357815443,17.629211132,-7.271395689,0.261560996,16.739903746,17.001464742
2024,Tennessee,Jackson County,12363,348,104,175,-71,1,421,422,-3,139,8.5322832062,14.357207318,-5.824924112,0.0820411847,34.539338748,34.621379933
2024,Tennessee,Jefferson County,57838,1178,542,794,-252,58,1370,1428,2,1536,9.467414278,13.869237891,-4.401823613,1.0131181331,23.930549005,24.943667138
2024,Tennessee,Johnson County,18375,329,148,293,-145,19,454,473,1,1569,8.1271793745,16.089618627,-7.962439252,1.0433541089,24.930671865,25.974025974
2024,Tennessee,Knox County,500669,5289,5444,5082,362,818,4080,4898,29,15035,10.931189128,10.204317257,0.7268718708,1.6424894759,8.1923680462,9.8348575221
2024,Tennessee,Lake County,6347,-153,64,144,-80,2,-75,-73,0,1707,9.9634155834,22.417685063,-12.45426948,0.311356737,-11.67587764,-11.3645209
2024,Tennessee,Lauderdale County,24610,-131,332,351,-19,0,-112,-112,0,1806,13.454641243,14.224635772,-0.769994529,0.0,-4.538915118,-4.538915118
2024,Tennessee,Lawrence County,46114,612,590,637,-47,4,653,657,2,464,12.879846315,13.905867971,-1.026021656,0.087320992,14.255151939,14.34247293
2024,Tennessee,Lewis County,13066,154,118,219,-101,13,242,255,0,186,9.0846100547,16.860420356,-7.775810301,1.0008468704,18.631149434,19.631996305
2024,Tennessee,Lincoln County,36169,163,421,511,-90,18,235,253,0,261,11.666089366,14.16002771,-2.493938344,0.4987876689,6.5119501212,7.0107377901
2024,Tennessee,Loudon County,60591,2347,539,766,-227,68,2507,2575,-1,506,9.0714015231,12.891824799,-3.820423276,1.1444439769,42.192956621,43.337400597
2024,Tennessee,McMinn County,55678,983,604,855,-251,16,1222,1238,-4,929,10.94470568,15.492919464,-4.548213784,0.2899259783,22.143096591,22.433022569
2024,Tennessee,McNairy County,26163,170,309,442,-133,17,286,303,0,288,11.84906818,16.949152542,-5.100084362,0.6518904824,10.967098704,11.618989186
2024,Tennessee,Macon County,26793,579,296,327,-31,22,589,611,-1,264,11.168336257,12.337993095,-1.169656838,0.8300790462,22.223479918,23.053558964
2024,Tennessee,Madison County,99193,21,1169,1193,-24,127,-85,42,3,4324,11.786353439,12.028331611,-0.241978172,1.2804678245,-0.857006024,0.4234618002
2024,Tennessee,Marion County,29382,332,290,437,-147,5,473,478,1,129,9.926067908,14.957557503,-5.031489595,0.1711391019,16.189759036,16.360898138
2024,Tennessee,Marshall County,36961,1104,429,441,-12,30,1091,1121,-5,236,11.782800956,12.112389794,-0.329588838,0.8239720948,29.965118515,30.789090609
2024,Tennessee,Maury County,110760,2764,1331,1106,225,4,2532,2536,3,1267,12.168809084,10.11172265,2.0570864342,0.0365704255,23.14907934,23.185649765
2024,Tennessee,Meigs County,13691,433,117,206,-89,0,521,521,1,113,8.6830680174,15.288136851,-6.605068834,0.0,38.665627667,38.665627667
2024,Tennessee,Monroe County,48594,914,508,736,-228,4,1136,1140,2,425,10.553212705,15.289693998,-4.736481293,0.083096163,23.599310302,23.682406465
2024,Tennessee,Montgomery County,239872,4973,3722,1743,1979,185,2767,2952,42,4446,15.679137942,7.3424872202,8.3366507221,0.7793230842,11.656145805,12.435468889
2024,Tennessee,Moore County,6748,32,53,95,-42,-1,73,72,2,48,7.8728461081,14.111705288,-6.23885918,-0.148544266,10.843731432,10.695187166
2024,Tennessee,Morgan County,21573,366,195,319,-124,0,494,494,-4,1868,9.1164095372,14.913510986,-5.797101449,0.0,23.094904161,23.094904161
2024,Tennessee,Obion County,30411,37,363,471,-108,0,145,145,0,234,11.943736119,15.497244386,-3.553508267,0.0,4.7709138768,4.7709138768
2024,Tennessee,Overton County,23327,334,242,394,-152,0,484,484,2,153,10.449050086,17.01208981,-6.563039724,0.0,20.898100173,20.898100173
2024,Tennessee,Perry County,8891,186,103,145,-42,7,221,228,0,148,11.707206183,16.481018413,-4.77381223,0.7956353717,25.119345306,25.914980677
2024,Tennessee,Pickett County,5128,25,31,77,-46,-1,71,70,1,54,6.0600136839,15.052292054,-8.99227837,-0.195484312,13.879386179,13.683901867
2024,Tennessee,Polk County,18033,255,166,330,-164,-1,416,415,4,197,9.2708944179,18.430091313,-9.159196895,-0.055848762,23.233084806,23.177236045
2024,Tennessee,Putnam County,83844,1374,943,931,12,167,1193,1360,2,3394,11.33999543,11.19569008,0.1443053501,2.0082494558,14.346356891,16.354606347
2024,Tennessee,Rhea County,33924,235,372,518,-146,7,369,376,5,622,11.003801044,15.322497153,-4.318696109,0.2070607723,10.915060713,11.122121486
2024,Tennessee,Roane County,56096,967,507,845,-338,-7,1311,1304,1,409,9.1166554282,15.194425714,-6.077770285,-0.125870982,23.573836817,23.447965835
2024,Tennessee,Robertson County,76776,1378,897,870,27,49,1299,1348,3,641,11.78913612,11.43427918,0.3548569401,0.643999632,17.072561673,17.716561305
2024,Tennessee,Rutherford County,367101,6419,4256,2548,1708,1192,3518,4710,1,5338,11.695793939,7.0020871606,4.693706778,3.2757016858,9.6677168881,12.943418574
2024,Tennessee,Scott County,22171,172,266,358,-92,-2,264,262,2,227,12.04437401,16.210097351,-4.165723342,-0.090559203,11.953814806,11.863255603
2024,Tennessee,Sequatchie County,17161,243,196,216,-20,49,214,263,0,332,11.502684938,12.676428299,-1.173743361,2.8756712345,12.559053963,15.434725197
2024,Tennessee,Sevier County,99415,609,1072,1301,-229,333,509,842,-4,495,10.81621019,13.126762553,-2.310552363,3.3598861876,5.1356818904,8.4955680781
2024,Tennessee,Shelby County,910042,-6315,12539,9509,3030,2301,-11684,-9383,38,12504,13.730844136,10.412839692,3.3180044448,2.5197122863,-12.79457556,-10.27486327
2024,Tennessee,Smith County,20538,68,231,276,-45,6,106,112,1,175,11.266094421,13.460788139,-2.194693718,0.2926258291,5.1697229809,5.46234881
2024,Tennessee,Stewart County,14222,228,130,205,-75,-3,305,302,1,203,9.2146299972,14.530762688,-5.316132691,-0.212645308,21.618939609,21.406294301
2024,Tennessee,Sullivan County,162135,1273,1501,2347,-846,31,2091,2122,-3,2267,9.2942039709,14.532642718,-5.238438747,0.1919522472,12.947488676,13.139440924
2024,Tennessee,Sumner County,207994,4273,2242,2057,185,202,3885,4087,1,1492,10.891028988,9.9923490764,0.8986799121,0.9812613094,18.872278154,19.853539463
2024,Tennessee,Tipton County,62015,365,692,757,-65,9,422,431,-1,827,11.191525492,12.242752598,-1.051227105,0.1455545223,6.8248898233,6.9704443456
2024,Tennessee,Trousdale County,12271,194,115,147,-32,-2,225,223,3,2512,9.4463610974,12.074913751,-2.628552653,-0.164284541,18.482010843,18.317726302
2024,Tennessee,Unicoi County,17756,165,141,368,-227,3,391,394,-2,376,7.9780462274,20.822134835,-12.84408861,0.1697456644,22.123518262,22.293263926
2024,Tennessee,Union County,20741,268,231,333,-102,-2,369,367,3,129,11.209783083,16.159557432,-4.949774349,-0.097054399,17.906536614,17.809482215
2024,Tennessee,Van Buren County,6493,63,67,145,-78,-2,141,139,2,69,10.36910934,22.440609766,-12.07150043,-0.309525652,21.821558462,21.51203281
2024,Tennessee,Warren County,42638,637,547,567,-20,60,594,654,3,418,12.925483524,13.3980789,-0.472595376,1.417786127,14.036082657,15.453868784
2024,Tennessee,Washington County,138420,2273,1260,1702,-442,200,2514,2714,1,5546,9.1780876799,12.397702564,-3.219614885,1.4568393143,18.31247018,19.769309495
2024,Tennessee,Wayne County,16066,-200,148,252,-104,-5,-90,-95,-1,1784,9.1550167017,15.588271681,-6.43325498,-0.309291105,-5.567239886,-5.876530991
2024,Tennessee,Weakley County,33084,41,340,469,-129,12,155,167,3,2226,10.283242851,14.184826168,-3.901583317,0.362937983,4.6879489467,5.0508869297
2024,Tennessee,White County,28692,692,287,453,-166,0,861,861,-3,158,10.124885345,15.981090806,-5.856205461,0.0,30.374656036,30.374656036
2024,Tennessee,Williamson County,264460,3722,2415,1499,916,746,2110,2856,-50,1265,9.1965315938,5.7083233371,3.4882082567,2.8408333619,8.0350648708,10.875898233
2024,Tennessee,Wilson County,163674,5081,1719,1387,332,356,4402,4758,-9,1708,10.668172664,8.6077693341,2.0604033302,2.2093481492,27.318962227,29.528310376
2024,Texas,Texas,30503301,473453,390494,232241,158253,128534,186767,315301,-101,605204,12.901823429,7.673184159,5.22863927,4.2467309936,6.1707346499,10.417465643
2024,Texas,Anderson County,57736,509,594,802,-208,107,614,721,-4,12904,10.333759557,13.952315093,-3.618555535,1.8614684725,10.68169759,12.543166062
2024,Texas,Andrews County,18664,340,292,152,140,69,131,200,0,64,15.78890451,8.2188817995,7.5700227101,3.7309397642,7.083378393,10.814318157
2024,Texas,Angelina County,87319,195,1178,1102,76,13,101,114,5,2641,13.505844316,12.634499521,0.8713447946,0.1490458201,1.1579713717,1.3070171919
2024,Texas,Aransas County,25374,411,235,412,-177,-4,590,586,2,445,9.3370681606,16.369668435,-7.032600274,-0.15892882,23.442000914,23.283072094
2024,Texas,Archer County,9029,180,90,109,-19,7,194,201,-2,56,10.068240295,12.193757691,-2.125517396,0.7830853563,21.702651303,22.48573666
2024,Texas,Armstrong County,1832,-25,23,30,-7,0,-19,-19,1,39,12.469503931,16.264570344,-3.795066414,0.0,-10.30089455,-10.30089455
2024,Texas,Atascosa County,51784,1048,624,551,73,-17,996,979,-4,312,12.173234491,10.749122123,1.4241123683,-0.331642606,19.430355053,19.098712446
2024,Texas,Austin County,31677,607,390,343,47,3,559,562,-2,229,12.430873189,10.9327936,1.4980795895,0.0956221015,17.817584904,17.913207006
2024,Texas,Bailey County,6672,-131,113,76,37,77,-243,-166,-2,117,16.771799629,11.280148423,5.4916512059,11.428571429,-36.06679035,-24.63821892
2024,Texas,Bandera County,22637,517,192,314,-122,20,620,640,-1,221,8.5796635163,14.031324709,-5.451661193,0.8937149496,27.705163438,28.598878388
2024,Texas,Bastrop County,110778,4383,1321,852,469,73,3854,3927,-13,2091,12.165416511,7.8462792336,4.3191372777,0.6722750987,35.49244151,36.164716608
2024,Texas,Baylor County,3463,1,34,79,-45,14,32,46,0,55,9.8194945848,22.815884477,-12.99638989,4.0433212996,9.2418772563,13.285198556
2024,Texas,Bee County,30850,-142,313,374,-61,11,-95,-84,3,7946,10.122570421,12.095339737,-1.972769315,0.3557452864,-3.072345655,-2.716600369
2024,Texas,Bell County,393193,5739,6539,2880,3659,712,1337,2049,31,8024,16.752770458,7.3784950176,9.3742754408,1.8241279349,3.4253638328,5.2494917677
2024,Texas,Bexar County,2087679,27488,26765,15947,10818,5705,10831,16536,134,40262,12.905418926,7.6892477344,5.2161711915,2.7508094516,5.2224394689,7.9732489205
2024,Texas,Blanco County,13048,637,87,155,-68,0,706,706,-1,75,6.834518245,12.176440551,-5.341922306,0.0,55.46172277,55.46172277
2024,Texas,Borden County,572,-8,5,7,-2,0,-6,-6,0,0,8.6805555556,12.152777778,-3.472222222,0.0,-10.41666667,-10.41666667
2024,Texas,Bosque County,18996,289,196,294,-98,17,373,390,-3,212,10.397050633,15.595575949,-5.198525316,0.9017850038,19.786223908,20.688008912
2024,Texas,Bowie County,91687,-25,1101,1208,-107,85,-7,78,4,5032,12.006608542,13.173463323,-1.166854781,0.926940714,-0.076336294,0.8506044199
2024,Texas,Brazoria County,398938,10704,4834,2959,1875,955,7888,8843,-14,9285,12.281940923,7.5180519632,4.7638889595,2.4264074434,20.04136326,22.467770703
2024,Texas,Brazos County,244703,2772,2885,1276,1609,966,184,1150,13,20865,11.856960262,5.2441876236,6.6127726382,3.9701295018,0.7562151432,4.7263446451
2024,Texas,Brewster County,9513,169,90,109,-19,40,148,188,0,505,9.5455268601,11.560693642,-2.015166782,4.2424563822,15.697088614,19.939544997
2024,Texas,Briscoe County,1445,6,10,16,-6,0,12,12,0,0,6.9348127601,11.095700416,-4.160887656,0.0,8.3217753121,8.3217753121
2024,Texas,Brooks County,6848,-54,101,98,3,38,-91,-53,-4,463,14.690909091,14.254545455,0.4363636364,5.5272727273,-13.23636364,-7.709090909
2024,Texas,Brown County,38709,266,468,588,-120,38,345,383,3,1678,12.131895479,15.24263791,-3.110742431,0.9850684363,8.9433844878,9.9284529241
2024,Texas,Burleson County,19475,785,216,283,-67,71,783,854,-2,144,11.319271584,14.830341936,-3.511070352,3.7206864929,41.032359492,44.753045985
2024,Texas,Burnet County,53991,1424,531,620,-89,3,1508,1511,2,1035,9.9664032733,11.636855046,-1.670451773,0.0563073631,28.303834531,28.360141895
2024,Texas,Caldwell County,49859,2010,646,458,188,86,1735,1821,1,2460,13.223072829,9.3748720678,3.8482007615,1.7603471568,35.513980431,37.274327588
2024,Texas,Calhoun County,19696,14,238,260,-22,38,-1,37,-1,317,12.087967901,13.205343085,-1.117375184,1.9300116816,-0.050789781,1.8792219006
2024,Texas,Callahan County,14374,127,143,215,-72,3,198,201,-2,80,9.9926627302,15.023933475,-5.031270745,0.2096362811,13.835994549,14.045630831
2024,Texas,Cameron County,426710,1799,6022,3228,2794,833,-1860,-1027,32,4416,14.142441297,7.5808370155,6.5616042817,1.9562692794,-4.368140288,-2.411871008
2024,Texas,Camp County,13000,279,209,226,-17,26,270,296,0,46,16.251312157,17.573189223,-1.321877065,2.0216943354,20.994518098,23.016212433
2024,Texas,Carson County,5878,62,69,82,-13,1,77,78,-3,29,11.800923551,14.024285959,-2.223362408,0.1710278775,13.169146571,13.340174448
2024,Texas,Cass County,28659,121,365,548,-183,-4,311,307,-3,328,12.762907145,19.161844153,-6.398937007,-0.139867476,10.874696225,10.73482875
2024,Texas,Castro County,7227,-60,115,94,21,24,-107,-83,2,109,15.846768637,12.953010886,2.8937577511,3.3071517156,-14.74438473,-11.43723302
2024,Texas,Chambers County,53876,2567,611,394,217,89,2273,2362,-12,211,11.617626087,7.4915624851,4.1260636022,1.6922565005,43.219090174,44.911346675
2024,Texas,Cherokee County,52217,785,682,715,-33,5,814,819,-1,2170,13.159798937,13.796563401,-0.636764465,0.0964794643,15.706856796,15.80333626
2024,Texas,Childress County,6788,-53,66,81,-15,9,-47,-38,0,1302,9.6852300242,11.886418666,-2.201188642,1.3207131851,-6.897057745,-5.576344559
2024,Texas,Clay County,10738,239,115,148,-33,10,264,274,-2,58,10.830154918,13.937938504,-3.107783585,0.9417526016,24.862268682,25.804021284
2024,Texas,Cochran County,2509,-13,51,43,8,17,-37,-20,-1,8,20.274299344,17.094017094,3.18028225,6.7580997814,-14.70880541,-7.950705625
2024,Texas,Coke County,3352,30,39,65,-26,0,59,59,-3,72,11.687144141,19.478573569,-7.791429428,0.0,17.680551393,17.680551393
2024,Texas,Coleman County,7842,20,94,204,-110,-2,133,131,-1,33,12.002042901,26.046986721,-14.04494382,-0.255362615,16.981613892,16.726251277
2024,Texas,Collin County,1195359,36364,12840,5299,7541,8137,20749,28886,-63,9069,10.907450621,4.5014471061,6.4060035152,6.9122995098,17.626066428,24.538365938
2024,Texas,Collingsworth County,2563,-22,36,41,-5,-1,-16,-17,0,9,13.986013986,15.928515929,-1.942501943,-0.388500389,-6.216006216,-6.604506605
2024,Texas,Colorado County,21117,285,294,327,-33,48,271,319,-1,418,14.017020668,15.590359723,-1.573339055,2.2884931703,12.920451024,15.208944194
2024,Texas,Comal County,193928,9179,1822,1550,272,45,8891,8936,-29,1486,9.6229768378,8.1863963219,1.4365805158,0.2376695706,46.958225612,47.195895182
2024,Texas,Comanche County,14050,129,186,206,-20,13,135,148,1,127,13.299488756,14.729541311,-1.430052554,0.9295341604,9.6528547424,10.582388903
2024,Texas,Concho County,3297,-70,25,33,-8,20,-82,-62,0,1054,7.5030012005,9.9039615846,-2.400960384,6.0024009604,-24.60984394,-18.60744298
2024,Texas,Cooke County,43782,734,580,475,105,22,609,631,-2,744,13.359437982,10.940919037,2.4185189451,0.5067373028,14.027409881,14.534147184
2024,Texas,Coryell County,84878,673,1058,641,417,156,100,256,0,12042,12.514563853,7.5820750756,4.9324887777,1.8452476003,1.1828510258,3.0280986261
2024,Texas,Cottle County,1294,-23,10,21,-11,0,-11,-11,-1,0,7.6599004213,16.085790885,-8.425890463,0.0,-8.425890463,-8.425890463
2024,Texas,Crane County,4574,23,67,48,19,-2,6,4,0,88,14.684931507,10.520547945,4.1643835616,-0.438356164,1.3150684932,0.8767123288
2024,Texas,Crockett County,2858,-102,56,55,1,-4,-98,-102,-1,43,19.250601581,18.906840839,0.3437607425,-1.37504297,-33.68855277,-35.06359574
2024,Texas,Crosby County,4917,-75,67,98,-31,11,-55,-44,0,65,13.523059845,19.779997982,-6.256938137,2.2202038551,-11.10101928,-8.88081542
2024,Texas,Culberson County,2196,33,31,31,0,1,32,33,0,48,14.223445744,14.223445744,0.0,0.4588208305,14.682266575,15.141087405
2024,Texas,Dallam County,7237,2,191,77,114,98,-209,-111,-1,27,26.395798784,10.641238253,15.754560531,13.54339414,-28.88336097,-15.33996683
2024,Texas,Dallas County,2606358,4365,36886,17336,19550,19273,-34330,-15057,-128,31833,14.164175955,6.6570014195,7.5071745357,7.4008068965,-13.18267528,-5.781868388
2024,Texas,Dawson County,12004,-172,185,159,26,10,-206,-196,-2,1680,15.301902399,13.151364764,2.1505376344,0.8271298594,-17.0388751,-16.21174524
2024,Texas,Deaf Smith County,18347,-52,328,209,119,52,-223,-171,0,154,17.852283242,11.375387797,6.4768954444,2.8302400261,-12.1373755,-9.307135471
2024,Texas,Delta County,5520,107,65,85,-20,1,127,128,-1,50,11.890606421,15.54925455,-3.65864813,0.1829324065,23.232415622,23.415348029
2024,Texas,Denton County,1007703,29943,11361,4558,6803,3828,19262,23090,50,9380,11.444182037,4.5913723902,6.8528096469,3.8560275361,19.40303093,23.259058466
2024,Texas,DeWitt County,19929,175,216,280,-64,4,236,240,-1,1542,10.886273719,14.111836303,-3.225562583,0.2015976615,11.894262027,12.095859688
2024,Texas,Dickens County,1711,-25,20,29,-9,3,-18,-15,-1,4,11.604293589,16.826225704,-5.221932115,1.7406440383,-10.44386423,-8.703220191
2024,Texas,Dimmit County,8257,-103,143,150,-7,-2,-94,-96,0,182,17.211289643,18.053800325,-0.842510682,-0.240717338,-11.31371487,-11.55443221
2024,Texas,Donley County,3214,-75,36,61,-25,5,-55,-50,0,293,11.071813009,18.760572044,-7.688759034,1.5377518069,-16.91526988,-15.37751807
2024,Texas,Duval County,9604,-102,147,169,-22,0,-80,-80,0,714,15.22527188,17.503883998,-2.278612118,0.0,-8.285862248,-8.285862248
2024,Texas,Eastland County,18037,144,225,359,-134,25,254,279,-1,727,12.524352908,19.983300863,-7.458947954,1.3915947676,14.138602839,15.530197606
2024,Texas,Ector County,164494,3437,2987,1399,1588,959,891,1850,-1,2508,18.350427429,8.5946595157,9.7557679135,5.8915500183,5.4737967323,11.365346751
2024,Texas,Edwards County,1393,-35,20,31,-11,0,-24,-24,0,13,14.179369018,21.978021978,-7.79865296,0.0,-17.01524282,-17.01524282
2024,Texas,Ellis County,222829,10506,2721,1594,1127,171,9247,9418,-39,1856,12.505974924,7.3261756811,5.1797992426,0.7859322719,42.500091922,43.286024194
2024,Texas,El Paso County,869880,2641,11089,6332,4757,1683,-3840,-2157,41,14728,12.767116127,7.2902316997,5.4768844276,1.9376910851,-4.421113349,-2.483422264
2024,Texas,Erath County,44195,358,501,423,78,20,261,281,-1,3744,11.382224646,9.6101417666,1.772082879,0.4543802254,5.9296619411,6.3840421665
2024,Texas,Falls County,17286,330,179,231,-52,18,366,384,-2,1788,10.454996788,13.492202558,-3.037205771,1.0513404591,21.377256001,22.42859646
2024,Texas,Fannin County,37571,496,365,543,-178,5,668,673,1,3131,9.7794925381,14.548669721,-4.769177183,0.1339656512,17.897811001,18.031776652
2024,Texas,Fayette County,25474,540,259,360,-101,25,622,647,-6,379,10.276146643,14.283447072,-4.007300429,0.9919060467,24.678622441,25.670528488
2024,Texas,Fisher County,3612,-14,28,62,-34,4,16,20,0,23,7.7369439072,17.131804366,-9.394860459,1.105277701,4.4211108041,5.5263885051
2024,Texas,Floyd County,5090,-149,58,89,-31,-2,-115,-117,-1,23,11.230516023,17.233033207,-6.002517185,-0.387259173,-22.26740246,-22.65466163
2024,Texas,Foard County,1079,16,9,25,-16,0,33,33,-1,32,8.4033613445,23.342670401,-14.93930906,0.0,30.81232493,30.81232493
2024,Texas,Fort Bend County,916778,27859,9567,4178,5389,6834,15757,22591,-121,4705,10.596462197,4.6275759444,5.9688862528,7.5693762575,17.452540487,25.021916745
2024,Texas,Franklin County,10735,70,104,127,-23,20,72,92,1,67,9.7196261682,11.869158879,-2.14953271,1.8691588785,6.7289719626,8.5981308411
2024,Texas,Freestone County,20441,409,239,242,-3,14,401,415,-3,1593,11.810342698,11.958589677,-0.148246979,0.6918192375,19.815679589,20.507498826
2024,Texas,Frio County,17987,271,231,206,25,197,47,244,2,2749,12.940089068,11.539646528,1.4004425398,11.035487214,2.6328319749,13.668319189
2024,Texas,Gaines County,22523,383,482,166,316,55,10,65,2,135,21.583861362,7.4334460292,14.150415333,2.4628887446,0.4477979536,2.9106866982
2024,Texas,Galveston County,361744,4357,4053,3171,882,505,2988,3493,-18,4992,11.271937936,8.8189773491,2.4529605872,1.4044728985,8.3100297442,9.7145026428
2024,Texas,Garza County,4517,19,53,64,-11,57,-26,31,-1,452,11.75818081,14.198557959,-2.440377149,12.645590682,-5.768164171,6.8774265114
2024,Texas,Gillespie County,27733,232,246,384,-138,109,263,372,-2,305,8.9075569396,13.904479125,-4.996922186,3.946844335,9.5231198175,13.469964153
2024,Texas,Glasscock County,1141,2,14,11,3,1,-2,-1,0,0,12.280701754,9.649122807,2.6315789474,0.8771929825,-1.754385965,-0.877192982
2024,Texas,Goliad County,7144,24,68,99,-31,-1,54,53,2,92,9.5344924285,13.881099271,-4.346606842,-0.140213124,7.5715086932,7.4312955693
2024,Texas,Gonzales County,19930,114,292,256,36,14,63,77,1,273,14.693302471,12.881799426,1.8115030443,0.7044734061,3.1701303276,3.8746037337
2024,Texas,Gray County,20916,-64,244,336,-92,41,-14,27,1,1548,11.647890013,16.039717395,-4.391827382,1.9572274203,-0.668321558,1.2889058621
2024,Texas,Grayson County,146907,3709,1846,1706,140,132,3441,3573,-4,2123,12.726426639,11.761258855,0.9651677841,0.9100153393,23.722445322,24.632460661
2024,Texas,Gregg County,126243,684,1744,1585,159,164,357,521,4,3421,13.852153676,12.589256638,1.2628970381,1.3026107815,2.8355612743,4.1381720558
2024,Texas,Grimes County,32384,1214,415,370,45,-1,1172,1171,-2,2813,13.059760204,11.643641628,1.4161185763,-0.031469302,36.882021588,36.850552286
2024,Texas,Guadalupe County,188454,5752,1920,1409,511,42,5213,5255,-14,1787,10.34605395,7.5924948,2.7535591503,0.2263199302,28.090614189,28.316934119
2024,Texas,Hale County,31761,-205,407,372,35,72,-314,-242,2,2011,12.773235834,11.67480032,1.098435514,2.2596387716,-9.854535754,-7.594896982
2024,Texas,Hall County,2818,0,31,49,-18,19,0,19,-1,32,11.000709723,17.388218595,-6.387508872,6.7423704755,0.0,6.7423704755
2024,Texas,Hamilton County,8619,306,94,143,-49,21,335,356,-1,154,11.103236475,16.891093787,-5.787857312,2.4805102764,39.570044885,42.050555162
2024,Texas,Hansford County,5071,-40,68,61,7,-3,-44,-47,0,57,13.356904341,11.981928894,1.3749754469,-0.589275192,-8.642702809,-9.231978
2024,Texas,Hardeman County,3490,-35,46,44,2,8,-46,-38,1,13,13.114754098,12.544547398,0.5702066999,2.2808267997,-13.1147541,-10.8339273
2024,Texas,Hardin County,58261,421,732,720,12,25,392,417,-8,394,12.609710511,12.402993945,0.2067165657,0.430659512,6.7527411478,7.1834006598
2024,Texas,Harris County,4835125,53788,65450,30755,34695,41665,-22792,18873,220,50587,13.612074794,6.3963233048,7.2157514895,8.665349065,-4.74020487,3.9251441954
2024,Texas,Harrison County,70895,857,883,849,34,25,801,826,-3,2411,12.530777036,12.04827826,0.482498776,0.3547785118,11.367103517,11.721882029
2024,Texas,Hartley County,5145,-83,74,45,29,6,-117,-111,-1,866,14.267810662,8.6763713487,5.5914393136,1.1568495132,-22.55856551,-21.40171599
2024,Texas,Haskell County,5385,9,47,110,-63,11,61,72,0,498,8.7352476536,20.444196636,-11.70894898,2.0444196636,11.337236316,13.38165598
2024,Texas,Hays County,280486,11383,3072,1448,1624,456,9286,9742,17,7796,11.179263049,5.2693922185,5.9098708307,1.6594218589,33.79252496,35.451946818
2024,Texas,Hemphill County,3189,-36,37,23,14,-1,-48,-49,-1,71,11.537262239,7.171811662,4.3654505769,-0.311817898,-14.96725912,-15.27907702
2024,Texas,Henderson County,86158,1668,964,1349,-385,15,2040,2055,-2,1171,11.298110731,15.810323004,-4.512212273,0.1758004782,23.908865032,24.08466551
2024,Texas,Hidalgo County,898471,10185,13671,5383,8288,1695,139,1834,63,8001,15.302584515,6.0254416241,9.2771428907,1.8972921332,0.1555891484,2.0528812816
2024,Texas,Hill County,38101,835,468,612,-144,37,942,979,0,458,12.419228575,16.240529675,-3.8213011,0.9818620882,24.997678029,25.979540117
2024,Texas,Hockley County,21460,182,284,283,1,20,161,181,0,290,13.290280313,13.243483551,0.0467967617,0.9359352333,7.5342786279,8.4702138612
2024,Texas,Hood County,67774,1380,691,871,-180,18,1547,1565,-5,863,10.300518753,12.983721901,-2.683203148,0.2683203148,23.060640391,23.328960706
2024,Texas,Hopkins County,38172,379,480,486,-6,58,329,387,-2,449,12.637398802,12.795366287,-0.157967485,1.5270190219,8.6618837623,10.188902784
2024,Texas,Houston County,22066,123,269,367,-98,16,205,221,0,2408,12.224772206,16.67840669,-4.453634484,0.7271239974,9.3162762162,10.043400214
2024,Texas,Howard County,30554,-178,376,427,-51,70,-201,-131,4,2344,12.270339066,13.934666971,-1.664327905,2.2843716346,-6.559409979,-4.275038345
2024,Texas,Hudspeth County,3451,35,32,39,-7,109,-67,42,0,1032,9.3199359254,11.358671909,-2.038735984,31.746031746,-19.51361584,12.232415902
2024,Texas,Hunt County,113347,4909,1397,1133,264,133,4530,4663,-18,2980,12.597786144,10.217102148,2.3806839958,1.1993597403,40.850373109,42.049732849
2024,Texas,Hutchinson County,20033,-189,237,339,-102,-6,-81,-87,0,284,11.774934791,16.842628245,-5.067693454,-0.298099615,-4.024344802,-4.322444417
2024,Texas,Irion County,1549,15,21,23,-2,0,17,17,0,3,13.623094389,14.920531949,-1.297437561,0.0,11.028219267,11.028219267
2024,Texas,Jack County,8875,111,93,105,-12,9,115,124,-1,907,10.544815466,11.905436816,-1.36062135,1.0204660128,13.039287941,14.059753954
2024,Texas,Jackson County,15221,38,243,161,82,10,-55,-45,1,360,15.98473885,10.590711748,5.3940271017,0.6578081831,-3.617945007,-2.960136824
2024,Texas,Jasper County,32694,199,418,544,-126,32,294,326,-1,464,12.82424949,16.689932351,-3.865682861,0.9817607265,9.0199266747,10.001687401
2024,Texas,Jeff Davis County,1856,-50,12,26,-14,-2,-35,-37,1,0,6.379585327,13.822434875,-7.442849548,-1.063264221,-18.60712387,-19.67038809
2024,Texas,Jefferson County,251496,-105,3260,2714,546,627,-1291,-664,13,14262,12.959727448,10.789171869,2.1705555787,2.4925610767,-5.132211085,-2.639650008
2024,Texas,Jim Hogg County,4720,-54,80,67,13,0,-65,-65,-2,77,16.852749105,14.114177375,2.7385717295,0.0,-13.69285865,-13.69285865
2024,Texas,Jim Wells County,38662,-67,506,527,-21,8,-55,-47,1,333,13.076455919,13.619154682,-0.542698763,0.2067423861,-1.421353904,-1.214611518
2024,Texas,Johnson County,202906,7410,2454,1737,717,121,6591,6712,-19,3214,12.319215265,8.7198357438,3.5993795212,0.6074266695,33.087183297,33.694609967
2024,Texas,Jones County,20381,110,163,248,-85,6,190,196,-1,5598,8.019285644,12.201121716,-4.181836072,0.2951884286,9.3476335728,9.6428220014
2024,Texas,Karnes County,15018,73,158,170,-12,115,-31,84,1,3195,10.546340487,11.347328372,-0.800987885,7.6761338985,-2.069218703,5.6069151954
2024,Texas,Kaufman County,185690,13079,2412,1287,1125,179,11819,11998,-44,1568,13.463540431,7.183904036,6.2796363951,0.9991599242,65.972464492,66.971624416
2024,Texas,Kendall County,50537,1518,455,425,30,71,1429,1500,-12,846,9.1405841938,8.5379083129,0.6026758809,1.4263329182,28.707461127,30.133794046
2024,Texas,Kenedy County,343,-11,2,2,0,0,-10,-10,-1,3,5.7388809182,5.7388809182,0.0,0.0,-28.69440459,-28.69440459
2024,Texas,Kent County,734,-10,9,20,-11,0,1,1,0,45,12.178619756,27.063599459,-14.8849797,0.0,1.3531799729,1.3531799729
2024,Texas,Kerr County,53915,131,509,775,-266,33,363,396,1,1922,9.4522697518,14.391962785,-4.939693033,0.6128190605,6.7410096658,7.3538287264
2024,Texas,Kimble County,4442,22,39,63,-24,0,46,46,0,12,8.8016249154,14.218009479,-5.416384563,0.0,10.381403746,10.381403746
2024,Texas,King County,217,-17,2,0,2,0,-19,-19,0,0,8.8691796009,0.0,8.8691796009,0.0,-84.25720621,-84.25720621
2024,Texas,Kinney County,3148,17,28,55,-27,14,30,44,0,463,8.9186176143,17.518713171,-8.600095557,4.4593088071,9.5556617296,14.014970537
2024,Texas,Kleberg County,30069,-307,364,319,45,63,-418,-355,3,1309,12.044006948,10.555050045,1.488956903,2.0845396642,-13.83075523,-11.74621557
2024,Texas,Knox County,3302,18,40,68,-28,3,45,48,-2,97,12.146978439,20.649863346,-8.502884907,0.9110233829,13.665350744,14.576374127
2024,Texas,Lamar County,51127,612,708,739,-31,60,590,650,-7,742,13.931248893,14.541232955,-0.609984062,1.180614313,11.609374078,12.789988391
2024,Texas,Lamb County,12711,-75,169,171,-2,35,-109,-74,1,174,13.256461544,13.413342746,-0.156881202,2.7454210299,-8.550025493,-5.804604463
2024,Texas,Lampasas County,23262,472,213,321,-108,16,564,580,0,190,9.2504125771,13.940762616,-4.690350039,0.6948666725,24.494050204,25.188916877
2024,Texas,La Salle County,6537,-19,77,83,-6,36,-49,-13,0,1443,11.762010234,12.678530512,-0.916520278,5.4991216681,-7.484915604,-1.985793936
2024,Texas,Lavaca County,20571,-82,252,281,-29,1,-54,-53,0,373,12.225887832,13.632835242,-1.406947409,0.0485154279,-2.619833107,-2.571317679
2024,Texas,Lee County,18240,269,204,198,6,-3,267,264,-1,371,11.267294469,10.935903455,0.3313910138,-0.165695507,14.746900113,14.581204606
2024,Texas,Leon County,16538,318,189,259,-70,9,381,390,-2,36,11.539166005,15.812931192,-4.273765187,0.5494840955,23.261493376,23.810977471
2024,Texas,Liberty County,108272,5810,1415,1015,400,52,5395,5447,-37,4842,13.429252043,9.6329970484,3.7962549944,0.4935131493,51.201989238,51.695502387
2024,Texas,Limestone County,22250,86,260,366,-106,16,175,191,1,1093,11.708019994,16.481289683,-4.77326969,0.7204935381,7.8803980727,8.6008916108
2024,Texas,Lipscomb County,2906,60,40,39,1,11,48,59,0,35,13.908205841,13.560500695,0.347705146,3.8247566064,16.68984701,20.514603616
2024,Texas,Live Oak County,11584,43,94,153,-59,45,57,102,0,1647,8.1297297297,13.232432432,-5.102702703,3.8918918919,4.9297297297,8.8216216216
2024,Texas,Llano County,22875,252,229,375,-146,37,360,397,1,170,10.066376544,16.484241066,-6.417864522,1.6264451185,15.824871423,17.451316541
2024,Texas,Loving County,43,-1,0,2,-2,0,1,1,0,0,0.0,45.977011494,-45.97701149,0.0,22.988505747,22.988505747
2024,Texas,Lubbock County,320940,3179,4122,2879,1243,931,988,1919,17,11421,12.907448086,9.0151729839,3.8922751021,2.915292132,3.0937794054,6.0090715374
2024,Texas,Lynn County,5761,23,84,87,-3,2,25,27,-1,38,14.609966084,15.131750587,-0.521784503,0.3478563353,4.3482041917,4.696060527
2024,Texas,McCulloch County,7452,-16,72,156,-84,-1,70,69,-1,80,9.6514745308,20.91152815,-11.26005362,-0.134048257,9.3833780161,9.2493297587
2024,Texas,McLennan County,268583,2421,3619,2517,1102,378,924,1302,17,9666,13.535423426,9.4138327614,4.1215906647,1.4137579594,3.4558527896,4.869610749
2024,Texas,McMullen County,568,-1,5,14,-9,0,10,10,-2,0,8.7950747581,24.626209323,-15.83113456,0.0,17.590149516,17.590149516
2024,Texas,Madison County,13742,101,190,169,21,37,42,79,1,2179,13.877223095,12.343424753,1.533798342,2.7024066026,3.0675966841,5.7700032867
2024,Texas,Marion County,9571,21,93,208,-115,3,133,136,0,106,9.7275247111,21.7561843,-12.02865959,0.3137911197,13.911406307,14.225197427
2024,Texas,Martin County,5216,-12,79,53,26,4,-41,-37,-1,12,15.128303332,10.149368058,4.9789352738,0.7659900421,-7.851397932,-7.08540789
2024,Texas,Mason County,3931,-47,34,63,-29,0,-17,-17,-1,1,8.5977999747,15.9312176,-7.333417625,0.0,-4.298899987,-4.298899987
2024,Texas,Matagorda County,36359,237,557,442,115,150,-28,122,0,344,15.369545122,12.19629972,3.1732454022,4.1390157421,-0.772616272,3.3663994702
2024,Texas,Maverick County,57762,134,978,527,451,120,-442,-322,5,429,16.951208944,9.1342404021,7.8169685415,2.0799029379,-7.660975821,-5.581072883
2024,Texas,Medina County,54797,1140,628,524,104,11,1029,1040,-4,2358,11.580946761,9.6630829661,1.9178637948,0.2028509783,18.97578697,19.178637948
2024,Texas,Menard County,1958,-21,18,38,-20,1,-2,-1,0,34,9.144018288,19.304038608,-10.16002032,0.508001016,-1.016002032,-0.508001016
2024,Texas,Midland County,177108,5089,3029,1244,1785,727,2584,3311,-7,1764,17.351851905,7.126346573,10.225505332,4.1646736002,14.80263629,18.96730989
2024,Texas,Milam County,25951,329,302,393,-91,6,416,422,-2,409,11.711554496,15.240532837,-3.528978341,0.2326798906,16.132472418,16.365152308
2024,Texas,Mills County,4548,50,44,89,-45,5,91,96,-1,176,9.7280565996,19.677205395,-9.949148795,1.1054609772,20.119389786,21.224850763
2024,Texas,Mitchell County,9075,137,72,103,-31,11,158,169,-1,2220,7.9942263921,11.436184978,-3.441958585,1.2213401432,17.542885694,18.764225837
2024,Texas,Montague County,21598,519,210,349,-139,9,651,660,-2,220,9.841366544,16.355413923,-6.514047379,0.4217728519,30.508236287,30.930009138
2024,Texas,Montgomery County,711354,31800,8570,4559,4011,2365,25501,27866,-77,4259,12.322885482,6.5554299781,5.7674555039,3.400656262,36.668133334,40.068789596
2024,Texas,Moore County,21190,96,441,189,252,191,-350,-159,3,122,20.858953741,8.9395516034,11.919402138,9.0341500331,-16.55472519,-7.520575158
2024,Texas,Morris County,12066,14,123,218,-95,22,87,109,0,89,10.199850734,18.077784228,-7.877933494,1.8243635459,7.2145285679,9.0388921138
2024,Texas,Motley County,1020,-14,13,30,-17,0,4,4,-1,0,12.658227848,29.211295034,-16.55306719,0.0,3.8948393379,3.8948393379
2024,Texas,Nacogdoches County,65375,381,888,722,166,42,171,213,2,4285,13.622870468,11.07625279,2.5466176775,0.6443249546,2.6233230292,3.2676479838
2024,Texas,Navarro County,55635,948,757,619,138,25,789,814,-4,1252,13.723464042,11.221696488,2.5017675532,0.4532187596,14.303584054,14.756802814
2024,Texas,Newton County,12039,-2,116,217,-101,0,98,98,1,45,9.634551495,18.023255814,-8.388704319,0.0,8.1395348837,8.1395348837
2024,Texas,Nolan County,14306,-154,178,209,-31,26,-148,-122,-1,284,12.375721338,14.531043593,-2.155322255,1.8076896336,-10.28992561,-8.482235973
2024,Texas,Nueces County,352289,699,4500,3406,1094,518,-932,-414,19,7491,12.786288552,9.6777997355,3.108488817,1.4718438823,-2.648182429,-1.176338547
2024,Texas,Ochiltree County,9704,12,145,88,57,126,-169,-43,-2,38,14.951536399,9.0740358837,5.8775005156,12.992369561,-17.42627346,-4.433903898
2024,Texas,Oldham County,1783,22,25,19,6,13,4,17,-1,243,14.108352144,10.72234763,3.3860045147,7.3363431151,2.2573363431,9.5936794582
2024,Texas,Orange County,85722,674,1132,1075,57,57,568,625,-8,517,13.257597939,12.590033378,0.6675645605,0.6675645605,6.6522222873,7.3197868478
2024,Texas,Palo Pinto County,29747,425,360,426,-66,9,482,491,0,268,12.189134741,14.423809443,-2.234674702,0.3047283685,16.31989707,16.624625438
2024,Texas,Panola County,22838,96,281,344,-63,0,160,160,-1,340,12.329969285,15.094339623,-2.764370338,0.0,7.0206230803,7.0206230803
2024,Texas,Parker County,173494,7556,1868,1386,482,128,6960,7088,-14,1316,11.006622829,8.1665841759,2.8400386528,0.754201136,41.009686771,41.763887907
2024,Texas,Parmer County,9617,-32,164,103,61,48,-142,-94,1,94,17.024810547,10.692411502,6.3323990449,4.9828713796,-14.7409945,-9.758123118
2024,Texas,Pecos County,14623,-88,189,169,20,32,-141,-109,1,1903,12.886070771,11.522465399,1.3636053726,2.1817685962,-9.613417877,-7.431649281
2024,Texas,Polk County,54186,930,579,844,-265,7,1185,1192,3,3825,10.777908081,15.710802107,-4.932894027,0.1303028611,22.058412911,22.188715772
2024,Texas,Potter County,114647,-264,1692,1402,290,444,-994,-550,-4,6386,14.741372551,12.214777965,2.5265945861,3.8683034353,-8.660120754,-4.791817318
2024,Texas,Presidio County,5795,-159,90,70,20,49,-226,-177,-2,46,15.320452804,11.915907737,3.4045450677,8.3411354158,-38.47135926,-30.13022385
2024,Texas,Rains County,12986,150,111,198,-87,6,230,236,1,59,8.5973201146,15.335760204,-6.73844009,0.4647200062,17.814266904,18.27898691
2024,Texas,Randall County,148255,2011,1852,1300,552,173,1284,1457,2,2534,12.577292283,8.8285528983,3.7487393845,1.1748766549,8.7198937857,9.8947704406
2024,Texas,Reagan County,3141,20,47,32,15,13,-9,4,1,0,15.011178537,10.220376876,4.7908016608,4.152028106,-2.874480996,1.2775471095
2024,Texas,Real County,2854,22,31,61,-30,0,51,51,1,65,10.903974675,21.456208231,-10.55223356,0.0,17.938797045,17.938797045
2024,Texas,Red River County,11678,73,140,225,-85,13,144,157,1,156,12.025941674,19.327406262,-7.301464588,1.116694584,12.369540008,13.486234592
2024,Texas,Reeves County,11770,78,187,151,36,44,0,44,-2,463,15.94067002,12.87187793,3.0687920893,3.750745887,0.0,3.750745887
2024,Texas,Refugio County,6666,28,54,110,-56,0,84,84,0,78,8.1178592904,16.536380036,-8.418520746,0.0,12.627781118,12.627781118
2024,Texas,Roberts County,840,28,14,7,7,0,21,21,0,0,16.949152542,8.4745762712,8.4745762712,0.0,25.423728814,25.423728814
2024,Texas,Robertson County,17267,137,211,260,-49,-3,187,184,2,159,12.268511789,15.117597465,-2.849085676,-0.174433817,10.873041254,10.698607437
2024,Texas,Rockwall County,131307,7965,1367,781,586,156,7267,7423,-44,723,10.736346893,6.133933375,4.6024135182,1.2252158854,57.074639995,58.29985588
2024,Texas,Runnels County,9868,-16,122,187,-65,5,44,49,0,179,12.353179425,18.934791414,-6.581611989,0.5062778453,4.4552450385,4.9615228838
2024,Texas,Rusk County,53079,555,534,694,-160,41,676,717,-2,4747,10.113349053,13.143565997,-3.030216945,0.7764930921,12.802666591,13.579159683
2024,Texas,Sabine County,10106,65,108,237,-129,5,190,195,-1,124,10.721199186,23.527075991,-12.80587681,0.4963518142,18.861368938,19.357720752
2024,Texas,San Augustine County,7833,-27,90,182,-92,-2,68,66,-1,220,11.470082202,23.19505512,-11.72497292,-0.254890716,8.6662843306,8.411393615
2024,Texas,San Jacinto County,28936,596,307,449,-142,3,737,740,-2,136,10.720022348,15.678469167,-4.958446819,0.1047559187,25.735037363,25.839793282
2024,Texas,San Patricio County,70660,573,936,760,176,145,250,395,2,353,13.300461111,10.799519706,2.5009414055,2.0604346807,3.5524735874,5.612908268
2024,Texas,San Saba County,5845,-35,54,85,-31,3,-7,-4,0,697,9.21108742,14.498933902,-5.287846482,0.5117270789,-1.194029851,-0.682302772
2024,Texas,Schleicher County,2391,32,39,33,6,0,26,26,0,31,16.421052632,13.894736842,2.5263157895,0.0,10.947368421,10.947368421
2024,Texas,Scurry County,16212,-57,201,211,-10,42,-91,-49,2,963,12.376466242,12.992210831,-0.615744589,2.5861272744,-5.603275761,-3.017148487
2024,Texas,Shackelford County,3229,17,33,41,-8,1,24,25,0,33,10.246856078,12.7309424,-2.484086322,0.3105107902,7.452258966,7.7627697562
2024,Texas,Shelby County,24179,118,398,367,31,-13,99,86,1,119,16.500829187,15.215588723,1.2852404643,-0.538971808,4.1044776119,3.5655058043
2024,Texas,Sherman County,2678,-100,45,31,14,1,-115,-114,0,25,16.495601173,11.363636364,5.1319648094,0.366568915,-42.15542522,-41.7888563
2024,Texas,Smith County,245209,3214,3049,2544,505,278,2426,2704,5,5523,12.5163176,10.443264013,2.0730535874,1.1412057372,9.9588673328,11.10007307
2024,Texas,Somervell County,9888,91,103,116,-13,20,83,103,1,127,10.46482093,11.785623571,-1.320802642,2.032004064,8.4328168656,10.46482093
2024,Texas,Starr County,65934,281,1100,559,541,13,-278,-265,5,348,16.718976799,8.4962800277,8.222696771,0.1975879076,-4.225341409,-4.027753501
2024,Texas,Stephens County,9343,-34,89,141,-52,-4,23,19,-1,921,9.5085470085,15.064102564,-5.555555556,-0.427350427,2.4572649573,2.0299145299
2024,Texas,Sterling County,1397,-29,33,16,17,0,-46,-46,0,31,23.379383634,11.335458732,12.043924903,0.0,-32.58944385,-32.58944385
2024,Texas,Stonewall County,1218,0,10,21,-11,0,13,13,-2,58,8.210180624,17.24137931,-9.031198686,0.0,10.673234811,10.673234811
2024,Texas,Sutton County,3221,-11,37,47,-10,21,-23,-2,1,5,11.46753448,14.566868123,-3.099333643,6.5086006509,-7.12846738,-0.619866729
2024,Texas,Swisher County,6955,-4,83,94,-11,36,-29,7,0,653,11.930429783,13.511571079,-1.581141297,5.1746442432,-4.168463418,1.0061808251
2024,Texas,Tarrant County,2182947,27301,28006,14996,13010,8805,5354,14159,132,28347,12.910176179,6.9128401765,5.9973360027,4.0589195622,2.468081242,6.5270008042
2024,Texas,Taylor County,146836,1689,2015,1590,425,527,733,1260,4,6318,13.802173414,10.891045027,2.9111283876,3.6097992006,5.0208402544,8.630639455
2024,Texas,Terrell County,687,-1,5,20,-15,0,14,14,0,0,7.2727272727,29.090909091,-21.81818182,0.0,20.363636364,20.363636364
2024,Texas,Terry County,11547,103,178,146,32,38,32,70,1,567,15.484319951,12.700621983,2.7836979688,3.3056413379,2.7836979688,6.0893393067
2024,Texas,Throckmorton County,1526,-13,13,23,-10,2,-5,-3,0,0,8.4828711256,15.008156607,-6.525285481,1.3050570962,-3.262642741,-1.957585644
2024,Texas,Titus County,31357,120,479,336,143,61,-86,-25,2,238,15.304981308,10.735853277,4.5691280314,1.9490686008,-2.747867208,-0.798798607
2024,Texas,Tom Green County,119057,144,1516,1267,249,136,-241,-105,0,3449,12.74110182,10.648401059,2.0927007606,1.1430012186,-2.025465395,-0.882464176
2024,Texas,Travis County,1334961,7411,16289,6312,9977,8068,-10479,-2411,-155,34552,12.235817993,4.7413888619,7.494429131,6.0604444451,-7.871516775,-1.81107233
2024,Texas,Trinity County,14228,235,147,306,-159,6,390,396,-2,108,10.417773998,21.685978527,-11.26820453,0.4252152652,27.63899224,28.064207505
2024,Texas,Tyler County,20382,-29,210,375,-165,13,124,137,-1,2310,10.295884098,18.385507317,-8.08962322,0.6373642537,6.0794744196,6.7168386733
2024,Texas,Upshur County,43281,827,496,600,-104,18,917,935,-4,437,11.57053712,13.996617484,-2.426080364,0.4198985245,21.391497055,21.811395579
2024,Texas,Upton County,3109,-37,27,31,-4,1,-34,-33,0,63,8.6330935252,9.9120703437,-1.278976819,0.3197442046,-10.87130296,-10.55155875
2024,Texas,Uvalde County,24960,70,407,324,83,76,-90,-14,1,841,16.328986961,12.998996991,3.3299899699,3.0491474423,-3.610832497,-0.561685055
2024,Texas,Val Verde County,47720,103,829,457,372,107,-376,-269,0,1971,17.390939509,9.587043855,7.8038956544,2.2446689113,-7.887808511,-5.6431396
2024,Texas,Van Zandt County,64000,1112,655,875,-220,10,1329,1339,-7,569,10.324065317,13.79169031,-3.467624992,0.1576193178,20.947607339,21.105226657
2024,Texas,Victoria County,91664,590,1299,1004,295,49,244,293,2,1113,14.217075813,10.988409636,3.2286661778,0.5362869244,2.6704899911,3.2067769156
2024,Texas,Walker County,81268,1590,697,654,43,204,1335,1539,8,19978,8.6612901222,8.1269494116,0.5343407105,2.5350117431,16.589415083,19.124426826
2024,Texas,Waller County,63553,1701,761,482,279,83,1338,1421,1,6205,12.136677166,7.687093816,4.4495833499,1.3237111758,21.338862087,22.662573263
2024,Texas,Ward County,10966,18,173,119,54,1,-37,-36,0,93,15.788993338,10.860637036,4.9283563019,0.0912658574,-3.376836725,-3.285570868
2024,Texas,Washington County,37007,639,381,479,-98,26,712,738,-1,2298,10.385008518,13.056218058,-2.67120954,0.7086882453,19.407155026,20.115843271
2024,Texas,Webb County,269148,1529,4420,1664,2756,795,-2054,-1259,32,4011,16.468970708,6.2000830901,10.268887618,2.9621791205,-7.653227564,-4.691048444
2024,Texas,Wharton County,41739,-1,555,534,21,42,-67,-25,3,572,13.296757268,12.793636723,0.5031205453,1.0062410906,-1.605194121,-0.59895303
2024,Texas,Wheeler County,4804,17,64,91,-27,13,31,44,0,56,13.345845063,18.976123449,-5.630278386,2.7108747784,6.4643937024,9.1752684809
2024,Texas,Wichita County,130180,-40,1742,1539,203,234,-480,-246,3,11332,13.379416283,11.820276498,1.5591397849,1.797235023,-3.686635945,-1.889400922
2024,Texas,Wilbarger County,12522,-13,184,191,-7,10,-16,-6,0,842,14.686514746,15.245240851,-0.558726104,0.7981801493,-1.277088239,-0.47890809
2024,Texas,Willacy County,20037,-217,245,212,33,10,-258,-248,-2,2692,12.161524906,10.52344196,1.6380829466,0.4963887717,-12.80683031,-12.31044154
2024,Texas,Williamson County,697191,24918,8043,3494,4549,2390,17943,20333,36,4687,11.746201434,5.1027263221,6.6434751114,3.4904166886,26.204412821,29.69482951
2024,Texas,Wilson County,54183,1429,592,582,10,57,1370,1427,-8,422,11.071939553,10.884913547,0.187026006,1.066048234,25.622562817,26.688611051
2024,Texas,Winkler County,7414,114,127,85,42,14,60,74,-2,152,17.262471116,11.5536224,5.7088487155,1.9029495718,8.155498165,10.058447737
2024,Texas,Wise County,78097,3200,915,743,172,31,3008,3039,-11,843,11.961253382,9.7127991947,2.2484541877,0.4052446501,39.321803469,39.72704812
2024,Texas,Wood County,47921,991,416,806,-390,90,1295,1385,-4,1553,8.7716523811,16.995076488,-8.223424107,1.8977132555,27.305985177,29.203698432
2024,Texas,Yoakum County,7468,-16,132,80,52,73,-144,-71,3,57,17.656500803,10.700909577,6.9555912253,9.7645799893,-19.26163724,-9.49705725
2024,Texas,Young County,18124,112,237,306,-69,8,175,183,-2,232,13.117113128,16.936019482,-3.818906354,0.4427717512,9.6856320567,10.128403808
2024,Texas,Zapata County,13736,-102,209,141,68,20,-188,-168,-2,101,15.15920795,10.227025459,4.9321824908,1.450641909,-13.63603395,-12.18539204
2024,Texas,Zavala County,9312,-72,169,148,21,3,-97,-94,1,43,18.078733419,15.832263586,2.2464698331,0.3209242619,-10.37655113,-10.05562687
2024,Utah,Utah,3417734,36498,45965,21169,24796,10285,1338,11623,79,55398,13.521165706,6.2271196961,7.2940460099,3.0254582679,0.3935890289,3.4190472969
2024,Utah,Beaver County,7233,-84,106,77,29,10,-123,-113,0,379,14.570446735,10.58419244,3.9862542955,1.3745704467,-16.90721649,-15.53264605
2024,Utah,Box Elder County,62684,1161,831,480,351,36,773,809,1,327,13.380888356,7.7290329853,5.6518553705,0.5796774739,12.446963537,13.026641011
2024,Utah,Cache County,142393,2248,2122,729,1393,333,515,848,7,4609,15.020988327,5.1603678089,9.8606205183,2.3572050485,3.6455273273,6.0027323758
2024,Utah,Carbon County,20609,69,226,291,-65,2,135,137,-3,250,10.984471069,14.143721597,-3.159250529,0.0972077086,6.5615203286,6.6587280371
2024,Utah,Daggett County,992,-23,10,7,3,0,-27,-27,1,0,9.9651220727,6.9755854509,2.9895366218,0.0,-26.9058296,-26.9058296
2024,Utah,Davis County,373207,3320,4769,2122,2647,511,132,643,30,2161,12.835522828,5.7112559111,7.1242669164,1.3753307119,0.3552713385,1.7306020503
2024,Utah,Duchesne County,20477,335,281,177,104,1,232,233,-2,183,13.835889608,8.715133312,5.1207562963,0.0492380413,11.423225584,11.472463625
2024,Utah,Emery County,10144,51,124,126,-2,11,41,52,1,61,12.254780847,12.452438603,-0.197657756,1.0871176558,4.0519839897,5.1391016455
2024,Utah,Garfield County,5314,56,58,61,-3,0,60,60,-1,269,10.972379871,11.539916761,-0.56753689,0.0,11.350737798,11.350737798
2024,Utah,Grand County,9706,-65,98,85,13,26,-104,-78,0,154,10.063151409,8.7282435693,1.33490784,2.66981568,-10.67926272,-8.00944704
2024,Utah,Iron County,64211,1703,823,419,404,161,1136,1297,2,1676,12.989370181,6.6130572369,6.3763129444,2.5410554061,17.929434418,20.470489824
2024,Utah,Juab County,13023,437,201,89,112,3,326,329,-4,102,15.69760631,6.9506814011,8.7469249092,0.2342926315,25.459799289,25.694091921
2024,Utah,Kane County,8425,222,93,101,-8,1,231,232,-2,217,11.185951407,12.148183786,-0.962232379,0.1202790474,27.784459947,27.904738994
2024,Utah,Millard County,13437,94,180,133,47,6,40,46,1,127,13.442867812,9.9327856609,3.5100821509,0.4480955937,2.9873039582,3.4353995519
2024,Utah,Morgan County,13000,163,139,70,69,6,90,96,-2,28,10.75976313,5.4185857491,5.3411773813,0.4644502071,6.966753106,7.4312033131
2024,Utah,Piute County,1550,57,18,24,-6,0,64,64,-1,0,11.830430496,15.773907328,-3.943476832,0.0,42.063752875,42.063752875
2024,Utah,Rich County,2670,21,28,18,10,-1,11,10,1,56,10.528294792,6.7681895093,3.7601052829,-0.376010528,4.1361158112,3.7601052829
2024,Utah,Salt Lake County,1185813,-756,14841,7436,7405,5951,-14070,-8119,-42,17818,12.511475808,6.2688049395,6.2426708684,5.0168986276,-11.86149617,-6.84459754
2024,Utah,San Juan County,14358,-48,185,156,29,17,-96,-79,2,381,12.863301349,10.846891948,2.0164094006,1.1820330969,-6.67501043,-5.492977333
2024,Utah,Sanpete County,30277,586,382,270,112,46,431,477,-3,2938,12.740128068,9.0048025614,3.7353255069,1.5341515475,14.374332978,15.908484525
2024,Utah,Sevier County,22344,301,284,226,58,-3,248,245,-2,371,12.796539527,10.183161737,2.6133777908,-0.135174713,11.174442968,11.039268254
2024,Utah,Summit County,42759,-286,418,210,208,115,-613,-498,4,133,9.7431355182,4.8948766957,4.8482588224,2.6805277143,-14.28837816,-11.60785045
2024,Utah,Tooele County,82051,2096,1070,491,579,56,1464,1520,-3,516,13.209387307,6.0615038949,7.1478834117,0.6913324198,18.073404689,18.764737109
2024,Utah,Uintah County,37747,643,497,318,179,50,413,463,1,114,13.279715702,8.4968804692,4.7828352327,1.3359874952,11.03525671,12.371244205
2024,Utah,Utah County,719174,16482,11955,3065,8890,2381,5130,7511,81,15667,16.815930615,4.3112360799,12.504694535,3.3491200999,7.2158698499,10.56498995
2024,Utah,Wasatch County,37144,547,383,187,196,137,214,351,0,236,10.387708331,5.0718053729,5.3159029576,3.7157076796,5.8040981272,9.5198058068
2024,Utah,Washington County,202452,4722,2298,1762,536,173,4023,4196,-10,3211,11.484774428,8.8059932731,2.6787811546,0.864606604,20.105851837,20.970458441
2024,Utah,Wayne County,2614,-20,32,33,-1,-1,-17,-18,-1,0,12.195121951,12.576219512,-0.381097561,-0.381097561,-6.478658537,-6.859756098
2024,Utah,Weber County,271926,2466,3513,2006,1507,257,679,936,23,3414,12.977801421,7.4106090664,5.5671923544,0.94941502,2.5083766481,3.4577916681
2024,Vermont,Vermont,647464,354,5072,6876,-1804,1312,844,2156,2,24942,7.8357822728,10.622799469,-2.787017196,2.0269215974,1.3039038325,3.3308254298
2024,Vermont,Addison County,37720,165,289,373,-84,96,153,249,0,3018,7.6785121222,9.9103287944,-2.231816672,2.5506476254,4.0650946529,6.6157422783
2024,Vermont,Bennington County,37183,-160,263,545,-282,77,47,124,-2,1459,7.057939511,14.625768188,-7.567828677,2.0663929367,1.2613047795,3.3276977162
2024,Vermont,Caledonia County,30610,23,239,397,-158,6,175,181,0,1059,7.8108404007,12.974492214,-5.163651813,0.1960880435,5.719234603,5.9153226465
2024,Vermont,Chittenden County,169481,124,1334,1297,37,872,-789,83,4,9901,7.8739692715,7.6555758209,0.2183934506,5.1470024023,-4.65709277,0.4899096323
2024,Vermont,Essex County,6010,13,56,89,-33,0,46,46,0,50,9.327892063,14.8246856,-5.496793537,0.0,7.6621970517,7.6621970517
2024,Vermont,Franklin County,50994,275,524,473,51,20,202,222,2,676,10.303501027,9.3006793625,1.0028216649,0.393263398,3.9719603197,4.3652237177
2024,Vermont,Grand Isle County,7467,-23,62,101,-39,3,13,16,0,0,8.2904325734,13.505382095,-5.214949522,0.4011499632,1.7383165073,2.1394664705
2024,Vermont,Lamoille County,26060,-43,208,251,-43,65,-67,-2,2,626,7.9750014378,9.6236796197,-1.648678182,2.4921879493,-2.568870655,-0.076682706
2024,Vermont,Orange County,29943,63,248,307,-59,19,102,121,1,647,8.2911254869,10.263610986,-1.972485499,0.6352071946,3.410059676,4.0452668706
2024,Vermont,Orleans County,27516,-46,208,437,-229,-4,187,183,0,736,7.5529249428,15.868404808,-8.315479865,-0.145248557,6.7903700207,6.6451214641
2024,Vermont,Rutland County,60271,-82,444,790,-346,3,261,264,0,1880,7.3617190609,13.098554185,-5.736835124,0.049741345,4.3274970155,4.3772383605
2024,Vermont,Washington County,60142,27,443,609,-166,39,157,196,-3,2331,7.3675544875,10.128308539,-2.760754052,0.6486108917,2.6110746152,3.2596855069
2024,Vermont,Windham County,45966,67,336,529,-193,32,229,261,-1,1817,7.3150819137,11.516899799,-4.201817885,0.696674468,4.9855766614,5.6822511294
2024,Vermont,Windsor County,58101,-49,418,678,-260,84,128,212,-1,742,7.1913359885,11.66441579,-4.473079801,1.4451488589,2.2021315946,3.6472804535
2024,Virginia,Virginia,8715698,36599,95669,79980,15689,28117,-6985,21132,-222,235956,10.999725953,9.1958532198,1.8038727327,3.2328057637,-0.803113713,2.429692051
2024,Virginia,Accomack County,33239,16,359,532,-173,68,121,189,0,384,10.803165719,16.009148085,-5.205982366,2.046282086,3.6411784177,5.6874605037
2024,Virginia,Albemarle County,115676,831,1047,916,131,405,299,704,-4,7500,9.0837711098,7.9472152212,1.1365558886,3.5137796556,2.5941237458,6.1079034014
2024,Virginia,Alleghany County,14595,-120,79,301,-222,1,102,103,-1,285,5.3906516547,20.539065165,-15.14841351,0.0682360969,6.9600818833,7.0283179802
2024,Virginia,Amelia County,13480,112,123,219,-96,6,203,209,-1,94,9.162693683,16.314064362,-7.151370679,0.4469606675,15.122169249,15.569129917
2024,Virginia,Amherst County,31396,-76,275,464,-189,14,99,113,0,735,8.7484888974,14.761086721,-6.012597824,0.4453776166,3.1494560031,3.5948336196
2024,Virginia,Appomattox County,16864,161,190,194,-4,1,163,164,1,80,11.320642297,11.558971609,-0.238329312,0.0595823279,9.7119194447,9.7715017726
2024,Virginia,Arlington County,234162,484,2601,974,1627,1838,-2979,-1141,-2,2847,11.119186047,4.1638166895,6.955369357,7.8573871409,-12.73512312,-4.877735978
2024,Virginia,Augusta County,78247,308,521,886,-365,33,641,674,-1,2997,6.6715326598,11.345447095,-4.673914435,0.4225730859,8.2081620632,8.6307351491
2024,Virginia,Bath County,4051,-10,43,75,-32,1,22,23,-1,57,10.601577909,18.49112426,-7.889546351,0.2465483235,5.4240631164,5.6706114398
2024,Virginia,Bedford County,81525,784,644,970,-326,35,1085,1120,-10,515,7.9375839671,11.955677714,-4.018093747,0.431390433,13.373103423,13.804493856
2024,Virginia,Bland County,6179,41,32,102,-70,0,113,113,-2,683,5.1960704717,16.562474629,-11.36640416,0.0,18.348623853,18.348623853
2024,Virginia,Botetourt County,34125,25,263,456,-193,9,214,223,-5,384,7.7097838036,13.367533895,-5.657750092,0.2638329058,6.2733602052,6.537193111
2024,Virginia,Brunswick County,15749,-82,118,267,-149,9,59,68,-1,2007,7.4730842305,16.909436352,-9.436352122,0.5699810006,3.7365421153,4.3065231159
2024,Virginia,Buchanan County,19087,-296,181,379,-198,5,-104,-99,1,1286,9.4099298154,19.703665194,-10.29373538,0.2599428126,-5.406810502,-5.146867689
2024,Virginia,Buckingham County,16978,-10,133,222,-89,0,77,77,2,2211,7.8313607725,13.071895425,-5.240534652,0.0,4.5339457104,4.5339457104
2024,Virginia,Campbell County,55270,205,375,712,-337,17,525,542,0,789,6.7974804006,12.906149454,-6.108669053,0.3081524448,9.5164725608,9.8246250057
2024,Virginia,Caroline County,32640,700,354,371,-17,26,692,718,-1,500,10.963146485,11.489625271,-0.526478786,0.8052028492,21.430783524,22.235986373
2024,Virginia,Carroll County,29239,121,269,502,-233,10,344,354,0,163,9.2191168155,17.204448481,-7.985331665,0.3427180972,11.789502545,12.132220642
2024,Virginia,Charles City County,6610,42,37,114,-77,0,120,120,-1,0,5.6154196388,17.301563211,-11.68614357,0.0,18.212171801,18.212171801
2024,Virginia,Charlotte County,11336,-64,146,235,-89,-2,28,26,-1,129,12.843068262,20.672061928,-7.828993666,-0.175932442,2.4630541872,2.2871217452
2024,Virginia,Chesterfield County,383876,5586,4144,2935,1209,767,3635,4402,-25,5263,10.874271484,7.7017342679,3.1725372163,2.0126849007,9.538604451,11.551289352
2024,Virginia,Clarke County,15466,135,159,181,-22,3,154,157,0,241,10.325681073,11.754391662,-1.428710589,0.1948241712,10.000974121,10.195798292
2024,Virginia,Craig County,4843,-15,45,73,-28,0,13,13,0,0,9.2773940831,15.049994846,-5.772600763,0.0,2.6801360684,2.6801360684
2024,Virginia,Culpeper County,54973,683,664,529,135,113,438,551,-3,1431,12.154160146,9.6830583089,2.4711018369,2.0684037597,8.0173526262,10.085756386
2024,Virginia,Cumberland County,9878,127,84,131,-47,9,167,176,-2,21,8.5587650925,13.347597942,-4.788832849,0.9170105456,17.015640124,17.93265067
2024,Virginia,Dickenson County,13640,-93,120,220,-100,4,4,8,-1,402,8.7677638549,16.074233734,-7.306469879,0.2922587952,0.2922587952,0.5845175903
2024,Virginia,Dinwiddie County,28343,244,182,364,-182,18,409,427,-1,411,6.4490981893,12.898196379,-6.449098189,0.6378228978,14.492753623,15.130576521
2024,Virginia,Essex County,10598,-32,113,183,-70,3,35,38,0,75,10.646316186,17.24137931,-6.595063124,0.2826455625,3.2975315621,3.5801771246
2024,Virginia,Fairfax County,1141878,2569,12496,5120,7376,8536,-13405,-4869,62,11560,10.955699818,4.4888910905,6.4668087272,7.4838231149,-11.75265333,-4.268830219
2024,Virginia,Fauquier County,75165,488,742,662,80,68,350,418,-10,399,9.9037652994,8.8359738925,1.0677914069,0.9076226959,4.6715874054,5.5792101013
2024,Virginia,Floyd County,15679,56,111,213,-102,10,150,160,-2,111,7.0921985816,13.609354035,-6.517155453,0.6389368091,9.5840521372,10.222988946
2024,Virginia,Fluvanna County,28462,345,259,285,-26,1,371,372,-1,1192,9.1553403206,10.074409233,-0.919068912,0.0353488043,13.114406405,13.14975521
2024,Virginia,Franklin County,55549,470,509,739,-230,31,669,700,0,1227,9.202010341,13.36008967,-4.158079329,0.5604367791,12.094587265,12.655024045
2024,Virginia,Frederick County,95994,1186,902,918,-16,96,1113,1209,-7,1049,9.4548275175,9.6225406442,-0.167713127,1.0062787602,11.666544376,12.672823136
2024,Virginia,Giles County,16457,25,150,289,-139,-1,167,166,-2,125,9.1215908054,17.574264952,-8.452674146,-0.060810605,10.155371097,10.094560491
2024,Virginia,Gloucester County,40057,507,369,474,-105,1,614,615,-3,303,9.2705415353,11.908500509,-2.637958973,0.0251234188,15.42577914,15.450902559
2024,Virginia,Goochland County,27197,1035,211,272,-61,4,1097,1101,-5,920,7.908693941,10.195093611,-2.28639967,0.1499278472,41.117712101,41.267639948
2024,Virginia,Grayson County,15285,-40,119,267,-148,1,110,111,-3,1095,7.7752368507,17.44527932,-9.67004247,0.0653381248,7.1871937275,7.2525318523
2024,Virginia,Greene County,21301,286,237,230,7,7,270,277,2,159,11.201436809,10.870592684,0.3308441252,0.3308441252,12.761130542,13.091974667
2024,Virginia,Greensville County,11133,-71,96,158,-62,-1,-9,-10,1,3291,8.5956037069,14.146931101,-5.551327394,-0.089537539,-0.805837848,-0.895375386
2024,Virginia,Halifax County,33432,-188,332,592,-260,2,70,72,0,623,9.9027620354,17.657937123,-7.755175088,0.059655193,2.0879317545,2.1475869474
2024,Virginia,Hanover County,114148,1288,1066,1145,-79,33,1346,1379,-12,2070,9.3917394982,10.087750211,-0.696010713,0.2907386524,11.858612912,12.149351565
2024,Virginia,Henrico County,334760,207,3690,3111,579,1386,-1760,-374,2,4586,11.026231375,9.2960991345,1.7301322401,4.1415600773,-5.259123908,-1.11756383
2024,Virginia,Henry County,49702,-93,393,908,-515,-1,431,430,-8,689,7.8997356704,18.251806587,-10.35207092,-0.020101109,8.6635777963,8.6434766877
2024,Virginia,Highland County,2339,43,18,33,-15,-1,61,60,-2,0,7.7669902913,14.239482201,-6.472491909,-0.431499461,26.321467098,25.889967638
2024,Virginia,Isle of Wight County,40711,576,408,459,-51,65,564,629,-2,199,10.093263736,11.354921703,-1.261657967,1.6079954481,13.952452812,15.56044826
2024,Virginia,James City County,82654,1171,822,774,48,133,1003,1136,-13,1397,10.0160232,9.431145933,0.5848772672,1.6205974278,12.221497895,13.842095323
2024,Virginia,King and Queen County,6720,6,47,102,-55,0,60,60,1,0,6.9971713563,15.185350603,-8.188179247,0.0,8.9325591782,8.9325591782
2024,Virginia,King George County,28568,650,321,204,117,21,511,532,1,202,11.365648125,7.2230287151,4.1426194101,0.7435470736,18.092978791,18.836525865
2024,Virginia,King William County,19030,501,245,221,24,9,470,479,-2,70,13.046140739,11.768151442,1.2779892968,0.4792459863,25.027290396,25.506536383
2024,Virginia,Lancaster County,10859,53,73,228,-155,4,205,209,-1,228,6.7389799215,21.047772906,-14.30879298,0.3692591738,18.924532656,19.29379183
2024,Virginia,Lee County,21745,-102,173,385,-212,3,106,109,1,1480,7.9372361901,17.663791521,-9.726555331,0.1376399339,4.8632776656,5.0009175996
2024,Virginia,Loudoun County,436347,3555,4924,1620,3304,1962,-1762,200,51,1237,11.330753769,3.7278271945,7.6029265745,4.5148129356,-4.054587356,0.4602255796
2024,Virginia,Louisa County,41037,1007,416,472,-56,44,1018,1062,1,99,10.263115694,11.644688961,-1.381573267,1.0855218523,25.11502831,26.200550162
2024,Virginia,Lunenburg County,12038,36,115,171,-56,18,75,93,-1,984,9.5673876872,14.226289517,-4.65890183,1.4975041597,6.2396006656,7.7371048253
2024,Virginia,Madison County,14128,120,128,172,-44,26,139,165,-1,242,9.0986636338,12.226329258,-3.127665624,1.8481660506,9.8805800398,11.72874609
2024,Virginia,Mathews County,8514,64,63,171,-108,0,174,174,-2,97,7.4274935157,20.160339543,-12.73284603,0.0,20.51402971,20.51402971
2024,Virginia,Mecklenburg County,30648,121,301,540,-239,64,295,359,1,910,9.8406211688,17.654270535,-7.813649367,2.0923579894,9.6444626073,11.736820597
2024,Virginia,Middlesex County,10924,-28,90,206,-116,32,56,88,0,373,8.2281952825,18.833424758,-10.60522948,2.9255805449,5.1197659536,8.0453464984
2024,Virginia,Montgomery County,98666,-160,634,763,-129,584,-623,-39,8,10921,6.420513236,7.7268952666,-1.306382031,5.9141636117,-6.309116319,-0.394952707
2024,Virginia,Nelson County,14705,-42,166,207,-41,22,-22,0,-1,68,11.272579112,14.056770338,-2.784191226,1.4939562678,-1.493956268,0.0
2024,Virginia,New Kent County,26134,1182,253,245,8,1,1172,1173,1,591,9.9048663039,9.5916689504,0.3131973535,0.0391496692,45.883412285,45.922561954
2024,Virginia,Northampton County,12021,43,114,212,-98,24,117,141,0,268,9.5003958498,17.667402808,-8.167006959,2.0000833368,9.7504062669,11.750489604
2024,Virginia,Northumberland County,12391,113,85,232,-147,-2,261,259,1,0,6.8912400178,18.809031578,-11.91779156,-0.162146824,21.160160525,20.998013701
2024,Virginia,Nottoway County,15566,11,169,253,-84,11,86,97,-2,2338,10.860833521,16.259117638,-5.398284117,0.7069181582,5.526814691,6.2337328492
2024,Virginia,Orange County,38574,519,438,455,-17,9,526,535,1,240,11.431703402,11.875399653,-0.443696251,0.2348980151,13.728483994,13.963382009
2024,Virginia,Page County,23741,-36,213,335,-122,18,67,85,1,203,8.9650237805,14.09992003,-5.13489625,0.7576076434,2.8199840061,3.5775916495
2024,Virginia,Patrick County,17509,-92,160,345,-185,-1,94,93,0,351,9.1142124751,19.652520649,-10.53830817,-0.056963828,5.3545998291,5.2976360011
2024,Virginia,Pittsylvania County,59571,-253,406,812,-406,-1,158,157,-4,1293,6.8009548139,13.601909628,-6.800954814,-0.01675112,2.6466769965,2.6299258763
2024,Virginia,Powhatan County,32105,520,285,304,-19,20,521,541,-2,1069,8.9495996232,9.5462395981,-0.596639975,0.6280420788,16.360496153,16.988538232
2024,Virginia,Prince Edward County,22049,150,207,266,-59,33,175,208,1,4417,9.420223901,12.105215254,-2.684991353,1.5017748248,7.9639574042,9.465732229
2024,Virginia,Prince George County,42871,-150,369,363,6,54,-211,-157,1,9253,8.5921855353,8.4524752014,0.1397103339,1.2573930052,-4.913146742,-3.655753737
2024,Virginia,Prince William County,489640,2628,6230,2324,3906,2658,-3991,-1333,55,2967,12.757870767,4.7591158366,7.9987549301,5.4430851521,-8.172818977,-2.729733825
2024,Virginia,Pulaski County,33655,-28,296,536,-240,5,206,211,1,1059,8.7914698981,15.919688734,-7.128218836,0.1485045591,6.1183878345,6.2668923936
2024,Virginia,Rappahannock County,7414,-39,35,94,-59,-3,24,21,-1,4,4.7084146095,12.64545638,-7.93704177,-0.403578395,3.2286271608,2.8250487657
2024,Virginia,Richmond County,9184,58,93,128,-35,15,80,95,-2,1548,10.158383397,13.981430912,-3.823047515,1.638448935,8.73839432,10.376843255
2024,Virginia,Roanoke County,97026,270,700,1145,-445,110,612,722,-7,2151,7.2246132252,11.817403061,-4.592789836,1.135296364,6.316376134,7.451672498
2024,Virginia,Rockbridge County,22358,-210,98,327,-229,3,18,21,-2,490,4.3627298224,14.557271958,-10.19454214,0.1335529537,0.8013177225,0.9348706762
2024,Virginia,Rockingham County,86568,1154,917,923,-6,155,1012,1167,-7,2278,10.663906688,10.733681432,-0.069774744,1.8025142166,11.768673466,13.571187682
2024,Virginia,Russell County,25477,40,265,436,-171,3,209,212,-1,311,10.409710492,17.126919904,-6.717209412,0.1178457792,8.2099226146,8.3277683938
2024,Virginia,Scott County,21433,-47,178,377,-199,0,155,155,-3,772,8.2958544031,17.570433202,-9.274578799,0.0,7.22391816,7.22391816
2024,Virginia,Shenandoah County,45228,292,472,588,-116,81,328,409,-1,451,10.469810567,13.042899605,-2.573089038,1.796725966,7.2756310723,9.0723570383
2024,Virginia,Smyth County,29216,-192,280,559,-279,13,74,87,0,538,9.5524017467,19.070687773,-9.518286026,0.4435043668,2.5245633188,2.9680676856
2024,Virginia,Southampton County,17975,76,108,257,-149,-1,227,226,-1,1444,6.0210737582,14.327925517,-8.306851759,-0.055750683,12.655405029,12.599654346
2024,Virginia,Spotsylvania County,149588,2760,1569,1112,457,224,2102,2326,-23,322,10.586473065,7.5029688006,3.0835042643,1.5113893987,14.182770161,15.69415956
2024,Virginia,Stafford County,165428,2259,1772,945,827,431,1029,1460,-28,3172,10.785247583,5.7517262787,5.0335213042,2.6232741017,6.2629908368,8.8862649385
2024,Virginia,Surry County,6593,66,68,106,-38,-1,105,104,0,0,10.365853659,16.158536585,-5.792682927,-0.152439024,16.006097561,15.853658537
2024,Virginia,Sussex County,10757,117,85,178,-93,0,212,212,-2,2131,7.9450390242,16.637846427,-8.692807403,0.0,19.815862037,19.815862037
2024,Virginia,Tazewell County,39120,-443,242,731,-489,16,31,47,-1,1734,6.1512652034,18.580887867,-12.42962266,0.4066952201,0.7879719889,1.1946672089
2024,Virginia,Warren County,41843,439,451,506,-55,82,414,496,-2,1130,10.835225293,12.156594232,-1.321368938,1.9700409624,9.9463043713,11.916345334
2024,Virginia,Washington County,54050,195,453,806,-353,6,548,554,-6,1958,8.3962745007,14.939066772,-6.542792271,0.1112089338,10.157082619,10.268291553
2024,Virginia,Westmoreland County,19013,248,170,258,-88,-5,340,335,1,81,8.9999470591,13.658743184,-4.658796125,-0.264704325,17.999894118,17.735189793
2024,Virginia,Wise County,35174,-153,353,608,-255,-1,105,104,-2,2639,10.014042354,17.247982298,-7.233939944,-0.028368392,2.9786811535,2.9503127615
2024,Virginia,Wythe County,28104,-11,282,471,-189,0,178,178,0,150,10.032195521,16.75590103,-6.723705509,0.0,6.3323787332,6.3323787332
2024,Virginia,York County,70952,-212,604,588,16,79,-308,-229,1,1031,8.5000985111,8.2749303386,0.2251681725,1.1117678516,-4.33448732,-3.222719469
2024,Virginia,Alexandria city,155230,185,2284,902,1382,1428,-2570,-1142,-55,1383,14.722423656,5.8141970832,8.9082265732,9.2047377327,-16.56594956,-7.361211828
2024,Virginia,Bristol city,16807,-133,185,302,-117,-6,-8,-14,-2,296,10.963937535,17.89788722,-6.933949684,-0.355587163,-0.474116218,-0.829703381
2024,Virginia,Buena Vista city,6566,-3,79,109,-30,-6,33,27,0,568,12.028930339,16.596878569,-4.56794823,-0.913589646,5.0247430529,4.1111534069
2024,Virginia,Charlottesville city,44983,-289,575,365,210,192,-694,-502,3,2416,12.741676361,8.0881945599,4.6534818016,4.2546119329,-15.37864938,-11.12403745
2024,Virginia,Chesapeake city,253886,1427,2985,2166,819,379,235,614,-6,4009,11.790380077,8.5554315733,3.2349485035,1.4970030315,0.9282208771,2.4252239086
2024,Virginia,Colonial Heights city,18393,115,271,308,-37,7,147,154,-2,194,14.780071446,16.79801478,-2.017943334,0.3817730632,8.0172343269,8.39900739
2024,Virginia,Covington city,5545,-88,73,122,-49,4,-43,-39,0,77,13.061370549,21.828591877,-8.767221328,0.7156915369,-7.693684022,-6.977992485
2024,Virginia,Danville city,41837,-180,435,854,-419,29,212,241,-2,1487,10.375175901,20.368736137,-9.993560236,0.6916783934,5.0564075655,5.7480859589
2024,Virginia,Emporia city,5463,-70,67,103,-36,2,-36,-34,0,196,12.186249545,18.734085122,-6.547835577,0.3637686431,-6.547835577,-6.184066933
2024,Virginia,Fairfax city,25144,392,595,300,295,286,-189,97,0,323,23.849607183,12.025012025,11.824595158,11.463844797,-7.575757576,3.8880872214
2024,Virginia,Falls Church city,14685,196,173,166,7,50,140,190,-1,177,11.859875231,11.379995887,0.4798793446,3.4277096044,9.5975868924,13.025296497
2024,Virginia,Franklin city,8339,65,157,179,-22,0,87,87,0,111,18.900860772,21.549389033,-2.648528261,0.0,10.473725396,10.473725396
2024,Virginia,Fredericksburg city,28928,280,348,305,43,221,16,237,0,2322,12.088370154,10.594692233,1.4936779214,7.6768097819,0.5557871335,8.2325969154
2024,Virginia,Galax city,6717,15,120,169,-49,-3,68,65,-1,276,17.885088308,25.188166033,-7.303077726,-0.447127208,10.134883374,9.6877561666
2024,Virginia,Hampton city,137098,-760,1637,1504,133,180,-1071,-891,-2,3534,11.907359723,10.939932207,0.9674275157,1.3093003972,-7.790337363,-6.481036966
2024,Virginia,Harrisonburg city,51082,-68,595,355,240,425,-736,-311,3,7334,11.640190938,6.9449878707,4.6952030675,8.3144220988,-14.39862274,-6.084200642
2024,Virginia,Hopewell city,22752,-38,317,418,-101,8,54,62,1,250,13.921215581,18.356681744,-4.435466163,0.3513240525,2.3714373545,2.7227614071
2024,Virginia,Lexington city,7528,22,121,69,52,21,-50,-29,-1,2711,16.096847146,9.1791938273,6.9176533191,2.7936676866,-6.65158973,-3.857922043
2024,Virginia,Lynchburg city,79535,307,1149,922,227,127,-44,83,-3,10680,14.474405246,11.614796899,2.859608347,1.5998689871,-0.554285318,1.0455836687
2024,Virginia,Manassas city,42696,23,693,365,328,394,-697,-303,-2,67,16.235401609,8.5511134018,7.6842882077,9.2305169324,-16.32911244,-7.098595509
2024,Virginia,Manassas Park city,16361,-332,70,85,-15,100,-415,-315,-2,0,4.235493435,5.1430991711,-0.907605736,6.0507049071,-25.11042536,-19.05972046
2024,Virginia,Martinsville city,13763,66,260,298,-38,43,61,104,0,488,18.936635106,21.70429716,-2.767662054,3.1318281136,4.4428259286,7.5746540422
2024,Virginia,Newport News city,183118,-862,2504,1768,736,387,-1977,-1590,-8,8283,13.642133708,9.63230527,4.0098284382,2.1084288119,-10.77096579,-8.662536979
2024,Virginia,Norfolk city,230930,-1628,3102,2208,894,727,-3214,-2487,-35,22087,13.385459818,9.5277547639,3.8577050539,3.1370822977,-13.86875173,-10.73166943
2024,Virginia,Norton city,3492,-97,41,93,-52,0,-44,-44,-1,28,11.58028527,26.267476345,-14.68719107,0.0,-12.42762322,-12.42762322
2024,Virginia,Petersburg city,33309,-153,730,640,90,47,-286,-239,-4,528,21.865780054,19.169998952,2.6957811026,1.407796798,-8.566593282,-7.158796484
2024,Virginia,Poquoson city,12635,11,132,132,0,2,11,13,-2,90,10.451720179,10.451720179,0.0,0.1583593967,0.8709766816,1.0293360782
2024,Virginia,Portsmouth city,96793,-161,1329,1229,100,63,-316,-253,-8,2784,13.718922099,12.686648051,1.0322740481,0.6503326503,-3.261985992,-2.611653342
2024,Virginia,Radford city,16971,252,141,140,1,20,231,251,0,3466,8.3704363313,8.3110715346,0.0593647967,1.1872959335,13.713268032,14.900563966
2024,Virginia,Richmond city,229247,880,2971,2241,730,910,-717,193,-43,11631,12.9847426,9.7942807694,3.1904618303,3.9771510487,-3.133645387,0.843505662
2024,Virginia,Roanoke city,97171,-486,1266,1433,-167,271,-576,-305,-14,2057,12.996078592,14.710411235,-1.714332642,2.7819409941,-5.912907796,-3.130966801
2024,Virginia,Salem city,25600,-100,321,391,-70,57,-88,-31,1,2026,12.514619883,15.243664717,-2.729044834,2.2222222222,-3.43079922,-1.208576998
2024,Virginia,Staunton city,25915,-25,364,404,-40,72,-53,19,-4,1426,14.039147623,15.581911098,-1.542763475,2.7769742551,-2.044161604,0.7328126507
2024,Virginia,Suffolk city,100659,2233,1125,992,133,88,2013,2101,-1,1574,11.301705302,9.9655925861,1.3361127157,0.8840445036,20.22251802,21.106562524
2024,Virginia,Virginia Beach city,453649,-1420,5353,3635,1718,881,-4026,-3145,7,7011,11.781432744,8.0002817156,3.7811510282,1.9389953759,-8.860834714,-6.921839338
2024,Virginia,Waynesboro city,23182,383,356,312,44,13,325,338,1,274,15.484656706,13.570822731,1.9138339749,0.5654509471,14.136273678,14.701724625
2024,Virginia,Williamsburg city,15847,162,63,222,-159,48,273,321,0,4881,3.9959406317,14.080933655,-10.08499302,3.0445261956,17.315742738,20.360268933
2024,Virginia,Winchester city,27617,-244,335,331,4,62,-310,-248,0,1131,12.076859296,11.932657991,0.144201305,2.2351202278,-11.17560114,-8.940480911
2024,Washington,Washington,7812880,28403,82523,67663,14860,28919,-15276,13643,-100,153031,10.581664573,8.6762135405,1.9054510325,3.7081923559,-1.958793403,1.7493989527
2024,Washington,Adams County,20820,-78,349,160,189,14,-279,-265,-2,334,16.731386931,7.6705498825,9.0608370488,0.6711731147,-13.37552136,-12.70434824
2024,Washington,Asotin County,22549,13,221,309,-88,5,97,102,-1,231,9.8037041145,13.707441499,-3.903737385,0.2218032605,4.3029832539,4.5247865144
2024,Washington,Benton County,215219,2390,2477,1900,577,376,1435,1811,2,1245,11.573468396,8.8775090644,2.6959593317,1.7568123201,6.7048555302,8.4616678503
2024,Washington,Chelan County,79997,-41,791,850,-59,89,-72,17,1,1642,9.8853375824,10.62267629,-0.737338707,1.1122566938,-0.899803168,0.2124535258
2024,Washington,Clallam County,77616,-68,546,1243,-697,54,573,627,2,1368,7.0315518352,16.00772698,-8.976175145,0.6954282035,7.3792659369,8.0746941404
2024,Washington,Clark County,521150,4413,5536,4500,1036,766,2572,3338,39,3506,10.667828001,8.6714642345,1.996363766,1.4760759119,4.9562235581,6.43229947
2024,Washington,Columbia County,4053,27,34,66,-32,1,59,60,-1,60,8.4168832776,16.338655774,-7.921772497,0.2475553905,14.605768041,14.853323431
2024,Washington,Cowlitz County,112864,800,1218,1412,-194,55,937,992,2,937,10.830132309,12.555128752,-1.724996443,0.4890453834,8.3315549865,8.8206003699
2024,Washington,Douglas County,44798,575,508,377,131,83,360,443,1,565,11.413037373,8.4699115939,2.9431257793,1.8647285472,8.0879792409,9.9527077881
2024,Washington,Ferry County,7497,29,63,124,-61,6,85,91,-1,85,8.4196458403,16.572001336,-8.152355496,0.8018710324,11.359839626,12.161710658
2024,Washington,Franklin County,99034,452,1441,551,890,188,-631,-443,5,2787,14.583839365,5.5764715408,9.0073678245,1.9026799449,-6.386122581,-4.483442636
2024,Washington,Garfield County,2363,6,27,32,-5,0,12,12,-1,19,11.440677966,13.559322034,-2.118644068,0.0,5.0847457627,5.0847457627
2024,Washington,Grant County,102678,1098,1365,882,483,203,404,607,8,2162,13.365449578,8.6361366507,4.7293129278,1.987682245,3.9557814137,5.9434636587
2024,Washington,Grays Harbor County,77290,249,675,1152,-477,28,696,724,2,2743,8.7474324666,14.92895141,-6.181518943,0.3628564579,9.01957481,9.3824312679
2024,Washington,Island County,86267,-415,761,897,-136,83,-347,-264,-15,1784,8.8002821641,10.373000133,-1.572717969,0.9598205251,-4.012743641,-3.052923116
2024,Washington,Jefferson County,33714,144,162,436,-274,23,396,419,-1,509,4.8154093098,12.959990488,-8.144581178,0.683669223,11.771000535,12.454669758
2024,Washington,King County,2271380,6069,22890,15088,7802,18815,-20431,-1616,-117,44400,10.091055353,6.6515440439,3.439511309,8.2945918071,-9.007005326,-0.712413519
2024,Washington,Kitsap County,277658,-155,2809,2551,258,324,-716,-392,-21,9984,10.113939342,9.1849979567,0.9289413849,1.1665775531,-2.57799237,-1.411414817
2024,Washington,Kittitas County,45508,386,397,394,3,9,375,384,-1,291,8.7608959506,8.6946927066,0.066203244,0.1986097319,8.2754054949,8.4740152267
2024,Washington,Klickitat County,23589,286,186,273,-87,50,321,371,2,637,7.9331229208,11.64377719,-3.710654269,2.1325599249,13.691034718,15.823594643
2024,Washington,Lewis County,86154,797,926,1126,-200,34,962,996,1,723,10.798141227,13.130353155,-2.332211928,0.3964760278,11.217939374,11.614415402
2024,Washington,Lincoln County,11738,125,98,145,-47,2,170,172,0,67,8.3936448118,12.419168344,-4.025523532,0.1712988737,14.560404265,14.731703139
2024,Washington,Mason County,68389,218,619,826,-207,155,266,421,4,2067,9.0656121851,12.097246632,-3.031634446,2.2700644405,3.8957234915,6.165787932
2024,Washington,Okanogan County,43712,252,421,577,-156,230,176,406,2,1312,9.6590648373,13.238195751,-3.579130914,5.2769237829,4.0379938512,9.3149176341
2024,Washington,Pacific County,24200,105,150,407,-257,29,334,363,-1,311,6.2118231701,16.854746868,-10.6429237,1.2009524796,13.831659592,15.032612072
2024,Washington,Pend Oreille County,14361,223,114,233,-119,0,344,344,-2,145,8.0002807116,16.351450928,-8.351170216,0.0,24.141197937,24.141197937
2024,Washington,Pierce County,928696,2217,10933,8162,2771,1846,-2396,-550,-4,21713,11.786489145,8.7991698896,2.9873192556,1.9901087498,-2.583044726,-0.592935976
2024,Washington,San Juan County,18566,-106,103,151,-48,21,-76,-55,-3,93,5.5319834578,8.1099951662,-2.578011708,1.1278801225,-4.081851872,-2.953971749
2024,Washington,Skagit County,131417,95,1389,1446,-57,136,23,159,-7,1447,10.573230468,11.007121135,-0.433890667,1.0352479076,0.1750786903,1.2103265979
2024,Washington,Skamania County,12640,185,88,103,-15,2,198,200,0,454,7.0133492728,8.2088065352,-1.195457262,0.1593943017,15.780035864,15.939430165
2024,Washington,Snohomish County,844761,4309,9749,6475,3274,3349,-2282,1067,-32,8374,11.570050789,7.6844885483,3.8855622405,3.9745717604,-2.708262991,1.2663087693
2024,Washington,Spokane County,551455,1715,5710,5565,145,511,1033,1544,26,16306,10.370551991,10.107201722,0.2633502695,0.9280826738,1.876143644,2.8042263178
2024,Washington,Stevens County,48837,554,440,624,-184,6,735,741,-3,254,9.0609555189,12.850082372,-3.789126853,0.1235584843,15.135914333,15.259472817
2024,Washington,Thurston County,299003,364,3043,2943,100,337,-63,274,-10,4325,10.183353914,9.8487054123,0.3346485019,1.1277654516,-0.210828556,0.9169368953
2024,Washington,Wahkiakum County,4765,77,31,68,-37,0,116,116,-2,10,6.5587644134,14.3869671,-7.828202687,0.0,24.542473289,24.542473289
2024,Washington,Walla Walla County,61568,-285,553,728,-175,85,-197,-112,2,4548,8.9611978513,11.797019956,-2.835822105,1.3773993081,-3.192325455,-1.814926147
2024,Washington,Whatcom County,231919,1321,1969,2076,-107,379,1034,1413,15,5982,8.5142816372,8.9769673331,-0.462685696,1.6388586798,4.471187005,6.1100456848
2024,Washington,Whitman County,48012,433,390,349,41,309,84,393,-1,5555,8.1597639945,7.3019426515,0.857821343,6.4650437803,1.7574876296,8.2225314099
2024,Washington,Yakima County,256643,-376,3341,2462,879,316,-1583,-1267,12,4056,13.008554263,9.5860702174,3.4224840459,1.2303810677,-6.163586171,-4.933205104
2024,West Virginia,West Virginia,1770071,-3964,17263,25929,-8666,1101,3595,4696,6,52052,9.7418079482,14.632180866,-4.890372918,0.6213132451,2.0287203599,2.6500336051
2024,West Virginia,Barbour County,15378,-13,137,250,-113,3,97,100,0,714,8.905066788,16.250121876,-7.345055088,0.1950014625,6.3050472879,6.5000487504
2024,West Virginia,Berkeley County,132440,3061,1518,1323,195,47,2820,2867,-1,939,11.595797096,10.106218418,1.4895786784,0.3590266558,21.541599349,21.900626005
2024,West Virginia,Boone County,20576,-331,189,366,-177,1,-158,-157,3,148,9.1121664296,17.64578261,-8.53361618,0.0482125208,-7.617578285,-7.569365764
2024,West Virginia,Braxton County,12162,-8,102,194,-92,0,84,84,0,436,8.3840210422,15.946079237,-7.562058195,0.0,6.9044879171,6.9044879171
2024,West Virginia,Brooke County,21373,-321,159,383,-224,14,-108,-94,-3,698,7.3838437783,17.786240045,-10.40239627,0.6501497666,-5.015441057,-4.36529129
2024,West Virginia,Cabell County,92082,-403,887,1350,-463,38,24,62,-2,4504,9.6116857293,14.628833974,-5.017148244,0.4117745859,0.2600681595,0.6718427455
2024,West Virginia,Calhoun County,5959,-110,60,124,-64,-3,-43,-46,0,23,9.9767209844,20.618556701,-10.64183572,-0.498836049,-7.149983372,-7.648819421
2024,West Virginia,Clay County,7783,-57,96,153,-57,0,-1,-1,1,55,12.289573065,19.586507073,-7.296934008,0.0,-0.128016386,-0.128016386
2024,West Virginia,Doddridge County,7680,-32,65,91,-26,-2,-4,-6,0,1115,8.4459459459,11.824324324,-3.378378378,-0.25987526,-0.51975052,-0.77962578
2024,West Virginia,Fayette County,39072,-316,378,714,-336,4,16,20,0,1487,9.6354830487,18.20035687,-8.564873821,0.1019627836,0.4078511343,0.5098139179
2024,West Virginia,Gilmer County,7254,-76,49,91,-42,4,-38,-34,0,1651,6.719692814,12.479429512,-5.759736698,0.5485463522,-5.211190346,-4.662643993
2024,West Virginia,Grant County,10921,-17,92,175,-83,8,60,68,-2,120,8.4175854339,16.011711423,-7.594125989,0.7319639508,5.4897296308,6.2216935816
2024,West Virginia,Greenbrier County,32149,-226,303,573,-270,16,30,46,-2,399,9.3918541938,17.760833178,-8.368978985,0.4959394954,0.9298865538,1.4258260492
2024,West Virginia,Hampshire County,23649,192,251,317,-66,-3,261,258,0,416,10.656816541,13.459007345,-2.802190804,-0.127372309,11.081390906,10.954018596
2024,West Virginia,Hancock County,28145,-109,245,489,-244,3,134,137,-2,265,8.6880973067,17.340732992,-8.652635685,0.106384865,4.7518573024,4.8582421674
2024,West Virginia,Hardy County,14251,83,128,187,-59,4,139,143,-1,71,9.0080579894,13.160209719,-4.152151729,0.2815018122,9.7821879728,10.063689785
2024,West Virginia,Harrison County,64639,-113,672,943,-271,19,138,157,1,917,10.387121206,14.575975145,-4.188853939,0.2936834865,2.1330695334,2.4267530199
2024,West Virginia,Jackson County,27593,-74,267,416,-149,16,58,74,1,142,9.6634093377,15.056098444,-5.392689106,0.5790807094,2.0991675715,2.6782482809
2024,West Virginia,Jefferson County,59787,786,538,551,-13,84,712,796,3,1089,9.0581540223,9.27703135,-0.218877328,1.4142842711,11.98774287,13.402027141
2024,West Virginia,Kanawha County,174805,-1059,1726,2590,-864,223,-422,-199,4,3094,9.8440409617,14.771764827,-4.927723865,1.271854655,-2.406828091,-1.134973436
2024,West Virginia,Lewis County,16500,-174,154,319,-165,0,-9,-9,0,215,9.2843793332,19.231928619,-9.947549286,0.0,-0.542593597,-0.542593597
2024,West Virginia,Lincoln County,19701,-150,193,357,-164,4,11,15,-1,60,9.7593042071,18.052184466,-8.292880259,0.2022653722,0.5562297735,0.7584951456
2024,West Virginia,Logan County,30827,-379,312,631,-319,-2,-59,-61,1,755,10.059162059,20.344010446,-10.28484839,-0.064481808,-1.902213338,-1.966695146
2024,West Virginia,McDowell County,17439,-367,160,390,-230,15,-153,-138,1,2014,9.0793020287,22.130798695,-13.05149667,0.8511845652,-8.682082565,-7.830898
2024,West Virginia,Marion County,55807,23,526,756,-230,0,255,255,-2,1556,9.4272835623,13.549479797,-4.122196234,0.0,4.5702610426,4.5702610426
2024,West Virginia,Marshall County,29405,-262,263,465,-202,6,-66,-60,0,874,8.9043878657,15.743499458,-6.839111593,0.2031419285,-2.234561213,-2.031419285
2024,West Virginia,Mason County,24765,-146,273,448,-175,1,26,27,2,737,10.991223126,18.036878976,-7.04565585,0.0402608906,1.0467831548,1.0870440454
2024,West Virginia,Mercer County,58057,-555,615,1000,-385,20,-190,-170,0,1178,10.54264629,17.142514293,-6.599868003,0.3428502859,-3.257077716,-2.91422743
2024,West Virginia,Mineral County,26867,-35,293,394,-101,-7,73,66,0,500,10.898473098,14.655284644,-3.756811546,-0.260373077,2.715319236,2.4549461586
2024,West Virginia,Mingo County,22023,-422,259,448,-189,-3,-230,-233,0,92,11.648826122,20.14932086,-8.500494738,-0.134928488,-10.34451741,-10.47944589
2024,West Virginia,Monongalia County,107718,740,980,737,243,389,106,495,2,8166,9.129187316,6.8655214815,2.2636658345,3.6237284346,0.9874427097,4.6111711443
2024,West Virginia,Monroe County,12382,60,133,217,-84,6,138,144,0,258,10.767487047,17.568005181,-6.800518135,0.4857512953,11.172279793,11.658031088
2024,West Virginia,Morgan County,17649,214,150,265,-115,-2,334,332,-3,185,8.5509063961,15.1066013,-6.555694904,-0.114012085,19.040018242,18.926006157
2024,West Virginia,Nicholas County,24169,-140,223,391,-168,21,7,28,0,81,9.200049507,16.131028508,-6.930979001,0.8663723751,0.2887907917,1.1551631668
2024,West Virginia,Ohio County,41194,-269,382,637,-255,29,-44,-15,1,2149,9.2430163205,15.41309266,-6.17007634,0.7016949563,-1.064640623,-0.362945667
2024,West Virginia,Pendleton County,6029,-38,63,106,-43,2,3,5,0,93,10.416666667,17.526455026,-7.10978836,0.3306878307,0.496031746,0.8267195767
2024,West Virginia,Pleasants County,7428,-142,74,116,-42,0,-100,-100,0,742,9.8679823977,15.468729164,-5.600746766,0.0,-13.33511135,-13.33511135
2024,West Virginia,Pocahontas County,7765,-32,64,134,-70,0,38,38,0,290,8.2251638607,17.221436833,-8.996272973,0.0,4.8836910423,4.8836910423
2024,West Virginia,Preston County,34099,-123,302,433,-131,29,-20,9,-1,3326,8.8406200143,12.675458497,-3.834838483,0.84893371,-0.585471524,0.2634621859
2024,West Virginia,Putnam County,56962,-101,537,664,-127,28,-3,25,1,316,9.4189870642,11.646568735,-2.227581671,0.4911203683,-0.052620039,0.4385003289
2024,West Virginia,Raleigh County,72356,-445,655,1197,-542,30,65,95,2,3345,9.0247111748,16.492487445,-7.46777627,0.41334555,0.895582025,1.308927575
2024,West Virginia,Randolph County,27350,-202,265,441,-176,0,-25,-25,-1,2428,9.6535645332,16.064988525,-6.411423992,0.0,-0.910713635,-0.910713635
2024,West Virginia,Ritchie County,8167,-63,84,137,-53,2,-12,-10,0,32,10.245776666,16.710373849,-6.464597182,0.2439470635,-1.463682381,-1.219735317
2024,West Virginia,Roane County,13743,-90,125,220,-95,1,4,5,0,90,9.0658543661,15.955903684,-6.890049318,0.0725268349,0.2901073397,0.3626341746
2024,West Virginia,Summers County,11581,-121,94,248,-154,-1,34,33,0,1002,8.0745608384,21.30309668,-13.22853584,-0.085899583,2.9205858352,2.8346862518
2024,West Virginia,Taylor County,16388,-22,151,253,-102,-1,80,79,1,460,9.2078785292,15.427769986,-6.219891457,-0.060979328,4.8783462406,4.8173669126
2024,West Virginia,Tucker County,6604,-16,60,114,-54,0,39,39,-1,129,9.0744101633,17.24137931,-8.166969147,0.0,5.8983666062,5.8983666062
2024,West Virginia,Tyler County,7919,-171,76,139,-63,-1,-108,-109,1,71,9.4946592542,17.365232057,-7.870572803,-0.124929727,-13.49241052,-13.61734025
2024,West Virginia,Upshur County,23529,-176,233,318,-85,3,-95,-92,1,982,9.8657746539,13.464876995,-3.599102342,0.1270271415,-4.022526146,-3.895499005
2024,West Virginia,Wayne County,37686,-294,363,624,-261,21,-55,-34,1,175,9.5947981921,16.493537388,-6.898739196,0.5550709698,-1.453757302,-0.898686332
2024,West Virginia,Webster County,8045,-96,77,147,-70,0,-26,-26,0,61,9.5143951563,18.163845298,-8.649450142,0.0,-3.21265291,-3.21265291
2024,West Virginia,Wetzel County,13890,-104,149,293,-144,9,33,42,-2,109,10.687132406,21.015636207,-10.3285038,0.6455314876,2.3669487878,3.0124802754
2024,West Virginia,Wirt County,5000,-92,56,85,-29,0,-64,-64,1,0,11.097899326,16.845025763,-5.747126437,0.0,-12.68331352,-12.68331352
2024,West Virginia,Wood County,83052,-336,853,1152,-299,29,-68,-39,2,1132,10.249939918,13.842826244,-3.592886325,0.3484739245,-0.817111271,-0.468637347
2024,West Virginia,Wyoming County,20277,-295,204,373,-169,-3,-123,-126,0,166,9.9880046023,18.262380964,-8.274376362,-0.146882421,-6.022179246,-6.169061666
2024,Wisconsin,Wisconsin,5910955,20412,59839,58692,1147,13653,5648,19301,-36,137061,10.140916009,9.9465339061,0.194382103,2.313774065,0.9571666241,3.2709406891
2024,Wisconsin,Adams County,21449,197,122,316,-194,7,384,391,0,1306,5.7141518934,14.80059015,-9.086438257,0.3278611742,17.985527271,18.313388445
2024,Wisconsin,Ashland County,16079,39,161,200,-39,8,70,78,0,566,10.025218718,12.453687848,-2.42846913,0.4981475139,4.3587907469,4.8569382608
2024,Wisconsin,Barron County,46833,118,444,605,-161,95,186,281,-2,799,9.4924530722,12.934536281,-3.442083209,2.0310428871,3.9765681789,6.007611066
2024,Wisconsin,Bayfield County,16769,110,115,190,-75,2,184,186,-1,52,6.880459495,11.367715687,-4.487256192,0.1196601651,11.008735192,11.128395357
2024,Wisconsin,Brown County,271417,1349,3004,2262,742,546,49,595,12,6448,11.095413539,8.3548020721,2.7406114666,2.0166763622,0.1809837761,2.1976601383
2024,Wisconsin,Buffalo County,13419,29,125,143,-18,1,49,50,-3,109,9.325226603,10.668059234,-1.342832631,0.0746018128,3.6554888284,3.7300906412
2024,Wisconsin,Burnett County,17092,104,94,227,-133,7,228,235,2,165,5.5164319249,13.321596244,-7.805164319,0.4107981221,13.38028169,13.791079812
2024,Wisconsin,Calumet County,53199,487,457,399,58,43,390,433,-4,169,8.6298873583,7.5346281312,1.0952592271,0.8120025304,7.3646741132,8.1766766436
2024,Wisconsin,Chippewa County,66970,217,651,657,-6,15,207,222,1,2639,9.7365449474,9.8262826888,-0.089737741,0.2243443536,3.09595208,3.3202964337
2024,Wisconsin,Clark County,34774,42,566,387,179,55,-191,-136,-1,402,16.286363767,11.13572929,5.1506344776,1.5825971859,-5.495928409,-3.913331223
2024,Wisconsin,Columbia County,58091,-137,568,620,-52,34,-121,-87,2,1397,9.766246271,10.66033924,-0.894092968,0.5845992486,-2.080485561,-1.495886313
2024,Wisconsin,Crawford County,15944,-71,161,198,-37,5,-38,-33,-1,675,10.075409118,12.39087581,-2.315466692,0.3129009043,-2.378046873,-2.065145968
2024,Wisconsin,Dane County,575347,7589,5580,3579,2001,3456,2092,5548,40,17536,9.7628826748,6.2618919522,3.5009907226,6.0466886244,3.6602061928,9.7068948172
2024,Wisconsin,Dodge County,88231,-143,756,1064,-308,115,48,163,2,5121,8.5614790068,12.049488973,-3.488009966,1.3023413833,0.5435859687,1.845927352
2024,Wisconsin,Door County,30562,11,212,379,-167,36,142,178,0,309,6.9379673719,12.40325299,-5.465285618,1.1781454028,4.6471290887,5.8252744915
2024,Wisconsin,Douglas County,44264,38,414,501,-87,42,81,123,2,1348,9.3569894903,11.323313369,-1.966323878,0.9492598034,1.8307153351,2.7799751384
2024,Wisconsin,Dunn County,45794,172,444,408,36,60,76,136,0,3015,9.7138356524,8.9262273563,0.7876082961,1.3126804936,1.6627286252,2.9754091188
2024,Wisconsin,Eau Claire County,107903,1117,1059,958,101,123,885,1008,8,4767,9.8654332546,8.924537354,0.9408959006,1.1458435225,8.2444838813,9.3903274038
2024,Wisconsin,Florence County,4682,-24,29,66,-37,0,13,13,0,41,6.1780997017,14.060502769,-7.882403068,0.0,2.7694929697,2.7694929697
2024,Wisconsin,Fond du Lac County,103948,136,1005,1136,-131,212,55,267,0,3258,9.6746245668,10.935695033,-1.261070466,2.0408163265,0.5294570658,2.5702733924
2024,Wisconsin,Forest County,9325,-7,88,152,-64,3,54,57,0,118,9.4334566115,16.294152329,-6.860695717,0.3215951118,5.7887120116,6.1103071233
2024,Wisconsin,Grant County,51409,94,560,572,-12,40,65,105,1,3317,10.90300222,11.136637981,-0.233635762,0.7787858728,1.2655270433,2.0443129162
2024,Wisconsin,Green County,36951,66,351,397,-46,30,84,114,-2,342,9.5075572891,10.753561948,-1.246004659,0.8126117341,2.2753128555,3.0879245896
2024,Wisconsin,Green Lake County,19344,136,203,286,-83,11,213,224,-5,234,10.531230546,14.837103133,-4.305872588,0.5706578128,11.050010376,11.620668188
2024,Wisconsin,Iowa County,23956,-2,258,211,47,24,-73,-49,0,182,10.769294987,8.8074466753,1.9618483116,1.0017948825,-3.047126101,-2.045331218
2024,Wisconsin,Iron County,6228,29,40,108,-68,1,98,99,-2,97,6.4375955581,17.381508007,-10.94391245,0.160939889,15.772109117,15.933049006
2024,Wisconsin,Jackson County,20855,-38,213,237,-24,22,-37,-15,1,1227,10.204081633,11.35383731,-1.149755677,1.0539427038,-1.772540002,-0.718597298
2024,Wisconsin,Jefferson County,85743,18,789,858,-69,94,-9,85,2,3899,9.2028833368,10.007698229,-0.804814893,1.0964144913,-0.104975856,0.9914386358
2024,Wisconsin,Juneau County,26594,-181,221,372,-151,17,-45,-28,-2,1563,8.2819614383,13.940677172,-5.658715734,0.6370739568,-1.686372239,-1.049298282
2024,Wisconsin,Kenosha County,167488,-149,1681,1627,54,313,-525,-212,9,4026,10.032077583,9.7098097725,0.3222678105,1.8679597165,-3.133159269,-1.265199552
2024,Wisconsin,Kewaunee County,20690,37,197,205,-8,18,28,46,-1,189,9.5300292673,9.917035532,-0.387006265,0.8707640955,1.3545219263,2.2252860218
2024,Wisconsin,La Crosse County,120486,234,1113,1103,10,86,135,221,3,4846,9.2465668071,9.1634889382,0.0830778689,0.7144696724,1.12155123,1.8360209024
2024,Wisconsin,Lafayette County,16945,39,248,166,82,38,-82,-44,1,96,14.65244749,9.8076866267,4.8447608638,2.2451330832,-4.844760864,-2.599627781
2024,Wisconsin,Langlade County,19404,-98,175,306,-131,9,25,34,-1,264,8.9960417416,15.73022156,-6.734179818,0.4626535753,1.2851488202,1.7478023955
2024,Wisconsin,Lincoln County,28405,50,253,436,-183,21,211,232,1,422,8.9147286822,15.362931642,-6.44820296,0.7399577167,7.4348132488,8.1747709655
2024,Wisconsin,Manitowoc County,81331,133,726,917,-191,143,184,327,-3,1085,8.9337902774,11.284140061,-2.350349784,1.7596859637,2.26421131,4.0238972737
2024,Wisconsin,Marathon County,138612,657,1437,1366,71,258,338,596,-10,1729,10.391695322,9.8782573481,0.5134379734,1.8657323542,2.4442540144,4.3099863686
2024,Wisconsin,Marinette County,42106,140,359,597,-238,26,352,378,0,686,8.5402987915,14.202112475,-5.661813684,0.6185174612,8.3737748596,8.9922923209
2024,Wisconsin,Marquette County,15838,61,127,250,-123,11,175,186,-2,155,8.0341609995,15.815277558,-7.781116559,0.6958722126,11.070694291,11.766566503
2024,Wisconsin,Menominee County,4226,20,64,69,-5,0,26,26,-1,8,15.180265655,16.366223909,-1.185958254,0.0,6.1669829222,6.1669829222
2024,Wisconsin,Milwaukee County,916205,-1873,11327,8928,2399,4154,-8408,-4254,-18,19156,12.350329802,9.734593844,2.6157359579,4.5292901913,-9.167614812,-4.638324621
2024,Wisconsin,Monroe County,46151,257,575,537,38,45,178,223,-4,691,12.493888859,11.668205769,0.8256830898,0.9777826063,3.8676734206,4.8454560269
2024,Wisconsin,Oconto County,39775,79,333,416,-83,5,155,160,2,378,8.3804154975,10.469227769,-2.088812271,0.1258320645,3.9007940003,4.0266260649
2024,Wisconsin,Oneida County,38226,33,265,521,-256,12,274,286,3,512,6.9354479907,13.635352465,-6.699904474,0.3140580222,7.1709915073,7.4850495296
2024,Wisconsin,Outagamie County,193234,965,2109,1593,516,320,126,446,3,3353,10.941549093,8.2645271243,2.6770219687,1.6601686628,0.653691411,2.3138600737
2024,Wisconsin,Ozaukee County,93460,439,814,883,-69,178,340,518,-10,2055,8.7301119149,9.4701336865,-0.740021772,1.9090416718,3.6464840922,5.555525764
2024,Wisconsin,Pepin County,7441,63,76,82,-6,12,58,70,-1,10,10.257102369,11.066873608,-0.80977124,1.6195424792,7.8277886497,9.447331129
2024,Wisconsin,Pierce County,43026,474,395,366,29,37,408,445,0,2390,9.2313445044,8.5536002244,0.6777442801,0.8647082194,9.5351609058,10.399869125
2024,Wisconsin,Polk County,45762,216,401,567,-166,12,373,385,-3,508,8.7834581855,12.41950322,-3.636045034,0.262846629,8.1701493845,8.4329960135
2024,Wisconsin,Portage County,71024,390,599,696,-97,198,292,490,-3,2972,8.4569879569,9.8264835025,-1.369495546,2.7954651343,4.1226051476,6.9180702819
2024,Wisconsin,Price County,14102,-57,93,210,-117,12,48,60,0,154,6.5815080853,14.86146987,-8.279961785,0.8492268497,3.3969073989,4.2461342486
2024,Wisconsin,Racine County,196613,652,2132,2127,5,396,250,646,1,3825,10.861646467,10.836173562,0.0254729045,2.0174540341,1.2736452236,3.2910992577
2024,Wisconsin,Richland County,17197,69,175,231,-56,17,108,125,0,372,10.196649672,13.459577567,-3.262927895,0.9905316824,6.292789512,7.2833211945
2024,Wisconsin,Rock County,164278,437,1765,1703,62,134,241,375,0,2716,10.758291961,10.380380289,0.3779116723,0.8167768401,1.4689792423,2.2857560824
2024,Wisconsin,Rusk County,14143,44,120,237,-117,9,152,161,0,145,8.4979817293,16.783513915,-8.285532186,0.6373486297,10.76411019,11.40145882
2024,Wisconsin,St. Croix County,96763,796,1019,787,232,48,522,570,-6,811,10.574378664,8.1668655632,2.4075131012,0.4981061589,5.4169044778,5.9150106366
2024,Wisconsin,Sauk County,65920,150,701,733,-32,183,0,183,-1,956,10.646214595,11.132204419,-0.485989825,2.7792543094,0.0,2.7792543094
2024,Wisconsin,Sawyer County,18552,31,136,275,-139,7,161,168,2,305,7.3368758935,14.835594638,-7.498718744,0.377633318,8.6855663151,9.0631996332
2024,Wisconsin,Shawano County,41109,122,431,495,-64,16,171,187,-1,461,10.499902553,12.059052816,-1.559150263,0.3897875658,4.1658546092,4.555642175
2024,Wisconsin,Sheboygan County,117752,91,1111,1218,-107,293,-94,199,-1,2949,9.4387310811,10.347771788,-0.909040707,2.4892423103,-0.798596509,1.6906458012
2024,Wisconsin,Taylor County,20058,117,216,221,-5,18,103,121,1,109,10.800270007,11.050276257,-0.25000625,0.9000225006,5.1501287532,6.0501512538
2024,Wisconsin,Trempealeau County,30899,8,382,304,78,58,-130,-72,2,399,12.364460269,9.8397798997,2.524680369,1.8773264282,-4.207800615,-2.330474187
2024,Wisconsin,Vernon County,31170,107,408,357,51,23,33,56,0,341,13.112014526,11.47301271,1.6390018158,0.7391576816,1.0605305867,1.7996882683
2024,Wisconsin,Vilas County,23885,143,160,358,-198,-1,341,340,1,83,6.7188779474,15.033489407,-8.31461146,-0.041992987,14.319608625,14.277615638
2024,Wisconsin,Walworth County,105822,158,913,1054,-141,109,190,299,0,2853,8.634141267,9.9675628647,-1.333421598,1.0308010932,1.7968092451,2.8276103383
2024,Wisconsin,Washburn County,16930,59,124,277,-153,4,209,213,-1,172,7.3370610337,16.390047632,-9.052986598,0.2366793882,12.366498033,12.603177421
2024,Wisconsin,Washington County,138168,412,1264,1325,-61,73,410,483,-10,745,9.1619431438,9.6040938809,-0.442150737,0.52913121,2.9718328235,3.5009640336
2024,Wisconsin,Waukesha County,412591,2318,3717,3936,-219,783,1785,2568,-31,3272,9.0342997142,9.5665869451,-0.532287231,1.9031091408,4.3385055125,6.2416146532
2024,Wisconsin,Waupaca County,51388,-122,462,739,-277,10,148,158,-3,1256,8.9797663706,14.363738848,-5.383972478,0.1943672375,2.8766351144,3.0710023518
2024,Wisconsin,Waushara County,24934,7,180,329,-149,9,148,157,-1,1144,7.2200717996,13.196686789,-5.97661499,0.36100359,5.9365034797,6.2975070697
2024,Wisconsin,Winnebago County,171735,1047,1673,1649,24,362,659,1021,2,6329,9.771539879,9.6313623793,0.1401774998,2.1143439547,3.8490405142,5.9633844689
2024,Wisconsin,Wood County,73939,161,693,1008,-315,90,391,481,-5,1032,9.3828063121,13.647718272,-4.26491196,1.2185462743,5.2939065917,6.512452866
2024,Wyoming,Wyoming,584057,2428,5882,5779,103,322,2016,2338,-13,13910,10.091911544,9.9151915696,0.1767199743,0.5524643858,3.4589074588,4.0113718446
2024,Wyoming,Albany County,38257,79,307,237,70,231,-220,11,-2,2976,8.0329691895,6.2013475502,1.8316216393,6.0443514097,-5.756525152,0.2878262576
2024,Wyoming,Big Horn County,12018,139,132,155,-23,4,157,161,1,261,11.047411809,12.972339624,-1.924927815,0.3347700548,13.139724652,13.474494706
2024,Wyoming,Campbell County,47498,439,567,335,232,1,205,206,1,587,11.992766268,7.0856731918,4.9070930761,0.0211512633,4.3360089681,4.3571602314
2024,Wyoming,Carbon County,14334,-204,144,154,-10,16,-209,-193,-1,589,9.9750623441,10.667775007,-0.692712663,1.1083402605,-14.47769465,-13.36935439
2024,Wyoming,Converse County,13809,44,127,145,-18,1,62,63,-1,84,9.2115761224,10.517153841,-1.305577718,0.0725320955,4.496989918,4.5695220135
2024,Wyoming,Crook County,7592,173,87,84,3,-3,174,171,-1,29,11.591499567,11.191792685,0.3997068816,-0.399706882,23.182999134,22.783292252
2024,Wyoming,Fremont County,39815,249,442,514,-72,4,319,323,-2,1403,11.136166085,12.950202189,-1.814036104,0.1007797836,8.0371877401,8.1379675237
2024,Wyoming,Goshen County,12642,6,110,176,-66,2,71,73,-1,1126,8.7032201915,13.925152306,-5.221932115,0.1582403671,5.6175330327,5.7757733998
2024,Wyoming,Hot Springs County,4661,38,34,84,-50,0,89,89,-1,97,7.3244291254,18.095648427,-10.7712193,0.0,19.172770358,19.172770358
2024,Wyoming,Johnson County,8759,40,76,102,-26,-8,75,67,-1,145,8.6966472136,11.671815997,-2.975168784,-0.915436549,8.582217645,7.6667810962
2024,Wyoming,Laramie County,100984,203,1121,1054,67,15,121,136,0,1619,11.111937155,10.447798181,0.6641389736,0.1486878299,1.1994151612,1.3481029911
2024,Wyoming,Lincoln County,20880,209,209,152,57,-1,154,153,-1,69,10.059926356,7.3163100768,2.7436162788,-0.048133619,7.4125773146,7.3644436957
2024,Wyoming,Natrona County,79941,418,827,792,35,0,381,381,2,1266,10.372247028,9.9332764762,0.4389705513,0.0,4.7785080018,4.7785080018
2024,Wyoming,Niobrara County,2354,6,21,33,-12,0,19,19,-1,244,8.9323692046,14.036580179,-5.104210974,0.0,8.0816673756,8.0816673756
2024,Wyoming,Park County,30735,230,266,352,-86,7,312,319,-3,669,8.6871325931,11.495754409,-2.808621816,0.2286087524,10.189418681,10.418027433
2024,Wyoming,Platte County,8546,-106,70,145,-75,15,-45,-30,-1,93,8.1404814513,16.862425863,-8.721944412,1.7443888824,-5.233166647,-3.488777765
2024,Wyoming,Sheridan County,32519,484,296,353,-57,9,533,542,-1,778,9.1706168479,10.936580227,-1.765963379,0.2788363231,16.513306689,16.792143012
2024,Wyoming,Sublette County,8969,217,75,73,2,-3,220,217,-2,55,8.4645336042,8.2388127081,0.2257208961,-0.338581344,24.829298572,24.490717228
2024,Wyoming,Sweetwater County,41249,-125,430,366,64,-12,-180,-192,3,629,10.408723963,8.859518536,1.5492054271,-0.290476018,-4.357140264,-4.647616281
2024,Wyoming,Teton County,23232,-65,190,90,100,55,-221,-166,1,280,8.1669496443,3.8685550947,4.2983945496,2.3641170023,-9.499451955,-7.135334952
2024,Wyoming,Uinta County,20745,18,229,182,47,-6,-23,-29,0,218,11.043595679,8.7770061728,2.2665895062,-0.289351852,-1.109182099,-1.398533951
2024,Wyoming,Washakie County,7710,-14,72,109,-37,-1,25,24,-1,144,9.3300505378,14.124659842,-4.794609304,-0.129584035,3.2396008812,3.1100168459
2024,Wyoming,Weston County,6808,-50,50,92,-42,-4,-3,-7,-1,549,7.3174301185,13.464071418,-6.1466413,-0.585394409,-0.439045807,-1.024440217
